Id,alphabet,Description,Category,Prevalence_20192,Prevalence_20201,Prevalence_20202,Pre_Early_Prct,Early_Outbreak_Prct,Pre_Outbreak_Prct,Pre_rank,Early_rank,Outbreak_rank,Rank_change1,Rank_change2,Rank_change3
a020,a,Salmonella enteritis,Certain infectious and parasitic diseases,85,41,60,-0.517647059,0.463414634,-0.294117647,2936,4051,3417,1115,-634,481
a029,a,"Salmonella infection, unspecified",Certain infectious and parasitic diseases,26,14,24,-0.461538462,0.714285714,-0.076923077,5182,6308,5186,1126,-1122,4
a039,a,"Shigellosis, unspecified",Certain infectious and parasitic diseases,34,13,20,-0.617647059,0.538461538,-0.411764706,4584,6427,5546,1843,-881,962
a040,a,Enteropathogenic Escherichia coli infection,Certain infectious and parasitic diseases,52,40,31,-0.230769231,-0.225,-0.403846154,3779,4096,4668,317,572,889
a044,a,Other intestinal Escherichia coli infections,Certain infectious and parasitic diseases,79,47,29,-0.405063291,-0.382978723,-0.632911392,3065,3789,4778,724,989,1713
a045,a,Campylobacter enteritis,Certain infectious and parasitic diseases,106,94,65,-0.113207547,-0.308510638,-0.386792453,2613,2677,3273,64,596,660
a0471,a,"Enterocolitis due to Clostridium difficile, recurrent",Certain infectious and parasitic diseases,471,403,340,-0.144373673,-0.156327543,-0.278131635,1097,1168,1314,71,146,217
a0472,a,"Enterocolitis due to Clostridium difficile, not specified as recurrent",Certain infectious and parasitic diseases,2669,2365,2499,-0.113900337,0.056659619,-0.063694268,299,318,310,19,-8,11
a048,a,Other specified bacterial intestinal infections,Certain infectious and parasitic diseases,51,42,57,-0.176470588,0.357142857,0.117647059,3812,3997,3498,185,-499,-314
a049,a,"Bacterial intestinal infection, unspecified",Certain infectious and parasitic diseases,41,29,33,-0.292682927,0.137931034,-0.195121951,4212,4728,4530,516,-198,318
a059,a,"Bacterial foodborne intoxication, unspecified",Certain infectious and parasitic diseases,30,45,48,0.5,0.066666667,0.6,4843,3874,3800,-969,-74,-1043
a071,a,Giardiasis [lambliasis],Certain infectious and parasitic diseases,45,24,15,-0.466666667,-0.375,-0.666666667,4029,5151,6130,1122,979,2101
a072,a,Cryptosporidiosis,Certain infectious and parasitic diseases,28,11,16,-0.607142857,0.454545455,-0.428571429,4993,6672,6000,1679,-672,1007
a0811,a,Acute gastroenteropathy due to Norwalk agent,Certain infectious and parasitic diseases,85,63,29,-0.258823529,-0.53968254,-0.658823529,2933,3311,4772,378,1461,1839
a0839,a,Other viral enteritis,Certain infectious and parasitic diseases,55,101,343,0.836363636,2.396039604,5.236363636,3686,2543,1302,-1143,-1241,-2384
a084,a,"Viral intestinal infection, unspecified",Certain infectious and parasitic diseases,597,435,359,-0.271356784,-0.174712644,-0.398659966,918,1120,1275,202,155,357
a09,a,"Infectious gastroenteritis and colitis, unspecified",Certain infectious and parasitic diseases,538,443,452,-0.176579926,0.020316027,-0.159851301,1002,1106,1105,104,-1,103
a150,a,Tuberculosis of lung,Certain infectious and parasitic diseases,40,38,32,-0.05,-0.157894737,-0.2,4252,4174,4589,-78,415,337
a159,a,Respiratory tuberculosis unspecified,Certain infectious and parasitic diseases,29,20,15,-0.310344828,-0.25,-0.482758621,4914,5567,6124,653,557,1210
a280,a,Pasteurellosis,Certain infectious and parasitic diseases,46,38,32,-0.173913043,-0.157894737,-0.304347826,3978,4174,4589,196,415,611
a310,a,Pulmonary mycobacterial infection,Certain infectious and parasitic diseases,112,111,90,-0.008928571,-0.189189189,-0.196428571,2536,2430,2762,-106,332,226
a318,a,Other mycobacterial infections,Certain infectious and parasitic diseases,13,12,11,-0.076923077,-0.083333333,-0.153846154,6528,6543,6652,15,109,124
a319,a,"Mycobacterial infection, unspecified",Certain infectious and parasitic diseases,32,31,16,-0.03125,-0.483870968,-0.5,4701,4576,5993,-125,1417,1292
a400,a,"Sepsis due to streptococcus, group A",Certain infectious and parasitic diseases,83,113,74,0.361445783,-0.345132743,-0.108433735,2969,2419,3057,-550,638,88
a401,a,"Sepsis due to streptococcus, group B",Certain infectious and parasitic diseases,122,88,105,-0.278688525,0.193181818,-0.139344262,2406,2763,2516,357,-247,110
a403,a,Sepsis due to Streptococcus pneumoniae,Certain infectious and parasitic diseases,51,118,63,1.31372549,-0.466101695,0.235294118,3805,2362,3315,-1443,953,-490
a408,a,Other streptococcal sepsis,Certain infectious and parasitic diseases,138,130,109,-0.057971014,-0.161538462,-0.210144928,2247,2252,2473,5,221,226
a409,a,"Streptococcal sepsis, unspecified",Certain infectious and parasitic diseases,129,162,109,0.255813953,-0.327160494,-0.15503876,2322,1998,2473,-324,475,151
a4101,a,Sepsis due to Methicillin susceptible Staphylococcus aureus,Certain infectious and parasitic diseases,688,606,661,-0.119186047,0.090759076,-0.039244186,842,892,838,50,-54,-4
a4102,a,Sepsis due to Methicillin resistant Staphylococcus aureus,Certain infectious and parasitic diseases,484,493,468,0.018595041,-0.050709939,-0.033057851,1068,1026,1075,-42,49,7
a411,a,Sepsis due to other specified staphylococcus,Certain infectious and parasitic diseases,167,162,234,-0.02994012,0.444444444,0.401197605,2015,1996,1631,-19,-365,-384
a412,a,Sepsis due to unspecified staphylococcus,Certain infectious and parasitic diseases,45,57,62,0.266666667,0.087719298,0.377777778,4015,3455,3335,-560,-120,-680
a414,a,Sepsis due to anaerobes,Certain infectious and parasitic diseases,156,147,167,-0.057692308,0.136054422,0.070512821,2096,2099,1959,3,-140,-137
a4150,a,"Gram-negative sepsis, unspecified",Certain infectious and parasitic diseases,356,332,313,-0.06741573,-0.057228916,-0.120786517,1285,1313,1368,28,55,83
a4151,a,Sepsis due to Escherichia coli [E. coli],Certain infectious and parasitic diseases,1415,1265,1208,-0.106007067,-0.045059289,-0.146289753,509,531,552,22,21,43
a4152,a,Sepsis due to Pseudomonas,Certain infectious and parasitic diseases,295,261,304,-0.115254237,0.164750958,0.030508475,1460,1504,1394,44,-110,-66
a4153,a,Sepsis due to Serratia,Certain infectious and parasitic diseases,28,36,27,0.285714286,-0.25,-0.035714286,4971,4257,4896,-714,639,-75
a4159,a,Other Gram-negative sepsis,Certain infectious and parasitic diseases,663,587,730,-0.114630468,0.243611584,0.101055807,858,905,788,47,-117,-70
a4181,a,Sepsis due to Enterococcus,Certain infectious and parasitic diseases,346,280,334,-0.190751445,0.192857143,-0.034682081,1307,1445,1317,138,-128,10
a4189,a,Other specified sepsis,Certain infectious and parasitic diseases,484,1609,4479,2.324380165,1.783716594,8.254132231,1066,445,203,-621,-242,-863
a419,a,"Sepsis, unspecified organism",Certain infectious and parasitic diseases,16939,17062,16267,0.00726135,-0.046594772,-0.039671763,44,43,50,-1,7,6
a430,a,Pulmonary nocardiosis,Certain infectious and parasitic diseases,45,58,34,0.288888889,-0.413793103,-0.244444444,4007,3419,4438,-588,1019,431
a46,a,Erysipelas,Certain infectious and parasitic diseases,36,30,19,-0.166666667,-0.366666667,-0.472222222,4433,4628,5622,195,994,1189
a480,a,Gas gangrene,Certain infectious and parasitic diseases,179,168,209,-0.061452514,0.244047619,0.167597765,1938,1944,1730,6,-214,-208
a481,a,Legionnaires' disease,Certain infectious and parasitic diseases,44,28,37,-0.363636364,0.321428571,-0.159090909,4055,4785,4255,730,-530,200
a483,a,Toxic shock syndrome,Certain infectious and parasitic diseases,11,19,14,0.727272727,-0.263157895,0.272727273,6702,5654,6226,-1048,572,-476
a4901,a,"Methicillin susceptible Staphylococcus aureus infection, unspecified site",Certain infectious and parasitic diseases,136,75,68,-0.448529412,-0.093333333,-0.5,2250,2986,3171,736,185,921
a4902,a,"Methicillin resistant Staphylococcus aureus infection, unspecified site",Certain infectious and parasitic diseases,96,57,62,-0.40625,0.087719298,-0.354166667,2733,3444,3325,711,-119,592
a498,a,Other bacterial infections of unspecified site,Certain infectious and parasitic diseases,18,20,16,0.111111111,-0.2,-0.111111111,5912,5540,5969,-372,429,57
a499,a,"Bacterial infection, unspecified",Certain infectious and parasitic diseases,28,28,46,0,0.642857143,0.642857143,4961,4783,3858,-178,-925,-1103
a502,a,"Early congenital syphilis, unspecified",Certain infectious and parasitic diseases,15,15,12,0,-0.2,-0.2,6266,6121,6491,-145,370,225
a509,a,"Congenital syphilis, unspecified",Certain infectious and parasitic diseases,24,26,55,0.083333333,1.115384615,1.291666667,5295,4947,3537,-348,-1410,-1758
a5216,a,Charcot's arthropathy (tabetic),Certain infectious and parasitic diseases,30,38,33,0.266666667,-0.131578947,0.1,4811,4152,4501,-659,349,-310
a523,a,"Neurosyphilis, unspecified",Certain infectious and parasitic diseases,23,34,26,0.47826087,-0.235294118,0.130434783,5392,4345,4962,-1047,617,-430
a528,a,"Late syphilis, latent",Certain infectious and parasitic diseases,27,42,38,0.555555556,-0.095238095,0.407407407,5056,3970,4213,-1086,243,-843
a530,a,"Latent syphilis, unspecified as early or late",Certain infectious and parasitic diseases,63,61,91,-0.031746032,0.491803279,0.444444444,3429,3343,2728,-86,-615,-701
a539,a,"Syphilis, unspecified",Certain infectious and parasitic diseases,89,99,135,0.112359551,0.363636364,0.516853933,2840,2558,2205,-282,-353,-635
a5442,a,Gonococcal arthritis,Certain infectious and parasitic diseases,10,15,11,0.5,-0.266666667,0.1,6774,6115,6617,-659,502,-157
a549,a,"Gonococcal infection, unspecified",Certain infectious and parasitic diseases,43,48,93,0.11627907,0.9375,1.162790698,4093,3723,2685,-370,-1038,-1408
a5611,a,Chlamydial female pelvic inflammatory disease,Certain infectious and parasitic diseases,17,14,11,-0.176470588,-0.214285714,-0.352941176,6011,6254,6616,243,362,605
a562,a,"Chlamydial infection of genitourinary tract, unspecified",Certain infectious and parasitic diseases,53,51,42,-0.037735849,-0.176470588,-0.20754717,3715,3618,4028,-97,410,313
a568,a,Sexually transmitted chlamydial infection of other sites,Certain infectious and parasitic diseases,60,67,83,0.116666667,0.23880597,0.383333333,3500,3188,2856,-312,-332,-644
a5900,a,"Urogenital trichomoniasis, unspecified",Certain infectious and parasitic diseases,16,11,14,-0.3125,0.272727273,-0.125,6127,6623,6213,496,-410,86
a5901,a,Trichomonal vulvovaginitis,Certain infectious and parasitic diseases,67,44,48,-0.343283582,0.090909091,-0.28358209,3324,3892,3771,568,-121,447
a599,a,"Trichomoniasis, unspecified",Certain infectious and parasitic diseases,70,64,89,-0.085714286,0.390625,0.271428571,3243,3261,2761,18,-500,-482
a6000,a,"Herpesviral infection of urogenital system, unspecified",Certain infectious and parasitic diseases,471,411,402,-0.127388535,-0.02189781,-0.146496815,1088,1147,1175,59,28,87
a6002,a,Herpesviral infection of other male genital organs,Certain infectious and parasitic diseases,11,11,12,0,0.090909091,0.090909091,6683,6620,6478,-63,-142,-205
a6004,a,Herpesviral vulvovaginitis,Certain infectious and parasitic diseases,45,53,44,0.177777778,-0.169811321,-0.022222222,3997,3547,3936,-450,389,-61
a6009,a,Herpesviral infection of other urogenital tract,Certain infectious and parasitic diseases,96,106,175,0.104166667,0.650943396,0.822916667,2732,2461,1899,-271,-562,-833
a609,a,"Anogenital herpesviral infection, unspecified",Certain infectious and parasitic diseases,28,18,16,-0.357142857,-0.111111111,-0.428571429,4950,5747,5954,797,207,1004
a630,a,Anogenital (venereal) warts,Certain infectious and parasitic diseases,129,94,116,-0.271317829,0.234042553,-0.100775194,2308,2652,2386,344,-266,78
a6920,a,"Lyme disease, unspecified",Certain infectious and parasitic diseases,42,46,41,0.095238095,-0.108695652,-0.023809524,4125,3795,4069,-330,274,-56
a749,a,"Chlamydial infection, unspecified",Certain infectious and parasitic diseases,117,112,150,-0.042735043,0.339285714,0.282051282,2453,2407,2071,-46,-336,-382
a770,a,Spotted fever due to Rickettsia rickettsii,Certain infectious and parasitic diseases,13,17,15,0.307692308,-0.117647059,0.153846154,6480,5870,6077,-610,207,-403
a86,a,Unspecified viral encephalitis,Certain infectious and parasitic diseases,40,20,19,-0.5,-0.05,-0.525,4215,5522,5600,1307,78,1385
a879,a,"Viral meningitis, unspecified",Certain infectious and parasitic diseases,120,53,43,-0.558333333,-0.188679245,-0.641666667,2414,3544,3980,1130,436,1566
b001,b,Herpesviral vesicular dermatitis,Certain infectious and parasitic diseases,233,220,208,-0.055793991,-0.054545455,-0.107296137,1666,1684,1731,18,47,65
b002,b,Herpesviral gingivostomatitis and pharyngotonsillitis,Certain infectious and parasitic diseases,78,74,61,-0.051282051,-0.175675676,-0.217948718,3049,2999,3345,-50,346,296
b003,b,Herpesviral meningitis,Certain infectious and parasitic diseases,17,13,14,-0.235294118,0.076923077,-0.176470588,5996,6356,6199,360,-157,203
b004,b,Herpesviral encephalitis,Certain infectious and parasitic diseases,32,40,23,0.25,-0.425,-0.28125,4661,4047,5207,-614,1160,546
b0089,b,Other herpesviral infection,Certain infectious and parasitic diseases,60,36,41,-0.4,0.138888889,-0.316666667,3491,4230,4065,739,-165,574
b009,b,"Herpesviral infection, unspecified",Certain infectious and parasitic diseases,615,565,527,-0.081300813,-0.067256637,-0.143089431,900,925,990,25,65,90
b019,b,Varicella without complication,Certain infectious and parasitic diseases,15,27,24,0.8,-0.111111111,0.6,6238,4845,5125,-1393,280,-1113
b0229,b,Other postherpetic nervous system involvement,Certain infectious and parasitic diseases,184,173,134,-0.059782609,-0.225433526,-0.27173913,1906,1908,2208,2,300,302
b0230,b,"Zoster ocular disease, unspecified",Certain infectious and parasitic diseases,47,43,41,-0.085106383,-0.046511628,-0.127659574,3909,3906,4063,-3,157,154
b027,b,Disseminated zoster,Certain infectious and parasitic diseases,41,28,30,-0.317073171,0.071428571,-0.268292683,4163,4759,4672,596,-87,509
b028,b,Zoster with other complications,Certain infectious and parasitic diseases,32,23,25,-0.28125,0.086956522,-0.21875,4656,5187,5025,531,-162,369
b029,b,Zoster without complications,Certain infectious and parasitic diseases,462,459,402,-0.006493506,-0.124183007,-0.12987013,1101,1074,1174,-27,100,73
b081,b,Molluscum contagiosum,Certain infectious and parasitic diseases,20,14,18,-0.3,0.285714286,-0.1,5671,6229,5700,558,-529,29
b09,b,Unspecified viral infection characterized by skin and mucous membrane lesions,Certain infectious and parasitic diseases,32,34,23,0.0625,-0.323529412,-0.28125,4655,4322,5199,-333,877,544
b159,b,Hepatitis A without hepatic coma,Certain infectious and parasitic diseases,242,125,115,-0.483471074,-0.08,-0.524793388,1624,2282,2391,658,109,767
b169,b,Acute hepatitis B without delta-agent and without hepatic coma,Certain infectious and parasitic diseases,31,27,16,-0.129032258,-0.407407407,-0.483870968,4713,4839,5935,126,1096,1222
b1710,b,Acute hepatitis C without hepatic coma,Certain infectious and parasitic diseases,146,106,101,-0.273972603,-0.047169811,-0.308219178,2159,2455,2550,296,95,391
b179,b,"Acute viral hepatitis, unspecified",Certain infectious and parasitic diseases,207,210,225,0.014492754,0.071428571,0.086956522,1795,1727,1654,-68,-73,-141
b181,b,Chronic viral hepatitis B without delta-agent,Certain infectious and parasitic diseases,214,222,203,0.037383178,-0.085585586,-0.051401869,1756,1673,1759,-83,86,3
b182,b,Chronic viral hepatitis C,Certain infectious and parasitic diseases,3227,2796,2721,-0.133560583,-0.026824034,-0.156801983,252,281,292,29,11,40
b1910,b,Unspecified viral hepatitis B without hepatic coma,Certain infectious and parasitic diseases,371,275,296,-0.258760108,0.076363636,-0.202156334,1239,1453,1402,214,-51,163
b1920,b,Unspecified viral hepatitis C without hepatic coma,Certain infectious and parasitic diseases,3965,3503,3236,-0.116519546,-0.076220383,-0.183858764,219,231,252,12,21,33
b199,b,Unspecified viral hepatitis without hepatic coma,Certain infectious and parasitic diseases,16,28,36,0.75,0.285714286,1.25,6095,4750,4271,-1345,-479,-1824
b20,b,Human immunodeficiency virus [HIV] disease,Certain infectious and parasitic diseases,673,673,633,0,-0.059435364,-0.059435364,848,820,866,-28,46,18
b258,b,Other cytomegaloviral diseases,Certain infectious and parasitic diseases,67,56,51,-0.164179104,-0.089285714,-0.23880597,3305,3451,3645,146,194,340
b259,b,"Cytomegaloviral disease, unspecified",Certain infectious and parasitic diseases,187,152,141,-0.187165775,-0.072368421,-0.245989305,1883,2046,2126,163,80,243
b2700,b,Gammaherpesviral mononucleosis without complication,Certain infectious and parasitic diseases,51,47,46,-0.078431373,-0.021276596,-0.098039216,3762,3733,3832,-29,99,70
b2790,b,"Infectious mononucleosis, unspecified without complication",Certain infectious and parasitic diseases,27,32,27,0.185185185,-0.15625,0,5017,4450,4849,-567,399,-168
b3324,b,Viral cardiomyopathy,Certain infectious and parasitic diseases,25,34,45,0.36,0.323529412,0.8,5170,4311,3874,-859,-437,-1296
b338,b,Other specified viral diseases,Certain infectious and parasitic diseases,10,11,10,0.1,-0.090909091,0,6727,6582,6676,-145,94,-51
b340,b,"Adenovirus infection, unspecified",Certain infectious and parasitic diseases,14,21,17,0.5,-0.19047619,0.214285714,6330,5372,5807,-958,435,-523
b341,b,"Enterovirus infection, unspecified",Certain infectious and parasitic diseases,27,22,24,-0.185185185,0.090909091,-0.111111111,5017,5254,5106,237,-148,89
b348,b,Other viral infections of unspecified site,Certain infectious and parasitic diseases,242,168,102,-0.305785124,-0.392857143,-0.578512397,1620,1933,2526,313,593,906
b349,b,"Viral infection, unspecified",Certain infectious and parasitic diseases,433,550,287,0.270207852,-0.478181818,-0.337182448,1133,940,1431,-193,491,298
b350,b,Tinea barbae and tinea capitis,Certain infectious and parasitic diseases,23,18,12,-0.217391304,-0.333333333,-0.47826087,5347,5711,6436,364,725,1089
b353,b,Tinea pedis,Certain infectious and parasitic diseases,402,422,343,0.049751244,-0.187203791,-0.146766169,1181,1127,1288,-54,161,107
b354,b,Tinea corporis,Certain infectious and parasitic diseases,84,81,56,-0.035714286,-0.308641975,-0.333333333,2908,2854,3475,-54,621,567
b356,b,Tinea cruris,Certain infectious and parasitic diseases,217,240,194,0.105990783,-0.191666667,-0.105990783,1736,1570,1793,-166,223,57
b359,b,"Dermatophytosis, unspecified",Certain infectious and parasitic diseases,45,61,51,0.355555556,-0.163934426,0.133333333,3970,3317,3639,-653,322,-331
b360,b,Pityriasis versicolor,Certain infectious and parasitic diseases,15,10,11,-0.333333333,0.1,-0.266666667,6208,6689,6562,481,-127,354
b368,b,Other specified superficial mycoses,Certain infectious and parasitic diseases,36,35,35,-0.027777778,0,-0.027777778,4389,4257,4329,-132,72,-60
b369,b,"Superficial mycosis, unspecified",Certain infectious and parasitic diseases,145,150,149,0.034482759,-0.006666667,0.027586207,2153,2054,2069,-99,15,-84
b370,b,Candidal stomatitis,Certain infectious and parasitic diseases,1520,1501,1144,-0.0125,-0.237841439,-0.247368421,476,465,567,-11,102,91
b371,b,Pulmonary candidiasis,Certain infectious and parasitic diseases,63,57,98,-0.095238095,0.719298246,0.555555556,3399,3414,2586,15,-828,-813
b372,b,Candidiasis of skin and nail,Certain infectious and parasitic diseases,498,476,439,-0.044176707,-0.077731092,-0.118473896,1046,1038,1113,-8,75,67
b373,b,Candidiasis of vulva and vagina,Certain infectious and parasitic diseases,427,393,458,-0.079625293,0.165394402,0.072599532,1139,1161,1080,22,-81,-59
b3741,b,Candidal cystitis and urethritis,Certain infectious and parasitic diseases,44,37,52,-0.159090909,0.405405405,0.181818182,4012,4159,3602,147,-557,-410
b3742,b,Candidal balanitis,Certain infectious and parasitic diseases,15,14,17,-0.066666667,0.214285714,0.133333333,6201,6197,5793,-4,-404,-408
b3749,b,Other urogenital candidiasis,Certain infectious and parasitic diseases,394,452,590,0.147208122,0.305309735,0.497461929,1190,1079,906,-111,-173,-284
b377,b,Candidal sepsis,Certain infectious and parasitic diseases,113,101,147,-0.10619469,0.455445545,0.300884956,2478,2499,2075,21,-424,-403
b3781,b,Candidal esophagitis,Certain infectious and parasitic diseases,364,377,306,0.035714286,-0.188328912,-0.159340659,1247,1194,1370,-53,176,123
b3789,b,Other sites of candidiasis,Certain infectious and parasitic diseases,190,165,207,-0.131578947,0.254545455,0.089473684,1861,1945,1724,84,-221,-137
b379,b,"Candidiasis, unspecified",Certain infectious and parasitic diseases,423,426,444,0.007092199,0.042253521,0.04964539,1145,1114,1102,-31,-12,-43
b380,b,Acute pulmonary coccidioidomycosis,Certain infectious and parasitic diseases,520,461,710,-0.113461538,0.540130152,0.365384615,1017,1066,803,49,-263,-214
b381,b,Chronic pulmonary coccidioidomycosis,Certain infectious and parasitic diseases,165,151,159,-0.084848485,0.052980132,-0.036363636,1994,2039,1982,45,-57,-12
b382,b,"Pulmonary coccidioidomycosis, unspecified",Certain infectious and parasitic diseases,627,575,909,-0.082934609,0.580869565,0.449760766,885,909,667,24,-242,-218
b384,b,Coccidioidomycosis meningitis,Certain infectious and parasitic diseases,80,98,89,0.225,-0.091836735,0.1125,2981,2542,2727,-439,185,-254
b387,b,Disseminated coccidioidomycosis,Certain infectious and parasitic diseases,145,151,148,0.04137931,-0.01986755,0.020689655,2143,2038,2065,-105,27,-78
b3889,b,Other forms of coccidioidomycosis,Certain infectious and parasitic diseases,18,18,21,0,0.166666667,0.166666667,5840,5690,5347,-150,-343,-493
b389,b,"Coccidioidomycosis, unspecified",Certain infectious and parasitic diseases,304,353,379,0.161184211,0.073654391,0.246710526,1418,1239,1210,-179,-29,-208
b440,b,Invasive pulmonary aspergillosis,Certain infectious and parasitic diseases,24,15,15,-0.375,0,-0.375,5227,6045,6019,818,-26,792
b441,b,Other pulmonary aspergillosis,Certain infectious and parasitic diseases,68,86,94,0.264705882,0.093023256,0.382352941,3248,2753,2636,-495,-117,-612
b4481,b,Allergic bronchopulmonary aspergillosis,Certain infectious and parasitic diseases,35,26,25,-0.257142857,-0.038461538,-0.285714286,4427,4879,4985,452,106,558
b449,b,"Aspergillosis, unspecified",Certain infectious and parasitic diseases,57,81,100,0.421052632,0.234567901,0.754385965,3553,2837,2539,-716,-298,-1014
b451,b,Cerebral cryptococcosis,Certain infectious and parasitic diseases,23,14,13,-0.391304348,-0.071428571,-0.434782609,5321,6181,6279,860,98,958
b465,b,"Mucormycosis, unspecified",Certain infectious and parasitic diseases,13,17,12,0.307692308,-0.294117647,-0.076923077,6414,5810,6407,-604,597,-7
b488,b,Other specified mycoses,Certain infectious and parasitic diseases,57,63,62,0.105263158,-0.015873016,0.087719298,3553,3246,3281,-307,35,-272
b49,b,Unspecified mycosis,Certain infectious and parasitic diseases,170,142,180,-0.164705882,0.267605634,0.058823529,1971,2103,1853,132,-250,-118
b59,b,Pneumocystosis,Certain infectious and parasitic diseases,86,73,84,-0.151162791,0.150684932,-0.023255814,2850,2997,2795,147,-202,-55
b850,b,Pediculosis due to Pediculus humanus capitis,Certain infectious and parasitic diseases,138,140,167,0.014492754,0.192857143,0.210144928,2203,2119,1926,-84,-193,-277
b852,b,"Pediculosis, unspecified",Certain infectious and parasitic diseases,87,61,52,-0.298850575,-0.147540984,-0.402298851,2834,3296,3585,462,289,751
b86,b,Scabies,Certain infectious and parasitic diseases,89,64,62,-0.280898876,-0.03125,-0.303370787,2802,3218,3278,416,60,476
b871,b,Wound myiasis,Certain infectious and parasitic diseases,15,29,16,0.933333333,-0.448275862,0.066666667,6178,4625,5885,-1553,1260,-293
b888,b,Other specified infestations,Certain infectious and parasitic diseases,53,26,27,-0.509433962,0.038461538,-0.490566038,3662,4871,4816,1209,-55,1154
b91,b,Sequelae of poliomyelitis,Certain infectious and parasitic diseases,32,43,46,0.34375,0.069767442,0.4375,4610,3864,3801,-746,-63,-809
b948,b,Sequelae of other specified infectious and parasitic diseases,Certain infectious and parasitic diseases,25,24,294,-0.04,11.25,10.76,5134,5038,1395,-96,-3643,-3739
b950,b,"Streptococcus, group A, as the cause of diseases classified elsewhere",Certain infectious and parasitic diseases,273,373,294,0.366300366,-0.211796247,0.076923077,1500,1198,1395,-302,197,-105
b951,b,"Streptococcus, group B, as the cause of diseases classified elsewhere",Certain infectious and parasitic diseases,767,839,814,0.093872229,-0.029797378,0.061277705,766,695,720,-71,25,-46
b952,b,Enterococcus as the cause of diseases classified elsewhere,Certain infectious and parasitic diseases,1758,1734,1765,-0.013651877,0.017877739,0.003981797,426,418,418,-8,0,-8
b953,b,Streptococcus pneumoniae as the cause of diseases classified elsewhere,Certain infectious and parasitic diseases,72,88,53,0.222222222,-0.397727273,-0.263888889,3150,2706,3543,-444,837,393
b954,b,Other streptococcus as the cause of diseases classified elsewhere,Certain infectious and parasitic diseases,713,723,708,0.014025245,-0.020746888,-0.007012623,807,771,800,-36,29,-7
b9561,b,Methicillin susceptible Staphylococcus aureus infection as the cause of diseases classified elsewhere,Certain infectious and parasitic diseases,2190,1937,1949,-0.115525114,0.006195147,-0.110045662,349,375,390,26,15,41
b9562,b,Methicillin resistant Staphylococcus aureus infection as the cause of diseases classified elsewhere,Certain infectious and parasitic diseases,2498,2045,1979,-0.181345076,-0.032273839,-0.207766213,312,358,386,46,28,74
b957,b,Other staphylococcus as the cause of diseases classified elsewhere,Certain infectious and parasitic diseases,684,625,702,-0.08625731,0.1232,0.026315789,834,855,803,21,-52,-31
b958,b,Unspecified staphylococcus as the cause of diseases classified elsewhere,Certain infectious and parasitic diseases,257,237,270,-0.077821012,0.139240506,0.050583658,1542,1567,1466,25,-101,-76
b960,b,Mycoplasma pneumoniae [M. pneumoniae] as the cause of diseases classified elsewhere,Certain infectious and parasitic diseases,18,11,10,-0.388888889,-0.090909091,-0.444444444,5816,6528,6621,712,93,805
b961,b,Klebsiella pneumoniae [K. pneumoniae] as the cause of diseases classified elsewhere,Certain infectious and parasitic diseases,2988,2678,2951,-0.103748327,0.101941748,-0.012382865,263,286,274,23,-12,11
b9620,b,Unspecified Escherichia coli [E. coli] as the cause of diseases classified elsewhere,Certain infectious and parasitic diseases,7083,6447,6464,-0.089792461,0.002636885,-0.087392348,115,125,131,10,6,16
b9629,b,Other Escherichia coli [E. coli] as the cause of diseases classified elsewhere,Certain infectious and parasitic diseases,59,56,56,-0.050847458,0,-0.050847458,3475,3409,3440,-66,31,-35
b963,b,Hemophilus influenzae [H. influenzae] as the cause of diseases classified elsewhere,Certain infectious and parasitic diseases,59,72,26,0.220338983,-0.638888889,-0.559322034,3475,3011,4878,-464,1867,1403
b964,b,Proteus (mirabilis) (morganii) as the cause of diseases classified elsewhere,Certain infectious and parasitic diseases,812,801,801,-0.013546798,0,-0.013546798,731,712,724,-19,12,-7
b965,b,Pseudomonas (aeruginosa) (mallei) (pseudomallei) as the cause of diseases classified elsewhere,Certain infectious and parasitic diseases,1983,1731,1805,-0.127080182,0.042749856,-0.089762985,378,415,409,37,-6,31
b966,b,Bacteroides fragilis [B. fragilis] as the cause of diseases classified elsewhere,Certain infectious and parasitic diseases,153,162,160,0.058823529,-0.012345679,0.045751634,2065,1951,1958,-114,7,-107
b967,b,Clostridium perfringens [C. perfringens] as the cause of diseases classified elsewhere,Certain infectious and parasitic diseases,39,27,34,-0.307692308,0.259259259,-0.128205128,4205,4776,4348,571,-428,143
b9681,b,Helicobacter pylori [H. pylori] as the cause of diseases classified elsewhere,Certain infectious and parasitic diseases,294,259,238,-0.119047619,-0.081081081,-0.19047619,1432,1485,1579,53,94,147
b9689,b,Other specified bacterial agents as the cause of diseases classified elsewhere,Certain infectious and parasitic diseases,2528,2454,2431,-0.029272152,-0.009372453,-0.038370253,305,309,313,4,4,8
b970,b,Adenovirus as the cause of diseases classified elsewhere,Certain infectious and parasitic diseases,89,137,26,0.539325843,-0.810218978,-0.707865169,2787,2133,4872,-654,2739,2085
b9710,b,Unspecified enterovirus as the cause of diseases classified elsewhere,Certain infectious and parasitic diseases,367,355,134,-0.032697548,-0.622535211,-0.634877384,1223,1218,2165,-5,947,942
b9729,b,Other coronavirus as the cause of diseases classified elsewhere,Certain infectious and parasitic diseases,91,388,28,3.263736264,-0.927835052,-0.692307692,2754,1157,4732,-1597,3575,1978
b974,b,Respiratory syncytial virus as the cause of diseases classified elsewhere,Certain infectious and parasitic diseases,126,593,13,3.706349206,-0.978077572,-0.896825397,2294,883,6247,-1411,5364,3953
b9789,b,Other viral agents as the cause of diseases classified elsewhere,Certain infectious and parasitic diseases,1193,1147,400,-0.038558256,-0.651264167,-0.664710813,550,549,1153,-1,604,603
b998,b,Other infectious disease,Certain infectious and parasitic diseases,43,26,35,-0.395348837,0.346153846,-0.186046512,4010,4846,4283,836,-563,273
b999,b,Unspecified infectious disease,Certain infectious and parasitic diseases,62,30,30,-0.516129032,0,-0.516129032,3384,4530,4603,1146,73,1219
c01,c,Malignant neoplasm of base of tongue,Neoplasms,59,65,62,0.101694915,-0.046153846,0.050847458,3464,3171,3260,-293,89,-204
c021,c,Malignant neoplasm of border of tongue,Neoplasms,13,14,10,0.076923077,-0.285714286,-0.230769231,6376,6143,6603,-233,460,227
c029,c,"Malignant neoplasm of tongue, unspecified",Neoplasms,126,90,79,-0.285714286,-0.122222222,-0.373015873,2293,2654,2878,361,224,585
c049,c,"Malignant neoplasm of floor of mouth, unspecified",Neoplasms,20,20,22,0,0.1,0.1,5588,5427,5215,-161,-212,-373
c060,c,Malignant neoplasm of cheek mucosa,Neoplasms,13,17,13,0.307692308,-0.235294118,0,6374,5771,6241,-603,470,-133
c069,c,"Malignant neoplasm of mouth, unspecified",Neoplasms,38,27,46,-0.289473684,0.703703704,0.210526316,4236,4766,3779,530,-987,-457
c07,c,Malignant neoplasm of parotid gland,Neoplasms,32,33,44,0.03125,0.333333333,0.375,4581,4325,3861,-256,-464,-720
c099,c,"Malignant neoplasm of tonsil, unspecified",Neoplasms,69,66,66,-0.043478261,0,-0.043478261,3200,3149,3154,-51,5,-46
c109,c,"Malignant neoplasm of oropharynx, unspecified",Neoplasms,49,52,55,0.06122449,0.057692308,0.12244898,3773,3505,3464,-268,-41,-309
c119,c,"Malignant neoplasm of nasopharynx, unspecified",Neoplasms,20,32,20,0.6,-0.375,0,5584,4388,5393,-1196,1005,-191
c139,c,"Malignant neoplasm of hypopharynx, unspecified",Neoplasms,10,20,17,1,-0.15,0.7,6644,5422,5736,-1222,314,-908
c140,c,"Malignant neoplasm of pharynx, unspecified",Neoplasms,68,66,61,-0.029411765,-0.075757576,-0.102941176,3220,3149,3285,-71,136,65
c155,c,Malignant neoplasm of lower third of esophagus,Neoplasms,85,98,98,0.152941176,0,0.152941176,2850,2518,2553,-332,35,-297
c159,c,"Malignant neoplasm of esophagus, unspecified",Neoplasms,228,245,215,0.074561404,-0.12244898,-0.057017544,1649,1527,1659,-122,132,10
c160,c,Malignant neoplasm of cardia,Neoplasms,85,63,75,-0.258823529,0.19047619,-0.117647059,2849,3214,2950,365,-264,101
c169,c,"Malignant neoplasm of stomach, unspecified",Neoplasms,234,218,172,-0.068376068,-0.211009174,-0.264957265,1627,1655,1880,28,225,253
c170,c,Malignant neoplasm of duodenum,Neoplasms,35,39,44,0.114285714,0.128205128,0.257142857,4383,4010,3854,-373,-156,-529
c179,c,"Malignant neoplasm of small intestine, unspecified",Neoplasms,18,19,11,0.055555556,-0.421052632,-0.388888889,5785,5524,6484,-261,960,699
c180,c,Malignant neoplasm of cecum,Neoplasms,137,118,128,-0.138686131,0.084745763,-0.065693431,2188,2294,2217,106,-77,29
c181,c,Malignant neoplasm of appendix,Neoplasms,62,49,80,-0.209677419,0.632653061,0.290322581,3376,3595,2850,219,-745,-526
c182,c,Malignant neoplasm of ascending colon,Neoplasms,197,194,162,-0.015228426,-0.164948454,-0.177664975,1801,1778,1941,-23,163,140
c183,c,Malignant neoplasm of hepatic flexure,Neoplasms,34,39,41,0.147058824,0.051282051,0.205882353,4438,4007,3983,-431,-24,-455
c184,c,Malignant neoplasm of transverse colon,Neoplasms,78,87,75,0.115384615,-0.137931034,-0.038461538,2985,2704,2946,-281,242,-39
c185,c,Malignant neoplasm of splenic flexure,Neoplasms,16,20,20,0.25,0,0.25,6001,5411,5382,-590,-29,-619
c186,c,Malignant neoplasm of descending colon,Neoplasms,44,49,45,0.113636364,-0.081632653,0.022727273,3955,3593,3808,-362,215,-147
c187,c,Malignant neoplasm of sigmoid colon,Neoplasms,201,224,205,0.114427861,-0.084821429,0.019900498,1784,1627,1713,-157,86,-71
c189,c,"Malignant neoplasm of colon, unspecified",Neoplasms,647,625,591,-0.034003091,-0.0544,-0.086553323,851,849,892,-2,43,41
c19,c,Malignant neoplasm of rectosigmoid junction,Neoplasms,364,300,309,-0.175824176,0.03,-0.151098901,1230,1353,1343,123,-10,113
c20,c,Malignant neoplasm of rectum,Neoplasms,478,404,413,-0.154811715,0.022277228,-0.135983264,1051,1129,1138,78,9,87
c210,c,"Malignant neoplasm of anus, unspecified",Neoplasms,45,49,52,0.088888889,0.06122449,0.155555556,3904,3589,3547,-315,-42,-357
c211,c,Malignant neoplasm of anal canal,Neoplasms,10,11,10,0.1,-0.090909091,0,6625,6481,6575,-144,94,-50
c218,c,"Malignant neoplasm of overlapping sites of rectum, anus and anal canal",Neoplasms,34,26,25,-0.235294118,-0.038461538,-0.264705882,4431,4821,4927,390,106,496
c220,c,Liver cell carcinoma,Neoplasms,505,456,495,-0.097029703,0.085526316,-0.01980198,1022,1057,1005,35,-52,-17
c221,c,Intrahepatic bile duct carcinoma,Neoplasms,252,236,279,-0.063492063,0.18220339,0.107142857,1546,1555,1429,9,-126,-117
c227,c,Other specified carcinomas of liver,Neoplasms,17,16,14,-0.058823529,-0.125,-0.176470588,5875,5862,6076,-13,214,201
c228,c,"Malignant neoplasm of liver, primary, unspecified as to type",Neoplasms,48,35,37,-0.270833333,0.057142857,-0.229166667,3797,4185,4140,388,-45,343
c229,c,"Malignant neoplasm of liver, not specified as primary or secondary",Neoplasms,79,87,64,0.101265823,-0.264367816,-0.189873418,2963,2698,3191,-265,493,228
c23,c,Malignant neoplasm of gallbladder,Neoplasms,59,87,76,0.474576271,-0.126436782,0.288135593,3446,2698,2923,-748,225,-523
c240,c,Malignant neoplasm of extrahepatic bile duct,Neoplasms,56,32,32,-0.428571429,0,-0.428571429,3529,4366,4445,837,79,916
c241,c,Malignant neoplasm of ampulla of Vater,Neoplasms,33,29,31,-0.121212121,0.068965517,-0.060606061,4485,4571,4512,86,-59,27
c249,c,"Malignant neoplasm of biliary tract, unspecified",Neoplasms,22,15,11,-0.318181818,-0.266666667,-0.5,5351,5967,6463,616,496,1112
c250,c,Malignant neoplasm of head of pancreas,Neoplasms,249,221,244,-0.112449799,0.104072398,-0.020080321,1558,1636,1550,78,-86,-8
c251,c,Malignant neoplasm of body of pancreas,Neoplasms,41,50,48,0.219512195,-0.04,0.170731707,4068,3545,3677,-523,132,-391
c252,c,Malignant neoplasm of tail of pancreas,Neoplasms,49,58,57,0.183673469,-0.017241379,0.163265306,3754,3324,3385,-430,61,-369
c253,c,Malignant neoplasm of pancreatic duct,Neoplasms,15,29,33,0.933333333,0.137931034,1.2,6108,4568,4380,-1540,-188,-1728
c259,c,"Malignant neoplasm of pancreas, unspecified",Neoplasms,632,608,655,-0.037974684,0.077302632,0.036392405,864,870,826,6,-44,-38
c269,c,Malignant neoplasm of ill-defined sites within the digestive system,Neoplasms,14,11,14,-0.214285714,0.272727273,0,6217,6466,6066,249,-400,-151
c320,c,Malignant neoplasm of glottis,Neoplasms,11,18,13,0.636363636,-0.277777778,0.181818182,6527,5609,6202,-918,593,-325
c321,c,Malignant neoplasm of supraglottis,Neoplasms,34,20,22,-0.411764706,0.1,-0.352941176,4421,5392,5181,971,-211,760
c329,c,"Malignant neoplasm of larynx, unspecified",Neoplasms,65,77,73,0.184615385,-0.051948052,0.123076923,3285,2859,2987,-426,128,-298
c3401,c,Malignant neoplasm of right main bronchus,Neoplasms,40,42,27,0.05,-0.357142857,-0.325,4108,3857,4755,-251,898,647
c3402,c,Malignant neoplasm of left main bronchus,Neoplasms,35,22,19,-0.371428571,-0.136363636,-0.457142857,4361,5152,5468,791,316,1107
c3411,c,"Malignant neoplasm of upper lobe, right bronchus or lung",Neoplasms,400,395,353,-0.0125,-0.106329114,-0.1175,1161,1137,1244,-24,107,83
c3412,c,"Malignant neoplasm of upper lobe, left bronchus or lung",Neoplasms,329,286,248,-0.130699088,-0.132867133,-0.246200608,1312,1386,1531,74,145,219
c342,c,"Malignant neoplasm of middle lobe, bronchus or lung",Neoplasms,62,43,49,-0.306451613,0.139534884,-0.209677419,3362,3811,3637,449,-174,275
c3431,c,"Malignant neoplasm of lower lobe, right bronchus or lung",Neoplasms,225,213,174,-0.053333333,-0.183098592,-0.226666667,1658,1664,1857,6,193,199
c3432,c,"Malignant neoplasm of lower lobe, left bronchus or lung",Neoplasms,187,190,150,0.016042781,-0.210526316,-0.197860963,1839,1788,2015,-51,227,176
c3481,c,Malignant neoplasm of overlapping sites of right bronchus and lung,Neoplasms,21,14,13,-0.333333333,-0.071428571,-0.380952381,5430,6090,6193,660,103,763
c3490,c,Malignant neoplasm of unspecified part of unspecified bronchus or lung,Neoplasms,1473,1468,1243,-0.003394433,-0.153269755,-0.156143924,481,465,535,-16,70,54
c3491,c,Malignant neoplasm of unspecified part of right bronchus or lung,Neoplasms,283,285,255,0.007067138,-0.105263158,-0.098939929,1446,1388,1506,-58,118,60
c3492,c,Malignant neoplasm of unspecified part of left bronchus or lung,Neoplasms,218,201,195,-0.077981651,-0.029850746,-0.105504587,1683,1723,1750,40,27,67
c37,c,Malignant neoplasm of thymus,Neoplasms,15,22,19,0.466666667,-0.136363636,0.266666667,6094,5144,5460,-950,316,-634
c4002,c,Malignant neoplasm of scapula and long bones of left upper limb,Neoplasms,18,35,20,0.944444444,-0.428571429,0.111111111,5748,4169,5352,-1579,1183,-396
c4021,c,Malignant neoplasm of long bones of right lower limb,Neoplasms,46,54,59,0.173913043,0.092592593,0.282608696,3840,3415,3321,-425,-94,-519
c4022,c,Malignant neoplasm of long bones of left lower limb,Neoplasms,116,89,72,-0.232758621,-0.191011236,-0.379310345,2393,2650,3000,257,350,607
c411,c,Malignant neoplasm of mandible,Neoplasms,37,34,22,-0.081081081,-0.352941176,-0.405405405,4240,4212,5169,-28,957,929
c412,c,Malignant neoplasm of vertebral column,Neoplasms,33,25,19,-0.242424242,-0.24,-0.424242424,4466,4868,5456,402,588,990
c414,c,"Malignant neoplasm of pelvic bones, sacrum and coccyx",Neoplasms,65,70,37,0.076923077,-0.471428571,-0.430769231,3277,3011,4123,-266,1112,846
c419,c,"Malignant neoplasm of bone and articular cartilage, unspecified",Neoplasms,80,52,69,-0.35,0.326923077,-0.1375,2931,3475,3069,544,-406,138
c434,c,Malignant melanoma of scalp and neck,Neoplasms,26,33,14,0.269230769,-0.575757576,-0.461538462,4980,4281,6046,-699,1765,1066
c4359,c,Malignant melanoma of other part of trunk,Neoplasms,20,25,15,0.25,-0.4,-0.25,5534,4865,5921,-669,1056,387
c439,c,"Malignant melanoma of skin, unspecified",Neoplasms,217,201,190,-0.073732719,-0.054726368,-0.124423963,1696,1723,1776,27,53,80
c44319,c,Basal cell carcinoma of skin of other parts of face,Neoplasms,14,12,13,-0.142857143,0.083333333,-0.071428571,6193,6321,6179,128,-142,-14
c44320,c,Squamous cell carcinoma of skin of unspecified parts of face,Neoplasms,11,15,12,0.363636364,-0.2,0.090909091,6502,5938,6302,-564,364,-200
c44329,c,Squamous cell carcinoma of skin of other parts of face,Neoplasms,32,32,29,0,-0.09375,-0.09375,4531,4344,4600,-187,256,69
c4440,c,Unspecified malignant neoplasm of skin of scalp and neck,Neoplasms,10,12,13,0.2,0.083333333,0.3,6581,6319,6178,-262,-141,-403
c4442,c,Squamous cell carcinoma of skin of scalp and neck,Neoplasms,47,33,35,-0.29787234,0.060606061,-0.255319149,3804,4280,4237,476,-43,433
c4490,c,"Unspecified malignant neoplasm of skin, unspecified",Neoplasms,102,99,63,-0.029411765,-0.363636364,-0.382352941,2565,2482,3204,-83,722,639
c4491,c,"Basal cell carcinoma of skin, unspecified",Neoplasms,58,50,37,-0.137931034,-0.26,-0.362068966,3462,3529,4120,67,591,658
c4492,c,"Squamous cell carcinoma of skin, unspecified",Neoplasms,31,43,21,0.387096774,-0.511627907,-0.322580645,4584,3799,5251,-785,1452,667
c457,c,Mesothelioma of other sites,Neoplasms,14,12,14,-0.142857143,0.166666667,0,6188,6315,6039,127,-276,-149
c459,c,"Mesothelioma, unspecified",Neoplasms,26,22,18,-0.153846154,-0.181818182,-0.307692308,4974,5129,5557,155,428,583
c469,c,"Kaposi's sarcoma, unspecified",Neoplasms,21,15,12,-0.285714286,-0.2,-0.428571429,5413,5932,6294,519,362,881
c480,c,Malignant neoplasm of retroperitoneum,Neoplasms,67,65,67,-0.029850746,0.030769231,0,3227,3140,3100,-87,-40,-127
c482,c,"Malignant neoplasm of peritoneum, unspecified",Neoplasms,37,20,19,-0.459459459,-0.05,-0.486486486,4233,5363,5447,1130,84,1214
c490,c,"Malignant neoplasm of connective and soft tissue of head, face and neck",Neoplasms,41,21,24,-0.487804878,0.142857143,-0.414634146,4048,5242,4989,1194,-253,941
c4921,c,"Malignant neoplasm of connective and soft tissue of right lower limb, including hip",Neoplasms,34,38,25,0.117647059,-0.342105263,-0.264705882,4398,4017,4895,-381,878,497
c4922,c,"Malignant neoplasm of connective and soft tissue of left lower limb, including hip",Neoplasms,54,38,36,-0.296296296,-0.052631579,-0.333333333,3575,4017,4165,442,148,590
c493,c,Malignant neoplasm of connective and soft tissue of thorax,Neoplasms,18,25,31,0.388888889,0.24,0.722222222,5727,4856,4488,-871,-368,-1239
c494,c,Malignant neoplasm of connective and soft tissue of abdomen,Neoplasms,18,17,22,-0.055555556,0.294117647,0.222222222,5727,5697,5157,-30,-540,-570
c495,c,Malignant neoplasm of connective and soft tissue of pelvis,Neoplasms,15,26,26,0.733333333,0,0.733333333,6070,4783,4810,-1287,27,-1260
c499,c,"Malignant neoplasm of connective and soft tissue, unspecified",Neoplasms,139,94,101,-0.323741007,0.074468085,-0.273381295,2154,2575,2485,421,-90,331
c49a0,c,"Gastrointestinal stromal tumor, unspecified site",Neoplasms,32,32,20,0,-0.375,-0.375,4522,4336,5333,-186,997,811
c49a2,c,Gastrointestinal stromal tumor of stomach,Neoplasms,55,43,47,-0.218181818,0.093023256,-0.145454545,3546,3797,3702,251,-95,156
c49a3,c,Gastrointestinal stromal tumor of small intestine,Neoplasms,28,20,21,-0.285714286,0.05,-0.25,4794,5355,5242,561,-113,448
c50111,c,Malignant neoplasm of central portion of right female breast,Neoplasms,15,11,14,-0.266666667,0.272727273,-0.066666667,6066,6418,6026,352,-392,-40
c50411,c,Malignant neoplasm of upper-outer quadrant of right female breast,Neoplasms,44,24,31,-0.454545455,0.291666667,-0.295454545,3920,4942,4486,1022,-456,566
c50412,c,Malignant neoplasm of upper-outer quadrant of left female breast,Neoplasms,40,46,29,0.15,-0.369565217,-0.275,4086,3680,4591,-406,911,505
c50812,c,Malignant neoplasm of overlapping sites of left female breast,Neoplasms,17,16,21,-0.058823529,0.3125,0.235294118,5822,5808,5240,-14,-568,-582
c50911,c,Malignant neoplasm of unspecified site of right female breast,Neoplasms,340,292,249,-0.141176471,-0.147260274,-0.267647059,1278,1372,1525,94,153,247
c50912,c,Malignant neoplasm of unspecified site of left female breast,Neoplasms,380,286,273,-0.247368421,-0.045454545,-0.281578947,1193,1384,1445,191,61,252
c50919,c,Malignant neoplasm of unspecified site of unspecified female breast,Neoplasms,808,737,718,-0.087871287,-0.02578019,-0.111386139,728,753,785,25,32,57
c519,c,"Malignant neoplasm of vulva, unspecified",Neoplasms,36,38,45,0.055555556,0.184210526,0.25,4277,4011,3775,-266,-236,-502
c52,c,Malignant neoplasm of vagina,Neoplasms,17,23,21,0.352941176,-0.086956522,0.235294118,5818,5031,5236,-787,205,-582
c530,c,Malignant neoplasm of endocervix,Neoplasms,18,11,12,-0.388888889,0.090909091,-0.333333333,5717,6410,6273,693,-137,556
c539,c,"Malignant neoplasm of cervix uteri, unspecified",Neoplasms,227,203,214,-0.105726872,0.054187192,-0.057268722,1643,1710,1653,67,-57,10
c541,c,Malignant neoplasm of endometrium,Neoplasms,316,273,244,-0.136075949,-0.106227106,-0.227848101,1350,1418,1542,68,124,192
c55,c,"Malignant neoplasm of uterus, part unspecified",Neoplasms,94,118,98,0.255319149,-0.169491525,0.042553191,2675,2272,2527,-403,255,-148
c561,c,Malignant neoplasm of right ovary,Neoplasms,93,96,76,0.032258065,-0.208333333,-0.182795699,2690,2533,2906,-157,373,216
c562,c,Malignant neoplasm of left ovary,Neoplasms,110,97,84,-0.118181818,-0.134020619,-0.236363636,2463,2513,2748,50,235,285
c569,c,Malignant neoplasm of unspecified ovary,Neoplasms,395,373,381,-0.055696203,0.021447721,-0.035443038,1165,1177,1187,12,10,22
c609,c,"Malignant neoplasm of penis, unspecified",Neoplasms,10,17,13,0.7,-0.235294118,0.3,6546,5679,6145,-867,466,-401
c61,c,Malignant neoplasm of prostate,Neoplasms,1915,1804,1685,-0.057963446,-0.065964523,-0.120104439,390,401,425,11,24,35
c6290,c,"Malignant neoplasm of unspecified testis, unspecified whether descended or undescended",Neoplasms,57,54,50,-0.052631579,-0.074074074,-0.122807018,3475,3399,3578,-76,179,103
c6291,c,"Malignant neoplasm of right testis, unspecified whether descended or undescended",Neoplasms,29,17,27,-0.413793103,0.588235294,-0.068965517,4707,5677,4719,970,-958,12
c6292,c,"Malignant neoplasm of left testis, unspecified whether descended or undescended",Neoplasms,17,13,21,-0.235294118,0.615384615,0.235294118,5808,6151,5227,343,-924,-581
c641,c,"Malignant neoplasm of right kidney, except renal pelvis",Neoplasms,269,262,182,-0.026022305,-0.305343511,-0.323420074,1482,1442,1807,-40,365,325
c642,c,"Malignant neoplasm of left kidney, except renal pelvis",Neoplasms,281,226,214,-0.195729537,-0.053097345,-0.238434164,1449,1599,1650,150,51,201
c649,c,"Malignant neoplasm of unspecified kidney, except renal pelvis",Neoplasms,310,271,267,-0.125806452,-0.014760148,-0.138709677,1367,1423,1460,56,37,93
c651,c,Malignant neoplasm of right renal pelvis,Neoplasms,21,20,18,-0.047619048,-0.1,-0.142857143,5386,5337,5524,-49,187,138
c652,c,Malignant neoplasm of left renal pelvis,Neoplasms,12,14,16,0.166666667,0.142857143,0.333333333,6360,6034,5756,-326,-278,-604
c661,c,Malignant neoplasm of right ureter,Neoplasms,25,24,20,-0.04,-0.166666667,-0.2,5020,4926,5310,-94,384,290
c662,c,Malignant neoplasm of left ureter,Neoplasms,40,21,24,-0.475,0.142857143,-0.4,4072,5216,4965,1144,-251,893
c672,c,Malignant neoplasm of lateral wall of bladder,Neoplasms,21,22,15,0.047619048,-0.318181818,-0.285714286,5384,5102,5877,-282,775,493
c674,c,Malignant neoplasm of posterior wall of bladder,Neoplasms,16,14,15,-0.125,0.071428571,-0.0625,5914,6031,5877,117,-154,-37
c678,c,Malignant neoplasm of overlapping sites of bladder,Neoplasms,23,27,23,0.173913043,-0.148148148,0,5196,4688,5041,-508,353,-155
c679,c,"Malignant neoplasm of bladder, unspecified",Neoplasms,773,760,659,-0.016817594,-0.132894737,-0.147477361,746,731,817,-15,86,71
c680,c,Malignant neoplasm of urethra,Neoplasms,19,19,13,0,-0.315789474,-0.315789474,5592,5435,6130,-157,695,538
c689,c,"Malignant neoplasm of urinary organ, unspecified",Neoplasms,20,20,26,0,0.3,0.3,5493,5332,4789,-161,-543,-704
c710,c,"Malignant neoplasm of cerebrum, except lobes and ventricles",Neoplasms,16,22,13,0.375,-0.409090909,-0.1875,5910,5100,6129,-810,1029,219
c711,c,Malignant neoplasm of frontal lobe,Neoplasms,134,130,118,-0.029850746,-0.092307692,-0.119402985,2187,2158,2285,-29,127,98
c712,c,Malignant neoplasm of temporal lobe,Neoplasms,86,85,79,-0.011627907,-0.070588235,-0.081395349,2788,2700,2841,-88,141,53
c713,c,Malignant neoplasm of parietal lobe,Neoplasms,49,50,55,0.020408163,0.1,0.12244898,3717,3510,3413,-207,-97,-304
c714,c,Malignant neoplasm of occipital lobe,Neoplasms,12,13,17,0.083333333,0.307692308,0.416666667,6348,6134,5636,-214,-498,-712
c716,c,Malignant neoplasm of cerebellum,Neoplasms,50,54,38,0.08,-0.296296296,-0.24,3687,3393,4061,-294,668,374
c717,c,Malignant neoplasm of brain stem,Neoplasms,17,21,11,0.235294118,-0.476190476,-0.352941176,5793,5208,6369,-585,1161,576
c718,c,Malignant neoplasm of overlapping sites of brain,Neoplasms,24,20,15,-0.166666667,-0.25,-0.375,5094,5326,5869,232,543,775
c719,c,"Malignant neoplasm of brain, unspecified",Neoplasms,325,223,284,-0.313846154,0.273542601,-0.126153846,1318,1611,1406,293,-205,88
c720,c,Malignant neoplasm of spinal cord,Neoplasms,12,14,21,0.166666667,0.5,0.75,6344,6019,5215,-325,-804,-1129
c73,c,Malignant neoplasm of thyroid gland,Neoplasms,200,202,164,0.01,-0.188118812,-0.18,1765,1706,1902,-59,196,137
c7490,c,Malignant neoplasm of unspecified part of unspecified adrenal gland,Neoplasms,39,40,29,0.025641026,-0.275,-0.256410256,4120,3908,4569,-212,661,449
c7492,c,Malignant neoplasm of unspecified part of left adrenal gland,Neoplasms,12,11,22,-0.083333333,1,0.833333333,6342,6374,5125,32,-1249,-1217
c7a090,c,Malignant carcinoid tumor of the bronchus and lung,Neoplasms,28,16,16,-0.428571429,0,-0.428571429,4767,5772,5741,1005,-31,974
c7a1,c,Malignant poorly differentiated neuroendocrine tumors,Neoplasms,50,46,63,-0.08,0.369565217,0.26,3685,3659,3184,-26,-475,-501
c7a8,c,Other malignant neuroendocrine tumors,Neoplasms,127,157,141,0.236220472,-0.101910828,0.11023622,2246,1947,2058,-299,111,-188
c7b02,c,Secondary carcinoid tumors of liver,Neoplasms,28,25,20,-0.107142857,-0.2,-0.285714286,4765,4825,5295,60,470,530
c7b09,c,Secondary carcinoid tumors of other sites,Neoplasms,15,16,10,0.066666667,-0.375,-0.333333333,6021,5769,6460,-252,691,439
c7b8,c,Other secondary neuroendocrine tumors,Neoplasms,62,98,99,0.580645161,0.010204082,0.596774194,3331,2481,2502,-850,21,-829
c760,c,"Malignant neoplasm of head, face and neck",Neoplasms,121,106,90,-0.123966942,-0.150943396,-0.256198347,2314,2373,2647,59,274,333
c762,c,Malignant neoplasm of abdomen,Neoplasms,20,20,22,0,0.1,0.1,5479,5318,5121,-161,-197,-358
c763,c,Malignant neoplasm of pelvis,Neoplasms,15,15,15,0,0,0,6018,5873,5857,-145,-16,-161
c770,c,"Secondary and unspecified malignant neoplasm of lymph nodes of head, face and neck",Neoplasms,243,247,255,0.016460905,0.032388664,0.049382716,1565,1500,1499,-65,-1,-66
c771,c,Secondary and unspecified malignant neoplasm of intrathoracic lymph nodes,Neoplasms,288,231,247,-0.197916667,0.069264069,-0.142361111,1425,1572,1524,147,-48,99
c772,c,Secondary and unspecified malignant neoplasm of intra-abdominal lymph nodes,Neoplasms,499,437,450,-0.124248497,0.029748284,-0.098196393,1024,1077,1073,53,-4,49
c773,c,Secondary and unspecified malignant neoplasm of axilla and upper limb lymph nodes,Neoplasms,149,116,96,-0.22147651,-0.172413793,-0.355704698,2057,2279,2540,222,261,483
c774,c,Secondary and unspecified malignant neoplasm of inguinal and lower limb lymph nodes,Neoplasms,63,42,25,-0.333333333,-0.404761905,-0.603174603,3301,3808,4855,507,1047,1554
c775,c,Secondary and unspecified malignant neoplasm of intrapelvic lymph nodes,Neoplasms,154,167,136,0.084415584,-0.185628743,-0.116883117,2019,1872,2112,-147,240,93
c778,c,Secondary and unspecified malignant neoplasm of lymph nodes of multiple regions,Neoplasms,47,56,48,0.191489362,-0.142857143,0.021276596,3767,3336,3630,-431,294,-137
c779,c,"Secondary and unspecified malignant neoplasm of lymph node, unspecified",Neoplasms,424,359,294,-0.153301887,-0.181058496,-0.306603774,1121,1200,1371,79,171,250
c7800,c,Secondary malignant neoplasm of unspecified lung,Neoplasms,1286,1150,1069,-0.105754277,-0.070434783,-0.16874028,525,543,589,18,46,64
c7801,c,Secondary malignant neoplasm of right lung,Neoplasms,720,633,618,-0.120833333,-0.023696682,-0.141666667,785,839,857,54,18,72
c7802,c,Secondary malignant neoplasm of left lung,Neoplasms,644,596,592,-0.074534161,-0.006711409,-0.080745342,847,872,883,25,11,36
c781,c,Secondary malignant neoplasm of mediastinum,Neoplasms,95,80,82,-0.157894737,0.025,-0.136842105,2644,2774,2765,130,-9,121
c782,c,Secondary malignant neoplasm of pleura,Neoplasms,148,163,141,0.101351351,-0.134969325,-0.047297297,2060,1897,2051,-163,154,-9
c7839,c,Secondary malignant neoplasm of other respiratory organs,Neoplasms,25,32,25,0.28,-0.21875,0,4992,4294,4847,-698,553,-145
c784,c,Secondary malignant neoplasm of small intestine,Neoplasms,91,107,101,0.175824176,-0.056074766,0.10989011,2698,2356,2461,-342,105,-237
c785,c,Secondary malignant neoplasm of large intestine and rectum,Neoplasms,166,181,152,0.090361446,-0.160220994,-0.084337349,1931,1799,1977,-132,178,46
c786,c,Secondary malignant neoplasm of retroperitoneum and peritoneum,Neoplasms,1064,1012,1036,-0.04887218,0.023715415,-0.026315789,595,599,602,4,3,7
c787,c,Secondary malignant neoplasm of liver and intrahepatic bile duct,Neoplasms,2683,2508,2454,-0.065225494,-0.0215311,-0.085352218,289,304,310,15,6,21
c7889,c,Secondary malignant neoplasm of other digestive organs,Neoplasms,262,232,232,-0.114503817,0,-0.114503817,1487,1559,1569,72,10,82
c7900,c,Secondary malignant neoplasm of unspecified kidney and renal pelvis,Neoplasms,26,36,38,0.384615385,0.055555556,0.461538462,4914,4062,4038,-852,-24,-876
c7901,c,Secondary malignant neoplasm of right kidney and renal pelvis,Neoplasms,29,28,26,-0.034482759,-0.071428571,-0.103448276,4673,4574,4760,-99,186,87
c7902,c,Secondary malignant neoplasm of left kidney and renal pelvis,Neoplasms,28,35,27,0.25,-0.228571429,-0.035714286,4744,4109,4686,-635,577,-58
c7911,c,Secondary malignant neoplasm of bladder,Neoplasms,112,97,92,-0.133928571,-0.051546392,-0.178571429,2412,2486,2589,74,103,177
c7919,c,Secondary malignant neoplasm of other urinary organs,Neoplasms,43,32,36,-0.255813953,0.125,-0.162790698,3915,4286,4118,371,-168,203
c792,c,Secondary malignant neoplasm of skin,Neoplasms,63,71,59,0.126984127,-0.169014085,-0.063492063,3288,2951,3276,-337,325,-12
c7931,c,Secondary malignant neoplasm of brain,Neoplasms,1369,1219,1179,-0.109569028,-0.032813782,-0.138787436,503,524,541,21,17,38
c7932,c,Secondary malignant neoplasm of cerebral meninges,Neoplasms,23,28,15,0.217391304,-0.464285714,-0.347826087,5155,4569,5831,-586,1262,676
c7949,c,Secondary malignant neoplasm of other parts of nervous system,Neoplasms,125,153,160,0.224,0.045751634,0.28,2253,1962,1913,-291,-49,-340
c7951,c,Secondary malignant neoplasm of bone,Neoplasms,3119,3011,2634,-0.034626483,-0.125207572,-0.155498557,255,260,295,5,35,40
c7952,c,Secondary malignant neoplasm of bone marrow,Neoplasms,60,69,45,0.15,-0.347826087,-0.25,3350,2994,3732,-356,738,382
c7960,c,Secondary malignant neoplasm of unspecified ovary,Neoplasms,14,12,23,-0.142857143,0.916666667,0.642857143,6093,6218,4999,125,-1219,-1094
c7961,c,Secondary malignant neoplasm of right ovary,Neoplasms,28,28,33,0,0.178571429,0.178571429,4737,4566,4307,-171,-259,-430
c7962,c,Secondary malignant neoplasm of left ovary,Neoplasms,28,23,22,-0.178571429,-0.043478261,-0.214285714,4737,4974,5090,237,116,353
c7970,c,Secondary malignant neoplasm of unspecified adrenal gland,Neoplasms,121,105,100,-0.132231405,-0.047619048,-0.173553719,2297,2367,2466,70,99,169
c7971,c,Secondary malignant neoplasm of right adrenal gland,Neoplasms,131,132,132,0.007633588,0,0.007633588,2188,2128,2132,-60,4,-56
c7972,c,Secondary malignant neoplasm of left adrenal gland,Neoplasms,189,179,152,-0.052910053,-0.150837989,-0.195767196,1803,1806,1971,3,165,168
c7981,c,Secondary malignant neoplasm of breast,Neoplasms,28,25,12,-0.107142857,-0.52,-0.571428571,4734,4789,6193,55,1404,1459
c7982,c,Secondary malignant neoplasm of genital organs,Neoplasms,121,123,100,0.016528926,-0.18699187,-0.173553719,2295,2198,2464,-97,266,169
c7989,c,Secondary malignant neoplasm of other specified sites,Neoplasms,639,607,583,-0.050078247,-0.039538715,-0.087636933,849,860,891,11,31,42
c799,c,Secondary malignant neoplasm of unspecified site,Neoplasms,567,514,474,-0.093474427,-0.077821012,-0.164021164,911,955,1024,44,69,113
c800,c,"Disseminated malignant neoplasm, unspecified",Neoplasms,49,47,39,-0.040816327,-0.170212766,-0.204081633,3681,3583,3982,-98,399,301
c801,c,"Malignant (primary) neoplasm, unspecified",Neoplasms,282,284,274,0.007092199,-0.035211268,-0.028368794,1431,1373,1426,-58,53,-5
c8110,c,"Nodular sclerosis Hodgkin lymphoma, unspecified site",Neoplasms,13,10,10,-0.230769231,0,-0.230769231,6196,6433,6414,237,-19,218
c8118,c,"Nodular sclerosis Hodgkin lymphoma, lymph nodes of multiple sites",Neoplasms,17,12,10,-0.294117647,-0.166666667,-0.411764706,5741,6207,6414,466,207,673
c8190,c,"Hodgkin lymphoma, unspecified, unspecified site",Neoplasms,114,107,96,-0.061403509,-0.102803738,-0.157894737,2376,2343,2519,-33,176,143
c8290,c,"Follicular lymphoma, unspecified, unspecified site",Neoplasms,64,45,57,-0.296875,0.266666667,-0.109375,3248,3664,3318,416,-346,70
c8300,c,"Small cell B-cell lymphoma, unspecified site",Neoplasms,20,21,21,0.05,0,0.05,5436,5157,5165,-279,8,-271
c8310,c,"Mantle cell lymphoma, unspecified site",Neoplasms,89,68,83,-0.235955056,0.220588235,-0.06741573,2712,3011,2727,299,-284,15
c8318,c,"Mantle cell lymphoma, lymph nodes of multiple sites",Neoplasms,11,16,15,0.454545455,-0.0625,0.363636364,6379,5721,5813,-658,92,-566
c8330,c,"Diffuse large B-cell lymphoma, unspecified site",Neoplasms,361,317,292,-0.121883657,-0.078864353,-0.191135734,1213,1290,1373,77,83,160
c8331,c,"Diffuse large B-cell lymphoma, lymph nodes of head, face, and neck",Neoplasms,33,30,39,-0.090909091,0.3,0.181818182,4386,4400,3977,14,-423,-409
c8332,c,"Diffuse large B-cell lymphoma, intrathoracic lymph nodes",Neoplasms,17,17,14,0,-0.176470588,-0.176470588,5735,5603,5929,-132,326,194
c8333,c,"Diffuse large B-cell lymphoma, intra-abdominal lymph nodes",Neoplasms,42,58,40,0.380952381,-0.310344828,-0.047619048,3936,3256,3931,-680,675,-5
c8338,c,"Diffuse large B-cell lymphoma, lymph nodes of multiple sites",Neoplasms,67,53,67,-0.208955224,0.264150943,0,3176,3382,3048,206,-334,-128
c8339,c,"Diffuse large B-cell lymphoma, extranodal and solid organ sites",Neoplasms,150,172,162,0.146666667,-0.058139535,0.08,2031,1828,1897,-203,69,-134
c8350,c,"Lymphoblastic (diffuse) lymphoma, unspecified site",Neoplasms,17,19,13,0.117647059,-0.315789474,-0.235294118,5732,5368,6058,-364,690,326
c8440,c,"Peripheral T-cell lymphoma, not classified, unspecified site",Neoplasms,14,15,14,0.071428571,-0.066666667,0,6070,5820,5926,-250,106,-144
c84a0,c,"Cutaneous T-cell lymphoma, unspecified, unspecified site",Neoplasms,10,13,15,0.3,0.153846154,0.5,6450,6064,5808,-386,-256,-642
c8510,c,"Unspecified B-cell lymphoma, unspecified site",Neoplasms,161,139,130,-0.136645963,-0.064748201,-0.192546584,1949,2054,2145,105,91,196
c8519,c,"Unspecified B-cell lymphoma, extranodal and solid organ sites",Neoplasms,21,37,37,0.761904762,0,0.761904762,5318,3996,4050,-1322,54,-1268
c8589,c,"Other specified types of non-Hodgkin lymphoma, extranodal and solid organ sites",Neoplasms,30,26,27,-0.133333333,0.038461538,-0.1,4573,4702,4660,129,-42,87
c8590,c,"Non-Hodgkin lymphoma, unspecified, unspecified site",Neoplasms,498,477,468,-0.042168675,-0.018867925,-0.060240964,1015,1007,1036,-8,29,21
c8599,c,"Non-Hodgkin lymphoma, unspecified, extranodal and solid organ sites",Neoplasms,40,28,34,-0.3,0.214285714,-0.15,4019,4547,4220,528,-327,201
c880,c,Waldenstrom macroglobulinemia,Neoplasms,80,96,73,0.2,-0.239583333,-0.0875,2875,2489,2924,-386,435,49
c884,c,Extranodal marginal zone B-cell lymphoma of mucosa-associated lymphoid tissue [MALT-lymphoma],Neoplasms,28,21,16,-0.25,-0.238095238,-0.428571429,4716,5145,5680,429,535,964
c9000,c,Multiple myeloma not having achieved remission,Neoplasms,1050,937,855,-0.107619048,-0.08751334,-0.185714286,595,620,678,25,58,83
c9001,c,Multiple myeloma in remission,Neoplasms,126,123,92,-0.023809524,-0.25203252,-0.26984127,2231,2190,2573,-41,383,342
c9002,c,Multiple myeloma in relapse,Neoplasms,63,85,61,0.349206349,-0.282352941,-0.031746032,3267,2661,3194,-606,533,-73
c9030,c,Solitary plasmacytoma not having achieved remission,Neoplasms,26,23,27,-0.115384615,0.173913043,0.038461538,4877,4948,4654,71,-294,-223
c9100,c,Acute lymphoblastic leukemia not having achieved remission,Neoplasms,382,429,446,0.123036649,0.03962704,0.167539267,1167,1077,1068,-90,-9,-99
c9101,c,"Acute lymphoblastic leukemia, in remission",Neoplasms,142,136,132,-0.042253521,-0.029411765,-0.070422535,2086,2080,2123,-6,43,37
c9102,c,"Acute lymphoblastic leukemia, in relapse",Neoplasms,107,72,78,-0.327102804,0.083333333,-0.271028037,2451,2913,2819,462,-94,368
c9110,c,Chronic lymphocytic leukemia of B-cell type not having achieved remission,Neoplasms,754,687,679,-0.088859416,-0.011644833,-0.099469496,755,787,801,32,14,46
c9111,c,Chronic lymphocytic leukemia of B-cell type in remission,Neoplasms,86,76,89,-0.11627907,0.171052632,0.034883721,2745,2815,2627,70,-188,-118
c9112,c,Chronic lymphocytic leukemia of B-cell type in relapse,Neoplasms,32,13,29,-0.59375,1.230769231,-0.09375,4438,6048,4510,1610,-1538,72
c9140,c,Hairy cell leukemia not having achieved remission,Neoplasms,16,13,24,-0.1875,0.846153846,0.5,5824,6048,4890,224,-1158,-934
c9150,c,Adult T-cell lymphoma/leukemia (HTLV-1-associated) not having achieved remission,Neoplasms,12,11,10,-0.083333333,-0.090909091,-0.166666667,6259,6290,6382,31,92,123
c91z0,c,Other lymphoid leukemia not having achieved remission,Neoplasms,17,23,16,0.352941176,-0.304347826,-0.058823529,5715,4943,5669,-772,726,-46
c9200,c,"Acute myeloblastic leukemia, not having achieved remission",Neoplasms,409,413,394,0.009779951,-0.046004843,-0.036674817,1130,1097,1147,-33,50,17
c9201,c,"Acute myeloblastic leukemia, in remission",Neoplasms,84,84,82,0,-0.023809524,-0.023809524,2781,2674,2735,-107,61,-46
c9202,c,"Acute myeloblastic leukemia, in relapse",Neoplasms,76,68,81,-0.105263158,0.191176471,0.065789474,2938,2996,2751,58,-245,-187
c9210,c,"Chronic myeloid leukemia, BCR/ABL-positive, not having achieved remission",Neoplasms,215,174,178,-0.190697674,0.022988506,-0.172093023,1672,1809,1796,137,-13,124
c9211,c,"Chronic myeloid leukemia, BCR/ABL-positive, in remission",Neoplasms,36,35,43,-0.027777778,0.228571429,0.194444444,4197,4072,3788,-125,-284,-409
c9240,c,"Acute promyelocytic leukemia, not having achieved remission",Neoplasms,26,27,11,0.038461538,-0.592592593,-0.576923077,4866,4611,6275,-255,1664,1409
c9250,c,"Acute myelomonocytic leukemia, not having achieved remission",Neoplasms,20,20,19,0,-0.05,-0.05,5407,5245,5325,-162,80,-82
c9300,c,"Acute monoblastic/monocytic leukemia, not having achieved remission",Neoplasms,15,19,15,0.266666667,-0.210526316,0,5939,5344,5783,-595,439,-156
c9310,c,Chronic myelomonocytic leukemia not having achieved remission,Neoplasms,44,50,37,0.136363636,-0.26,-0.159090909,3842,3453,4035,-389,582,193
c946,c,"Myelodysplastic disease, not classified",Neoplasms,68,75,84,0.102941176,0.12,0.235294118,3127,2830,2697,-297,-133,-430
c9500,c,Acute leukemia of unspecified cell type not having achieved remission,Neoplasms,38,31,22,-0.184210526,-0.290322581,-0.421052632,4099,4307,5050,208,743,951
c9590,c,"Leukemia, unspecified not having achieved remission",Neoplasms,89,90,84,0.011235955,-0.066666667,-0.056179775,2700,2572,2697,-128,125,-3
c9591,c,"Leukemia, unspecified, in remission",Neoplasms,21,36,33,0.714285714,-0.083333333,0.571428571,5293,4022,4270,-1271,248,-1023
c966,c,Unifocal Langerhans-cell histiocytosis,Neoplasms,11,12,10,0.090909091,-0.166666667,-0.090909091,6338,6161,6368,-177,207,30
d0511,d,Intraductal carcinoma in situ of right breast,Blood and immune disorders ,22,17,18,-0.227272727,0.058823529,-0.181818182,5201,5569,5427,368,-142,226
d0512,d,Intraductal carcinoma in situ of left breast,Blood and immune disorders ,17,15,21,-0.117647059,0.4,0.235294118,5702,5789,5132,87,-657,-570
d069,d,"Carcinoma in situ of cervix, unspecified",Blood and immune disorders ,13,11,23,-0.153846154,1.090909091,0.769230769,6149,6273,4956,124,-1317,-1193
d110,d,Benign neoplasm of parotid gland,Blood and immune disorders ,16,12,17,-0.25,0.416666667,0.0625,5809,6159,5544,350,-615,-265
d120,d,Benign neoplasm of cecum,Blood and immune disorders ,137,124,116,-0.094890511,-0.064516129,-0.153284672,2127,2173,2271,46,98,144
d122,d,Benign neoplasm of ascending colon,Blood and immune disorders ,196,149,142,-0.239795918,-0.046979866,-0.275510204,1757,1966,2026,209,60,269
d123,d,Benign neoplasm of transverse colon,Blood and immune disorders ,179,144,135,-0.195530726,-0.0625,-0.245810056,1839,2005,2094,166,89,255
d124,d,Benign neoplasm of descending colon,Blood and immune disorders ,106,73,85,-0.311320755,0.164383562,-0.198113208,2456,2877,2680,421,-197,224
d125,d,Benign neoplasm of sigmoid colon,Blood and immune disorders ,160,120,100,-0.25,-0.166666667,-0.375,1948,2209,2448,261,239,500
d126,d,"Benign neoplasm of colon, unspecified",Blood and immune disorders ,71,45,72,-0.366197183,0.6,0.014084507,3057,3636,2925,579,-711,-132
d127,d,Benign neoplasm of rectosigmoid junction,Blood and immune disorders ,27,22,24,-0.185185185,0.090909091,-0.111111111,4779,5006,4875,227,-131,96
d128,d,Benign neoplasm of rectum,Blood and immune disorders ,28,35,32,0.25,-0.085714286,0.142857143,4692,4062,4323,-630,261,-369
d132,d,Benign neoplasm of duodenum,Blood and immune disorders ,16,17,23,0.0625,0.352941176,0.4375,5801,5561,4948,-240,-613,-853
d134,d,Benign neoplasm of liver,Blood and immune disorders ,22,17,21,-0.227272727,0.235294118,-0.045454545,5193,5561,5122,368,-439,-71
d135,d,Benign neoplasm of extrahepatic bile ducts,Blood and immune disorders ,14,17,14,0.214285714,-0.176470588,0,6025,5561,5880,-464,319,-145
d136,d,Benign neoplasm of pancreas,Blood and immune disorders ,80,77,78,-0.0375,0.012987013,-0.025,2859,2780,2806,-79,26,-53
d150,d,Benign neoplasm of thymus,Blood and immune disorders ,27,18,13,-0.333333333,-0.277777778,-0.518518519,4777,5437,6009,660,572,1232
d151,d,Benign neoplasm of heart,Blood and immune disorders ,39,34,51,-0.128205128,0.5,0.307692308,4050,4103,3473,53,-630,-577
d170,d,"Benign lipomatous neoplasm of skin and subcutaneous tissue of head, face and neck",Blood and immune disorders ,18,10,13,-0.444444444,0.3,-0.277777778,5590,6366,6008,776,-358,418
d171,d,Benign lipomatous neoplasm of skin and subcutaneous tissue of trunk,Blood and immune disorders ,25,23,32,-0.08,0.391304348,0.28,4921,4923,4321,2,-602,-600
d175,d,Benign lipomatous neoplasm of intra-abdominal organs,Blood and immune disorders ,52,39,48,-0.25,0.230769231,-0.076923077,3547,3880,3576,333,-304,29
d176,d,Benign lipomatous neoplasm of spermatic cord,Blood and immune disorders ,24,13,21,-0.458333333,0.615384615,-0.125,4998,6016,5118,1018,-898,120
d1771,d,Benign lipomatous neoplasm of kidney,Blood and immune disorders ,57,50,61,-0.122807018,0.22,0.070175439,3404,3445,3176,41,-269,-228
d1779,d,Benign lipomatous neoplasm of other sites,Blood and immune disorders ,61,42,62,-0.31147541,0.476190476,0.016393443,3295,3748,3149,453,-599,-146
d179,d,"Benign lipomatous neoplasm, unspecified",Blood and immune disorders ,93,79,68,-0.150537634,-0.139240506,-0.268817204,2634,2749,3001,115,252,367
d1800,d,Hemangioma unspecified site,Blood and immune disorders ,76,74,44,-0.026315789,-0.405405405,-0.421052632,2929,2841,3729,-88,888,800
d1801,d,Hemangioma of skin and subcutaneous tissue,Blood and immune disorders ,73,64,71,-0.123287671,0.109375,-0.02739726,3004,3083,2955,79,-128,-49
d1802,d,Hemangioma of intracranial structures,Blood and immune disorders ,48,46,51,-0.041666667,0.108695652,0.0625,3680,3591,3469,-89,-122,-211
d1803,d,Hemangioma of intra-abdominal structures,Blood and immune disorders ,286,230,220,-0.195804196,-0.043478261,-0.230769231,1411,1556,1600,145,44,189
d1809,d,Hemangioma of other sites,Blood and immune disorders ,165,134,118,-0.187878788,-0.119402985,-0.284848485,1916,2086,2248,170,162,332
d181,d,"Lymphangioma, any site",Blood and immune disorders ,56,47,59,-0.160714286,0.255319149,0.053571429,3421,3546,3231,125,-315,-190
d219,d,"Benign neoplasm of connective and other soft tissue, unspecified",Blood and immune disorders ,24,21,18,-0.125,-0.142857143,-0.25,4989,5103,5401,114,298,412
d225,d,Melanocytic nevi of trunk,Blood and immune disorders ,15,19,23,0.266666667,0.210526316,0.533333333,5904,5317,4935,-587,-382,-969
d250,d,Submucous leiomyoma of uterus,Blood and immune disorders ,63,52,53,-0.174603175,0.019230769,-0.158730159,3244,3384,3401,140,17,157
d251,d,Intramural leiomyoma of uterus,Blood and immune disorders ,143,131,95,-0.083916084,-0.27480916,-0.335664336,2072,2117,2519,45,402,447
d252,d,Subserosal leiomyoma of uterus,Blood and immune disorders ,161,121,146,-0.248447205,0.20661157,-0.093167702,1939,2192,1997,253,-195,58
d259,d,"Leiomyoma of uterus, unspecified",Blood and immune disorders ,1200,981,1031,-0.1825,0.0509684,-0.140833333,543,606,599,63,-7,56
d270,d,Benign neoplasm of right ovary,Blood and immune disorders ,72,69,68,-0.041666667,-0.014492754,-0.055555556,3024,2955,2995,-69,40,-29
d271,d,Benign neoplasm of left ovary,Blood and immune disorders ,64,50,60,-0.21875,0.2,-0.0625,3212,3435,3198,223,-237,-14
d279,d,Benign neoplasm of unspecified ovary,Blood and immune disorders ,12,12,18,0,0.5,0.5,6206,6125,5394,-81,-731,-812
d320,d,Benign neoplasm of cerebral meninges,Blood and immune disorders ,351,388,380,0.105413105,-0.020618557,0.082621083,1235,1130,1170,-105,40,-65
d321,d,Benign neoplasm of spinal meninges,Blood and immune disorders ,25,24,34,-0.04,0.416666667,0.36,4904,4813,4178,-91,-635,-726
d329,d,"Benign neoplasm of meninges, unspecified",Blood and immune disorders ,261,241,213,-0.076628352,-0.116182573,-0.183908046,1474,1498,1628,24,130,154
d332,d,"Benign neoplasm of brain, unspecified",Blood and immune disorders ,22,16,22,-0.272727273,0.375,0,5168,5647,5015,479,-632,-153
d333,d,Benign neoplasm of cranial nerves,Blood and immune disorders ,84,76,75,-0.095238095,-0.013157895,-0.107142857,2766,2798,2848,32,50,82
d3500,d,Benign neoplasm of unspecified adrenal gland,Blood and immune disorders ,111,108,74,-0.027027027,-0.314814815,-0.333333333,2393,2310,2869,-83,559,476
d3501,d,Benign neoplasm of right adrenal gland,Blood and immune disorders ,140,117,89,-0.164285714,-0.239316239,-0.364285714,2092,2228,2614,136,386,522
d3502,d,Benign neoplasm of left adrenal gland,Blood and immune disorders ,194,189,138,-0.025773196,-0.26984127,-0.288659794,1764,1748,2059,-16,311,295
d351,d,Benign neoplasm of parathyroid gland,Blood and immune disorders ,41,45,50,0.097560976,0.111111111,0.219512195,3932,3615,3486,-317,-129,-446
d352,d,Benign neoplasm of pituitary gland,Blood and immune disorders ,286,282,283,-0.013986014,0.003546099,-0.01048951,1409,1368,1390,-41,22,-19
d3610,d,"Benign neoplasm of peripheral nerves and autonomic nervous system, unspecified",Blood and immune disorders ,21,29,28,0.380952381,-0.034482759,0.333333333,5251,4411,4542,-840,131,-709
d3a8,d,Other benign neuroendocrine tumors,Blood and immune disorders ,64,49,65,-0.234375,0.326530612,0.015625,3205,3461,3062,256,-399,-143
d374,d,Neoplasm of uncertain behavior of colon,Blood and immune disorders ,11,11,13,0,0.181818182,0.181818182,6286,6225,5975,-61,-250,-311
d4101,d,Neoplasm of uncertain behavior of right kidney,Blood and immune disorders ,17,14,19,-0.176470588,0.357142857,0.117647059,5658,5877,5275,219,-602,-383
d4102,d,Neoplasm of uncertain behavior of left kidney,Blood and immune disorders ,12,18,19,0.5,0.055555556,0.583333333,6193,5406,5275,-787,-131,-918
d414,d,Neoplasm of uncertain behavior of bladder,Blood and immune disorders ,10,16,12,0.6,-0.25,0.2,6361,5638,6088,-723,450,-273
d446,d,Neoplasm of uncertain behavior of carotid body,Blood and immune disorders ,18,14,16,-0.222222222,0.142857143,-0.111111111,5559,5875,5607,316,-268,48
d45,d,Polycythemia vera,Blood and immune disorders ,240,220,218,-0.083333333,-0.009090909,-0.091666667,1552,1597,1603,45,6,51
d464,d,"Refractory anemia, unspecified",Blood and immune disorders ,22,14,19,-0.363636364,0.357142857,-0.136363636,5160,5874,5274,714,-600,114
d46z,d,Other myelodysplastic syndromes,Blood and immune disorders ,33,41,24,0.242424242,-0.414634146,-0.272727273,4328,3770,4843,-558,1073,515
d469,d,"Myelodysplastic syndrome, unspecified",Blood and immune disorders ,720,645,585,-0.104166667,-0.093023256,-0.1875,778,818,886,40,68,108
d471,d,Chronic myeloproliferative disease,Blood and immune disorders ,44,42,41,-0.045454545,-0.023809524,-0.068181818,3807,3724,3837,-83,113,30
d472,d,Monoclonal gammopathy,Blood and immune disorders ,455,374,398,-0.178021978,0.064171123,-0.125274725,1073,1154,1136,81,-18,63
d473,d,Essential (hemorrhagic) thrombocythemia,Blood and immune disorders ,1392,1400,1643,0.005747126,0.173571429,0.180316092,498,481,435,-17,-46,-63
d47z1,d,Post-transplant lymphoproliferative disorder (PTLD),Blood and immune disorders ,41,48,41,0.170731707,-0.145833333,0,3925,3494,3835,-431,341,-90
d480,d,Neoplasm of uncertain behavior of bone and articular cartilage,Blood and immune disorders ,12,16,13,0.333333333,-0.1875,0.083333333,6184,5631,5964,-553,333,-220
d481,d,Neoplasm of uncertain behavior of connective and other soft tissue,Blood and immune disorders ,28,27,19,-0.035714286,-0.296296296,-0.321428571,4658,4564,5268,-94,704,610
d490,d,Neoplasm of unspecified behavior of digestive system,Blood and immune disorders ,82,82,82,0,0,0,2795,2695,2713,-100,18,-82
d491,d,Neoplasm of unspecified behavior of respiratory system,Blood and immune disorders ,20,16,16,-0.2,0,-0.2,5348,5629,5597,281,-32,249
d492,d,"Neoplasm of unspecified behavior of bone, soft tissue, and skin",Blood and immune disorders ,38,28,27,-0.263157895,-0.035714286,-0.289473684,4058,4485,4595,427,110,537
d494,d,Neoplasm of unspecified behavior of bladder,Blood and immune disorders ,64,63,58,-0.015625,-0.079365079,-0.09375,3200,3088,3236,-112,148,36
d49511,d,Neoplasm of unspecified behavior of right kidney,Blood and immune disorders ,12,11,26,-0.083333333,1.363636364,1.166666667,6179,6207,4664,28,-1543,-1515
d49512,d,Neoplasm of unspecified behavior of left kidney,Blood and immune disorders ,20,11,25,-0.45,1.272727273,0.25,5346,6207,4743,861,-1464,-603
d4959,d,Neoplasm of unspecified behavior of other genitourinary organ,Blood and immune disorders ,24,12,20,-0.5,0.666666667,-0.166666667,4962,6095,5159,1133,-936,197
d496,d,Neoplasm of unspecified behavior of brain,Blood and immune disorders ,144,165,176,0.145833333,0.066666667,0.222222222,2054,1855,1796,-199,-59,-258
d497,d,Neoplasm of unspecified behavior of endocrine glands and other parts of nervous system,Blood and immune disorders ,62,64,66,0.032258065,0.03125,0.064516129,3245,3064,3027,-181,-37,-218
d4989,d,Neoplasm of unspecified behavior of other specified sites,Blood and immune disorders ,19,10,18,-0.473684211,0.8,-0.052631579,5436,6309,5363,873,-946,-73
d500,d,Iron deficiency anemia secondary to blood loss (chronic),Blood and immune disorders ,2428,2005,2070,-0.174217463,0.032418953,-0.147446458,316,359,368,43,9,52
d508,d,Other iron deficiency anemias,Blood and immune disorders ,174,172,163,-0.011494253,-0.052325581,-0.063218391,1856,1811,1875,-45,64,19
d509,d,"Iron deficiency anemia, unspecified",Blood and immune disorders ,8938,8901,9077,-0.004139629,0.019773059,0.015551578,84,84,79,0,-5,-5
d510,d,Vitamin B12 deficiency anemia due to intrinsic factor deficiency,Blood and immune disorders ,125,89,84,-0.288,-0.056179775,-0.328,2214,2564,2674,350,110,460
d513,d,Other dietary vitamin B12 deficiency anemia,Blood and immune disorders ,24,24,20,0,-0.166666667,-0.166666667,4956,4787,5153,-169,366,197
d519,d,"Vitamin B12 deficiency anemia, unspecified",Blood and immune disorders ,131,140,129,0.06870229,-0.078571429,-0.015267176,2152,2023,2128,-129,105,-24
d520,d,Dietary folate deficiency anemia,Blood and immune disorders ,30,17,26,-0.433333333,0.529411765,-0.133333333,4502,5508,4657,1006,-851,155
d529,d,"Folate deficiency anemia, unspecified",Blood and immune disorders ,52,56,77,0.076923077,0.375,0.480769231,3512,3255,2797,-257,-458,-715
d531,d,"Other megaloblastic anemias, not elsewhere classified",Blood and immune disorders ,74,44,89,-0.405405405,1.022727273,0.202702703,2959,3644,2603,685,-1041,-356
d539,d,"Nutritional anemia, unspecified",Blood and immune disorders ,2720,2618,3036,-0.0375,0.159663866,0.116176471,283,288,267,5,-21,-16
d561,d,Beta thalassemia,Blood and immune disorders ,40,58,48,0.45,-0.172413793,0.2,3953,3202,3537,-751,335,-416
d563,d,Thalassemia minor,Blood and immune disorders ,152,139,138,-0.085526316,-0.007194245,-0.092105263,1988,2030,2049,42,19,61
d569,d,"Thalassemia, unspecified",Blood and immune disorders ,69,77,76,0.115942029,-0.012987013,0.101449275,3069,2755,2815,-314,60,-254
d5700,d,"Hb-SS disease with crisis, unspecified",Blood and immune disorders ,308,270,261,-0.123376623,-0.033333333,-0.152597403,1347,1397,1449,50,52,102
d5701,d,Hb-SS disease with acute chest syndrome,Blood and immune disorders ,29,25,23,-0.137931034,-0.08,-0.206896552,4569,4691,4891,122,200,322
d571,d,Sickle-cell disease without crisis,Blood and immune disorders ,112,103,106,-0.080357143,0.029126214,-0.053571429,2363,2342,2351,-21,9,-12
d57219,d,"Sickle-cell/Hb-C disease with crisis, unspecified",Blood and immune disorders ,27,17,17,-0.37037037,0,-0.37037037,4723,5499,5463,776,-36,740
d573,d,Sickle-cell trait,Blood and immune disorders ,199,221,183,0.110552764,-0.171945701,-0.08040201,1733,1587,1767,-146,180,34
d57419,d,"Sickle-cell thalassemia, unspecified, with crisis",Blood and immune disorders ,10,15,13,0.5,-0.133333333,0.3,6322,5709,5935,-613,226,-387
d580,d,Hereditary spherocytosis,Blood and immune disorders ,35,28,37,-0.2,0.321428571,0.057142857,4189,4468,3976,279,-492,-213
d582,d,Other hemoglobinopathies,Blood and immune disorders ,27,25,33,-0.074074074,0.32,0.222222222,4721,4688,4211,-33,-477,-510
d589,d,"Hereditary hemolytic anemia, unspecified",Blood and immune disorders ,81,82,61,0.012345679,-0.256097561,-0.24691358,2808,2684,3139,-124,455,331
d593,d,Hemolytic-uremic syndrome,Blood and immune disorders ,34,46,28,0.352941176,-0.391304348,-0.176470588,4244,3551,4514,-693,963,270
d594,d,Other nonautoimmune hemolytic anemias,Blood and immune disorders ,23,32,23,0.391304348,-0.28125,0,5031,4184,4885,-847,701,-146
d599,d,"Acquired hemolytic anemia, unspecified",Blood and immune disorders ,36,25,32,-0.305555556,0.28,-0.111111111,4134,4685,4268,551,-417,134
d611,d,Drug-induced aplastic anemia,Blood and immune disorders ,12,11,25,-0.083333333,1.272727273,1.083333333,6150,6179,4721,29,-1458,-1429
d61810,d,Antineoplastic chemotherapy induced pancytopenia,Blood and immune disorders ,1969,1813,1836,-0.079228035,0.012686156,-0.067546978,374,394,398,20,4,24
d61811,d,Other drug-induced pancytopenia,Blood and immune disorders ,86,93,93,0.081395349,0,0.081395349,2709,2502,2524,-207,22,-185
d61818,d,Other pancytopenia,Blood and immune disorders ,4217,4272,4066,0.013042447,-0.048220974,-0.035807446,201,197,218,-4,21,17
d619,d,"Aplastic anemia, unspecified",Blood and immune disorders ,72,75,75,0.041666667,0,0.041666667,2996,2790,2823,-206,33,-173
d62,d,Acute posthemorrhagic anemia,Blood and immune disorders ,20761,19431,20435,-0.064062425,0.051670012,-0.015702519,33,34,36,1,2,3
d630,d,Anemia in neoplastic disease,Blood and immune disorders ,2095,1801,1694,-0.140334129,-0.059411438,-0.191408115,354,393,416,39,23,62
d638,d,Anemia in other chronic diseases classified elsewhere,Blood and immune disorders ,7534,7174,7371,-0.047783382,0.027460273,-0.021635254,103,108,107,5,-1,4
d6481,d,Anemia due to antineoplastic chemotherapy,Blood and immune disorders ,1257,1149,959,-0.085918854,-0.165361184,-0.237072395,526,533,619,7,86,93
d6489,d,Other specified anemias,Blood and immune disorders ,368,378,330,0.027173913,-0.126984127,-0.10326087,1181,1136,1259,-45,123,78
d649,d,"Anemia, unspecified",Blood and immune disorders ,29657,28576,29527,-0.036450079,0.033279675,-0.004383451,19,21,22,2,1,3
d65,d,Disseminated intravascular coagulation [defibrination syndrome],Blood and immune disorders ,526,447,594,-0.150190114,0.32885906,0.129277567,965,1040,863,75,-177,-102
d66,d,Hereditary factor VIII deficiency,Blood and immune disorders ,101,53,65,-0.475247525,0.226415094,-0.356435644,2483,3309,3031,826,-278,548
d67,d,Hereditary factor IX deficiency,Blood and immune disorders ,23,20,16,-0.130434783,-0.2,-0.304347826,5018,5154,5552,136,398,534
d680,d,Von Willebrand's disease,Blood and immune disorders ,148,165,168,0.114864865,0.018181818,0.135135135,2010,1840,1831,-170,-9,-179
d681,d,Hereditary factor XI deficiency,Blood and immune disorders ,18,16,26,-0.111111111,0.625,0.444444444,5503,5587,4630,84,-957,-873
d682,d,Hereditary deficiency of other clotting factors,Blood and immune disorders ,193,162,191,-0.160621762,0.179012346,-0.010362694,1752,1859,1714,107,-145,-38
d6832,d,Hemorrhagic disorder due to extrinsic circulating anticoagulants,Blood and immune disorders ,554,542,600,-0.02166065,0.10701107,0.083032491,917,901,851,-16,-50,-66
d684,d,Acquired coagulation factor deficiency,Blood and immune disorders ,1894,1754,2163,-0.073917635,0.2331813,0.142027455,387,398,348,11,-50,-39
d6851,d,Activated protein C resistance,Blood and immune disorders ,762,656,660,-0.139107612,0.006097561,-0.133858268,737,796,795,59,-1,58
d6852,d,Prothrombin gene mutation,Blood and immune disorders ,73,77,60,0.054794521,-0.220779221,-0.178082192,2958,2736,3152,-222,416,194
d6859,d,Other primary thrombophilia,Blood and immune disorders ,760,803,1133,0.056578947,0.410958904,0.490789474,737,687,549,-50,-138,-188
d6861,d,Antiphospholipid syndrome,Blood and immune disorders ,329,272,324,-0.17325228,0.191176471,-0.015197568,1267,1376,1260,109,-116,-7
d6862,d,Lupus anticoagulant syndrome,Blood and immune disorders ,197,212,187,0.076142132,-0.117924528,-0.050761421,1723,1609,1730,-114,121,7
d6869,d,Other thrombophilia,Blood and immune disorders ,536,300,607,-0.440298507,1.023333333,0.132462687,948,1306,842,358,-464,-106
d688,d,Other specified coagulation defects,Blood and immune disorders ,181,227,467,0.254143646,1.057268722,1.580110497,1798,1539,1017,-259,-522,-781
d689,d,"Coagulation defect, unspecified",Blood and immune disorders ,2901,2837,3444,-0.022061358,0.213958407,0.187176836,266,268,236,2,-32,-30
d690,d,Allergic purpura,Blood and immune disorders ,28,29,12,0.035714286,-0.586206897,-0.571428571,4609,4358,6015,-251,1657,1406
d691,d,Qualitative platelet defects,Blood and immune disorders ,46,57,45,0.239130435,-0.210526316,-0.02173913,3672,3197,3623,-475,426,-49
d692,d,Other nonthrombocytopenic purpura,Blood and immune disorders ,71,66,78,-0.070422535,0.181818182,0.098591549,2998,2987,2758,-11,-229,-240
d693,d,Immune thrombocytopenic purpura,Blood and immune disorders ,622,560,533,-0.099678457,-0.048214286,-0.143086817,843,879,926,36,47,83
d6941,d,Evans syndrome,Blood and immune disorders ,12,16,21,0.333333333,0.3125,0.75,6120,5572,5025,-548,-547,-1095
d6949,d,Other primary thrombocytopenia,Blood and immune disorders ,24,25,22,0.041666667,-0.12,-0.083333333,4910,4657,4942,-253,285,32
d6959,d,Other secondary thrombocytopenia,Blood and immune disorders ,4344,4154,4233,-0.04373849,0.019017814,-0.025552486,192,199,205,7,6,13
d696,d,"Thrombocytopenia, unspecified",Blood and immune disorders ,11416,11530,12515,0.009985985,0.085429315,0.096268395,62,61,58,-1,-3,-4
d701,d,Agranulocytosis secondary to cancer chemotherapy,Blood and immune disorders ,443,396,415,-0.106094808,0.047979798,-0.063205418,1062,1093,1089,31,-4,27
d702,d,Other drug-induced agranulocytosis,Blood and immune disorders ,96,75,55,-0.21875,-0.266666667,-0.427083333,2543,2767,3278,224,511,735
d703,d,Neutropenia due to infection,Blood and immune disorders ,80,76,73,-0.05,-0.039473684,-0.0875,2802,2750,2847,-52,97,45
d704,d,Cyclic neutropenia,Blood and immune disorders ,13,10,17,-0.230769231,0.7,0.307692308,6021,6246,5420,225,-826,-601
d708,d,Other neutropenia,Blood and immune disorders ,57,42,39,-0.263157895,-0.071428571,-0.315789474,3332,3669,3866,337,197,534
d709,d,"Neutropenia, unspecified",Blood and immune disorders ,1227,1096,1170,-0.106764466,0.067518248,-0.046454768,524,544,527,20,-17,3
d71,d,Functional disorders of polymorphonuclear neutrophils,Blood and immune disorders ,59,69,40,0.169491525,-0.420289855,-0.322033898,3274,2900,3820,-374,920,546
d72810,d,Lymphocytopenia,Blood and immune disorders ,67,883,1573,12.17910448,0.781426954,22.47761194,3085,628,440,-2457,-188,-2645
d72818,d,Other decreased white blood cell count,Blood and immune disorders ,36,35,37,-0.027777778,0.057142857,0.027777778,4098,3973,3939,-125,-34,-159
d72819,d,"Decreased white blood cell count, unspecified",Blood and immune disorders ,1516,1686,2029,0.112137203,0.203440095,0.338390501,454,406,362,-48,-44,-92
d72820,d,Lymphocytosis (symptomatic),Blood and immune disorders ,78,73,88,-0.064102564,0.205479452,0.128205128,2833,2811,2579,-22,-232,-254
d72821,d,Monocytosis (symptomatic),Blood and immune disorders ,45,45,53,0,0.177777778,0.177777778,3703,3552,3331,-151,-221,-372
d72823,d,Leukemoid reaction,Blood and immune disorders ,252,261,262,0.035714286,0.003831418,0.03968254,1476,1397,1419,-79,22,-57
d72825,d,Bandemia,Blood and immune disorders ,304,274,315,-0.098684211,0.149635036,0.036184211,1340,1362,1275,22,-87,-65
d72828,d,Other elevated white blood cell count,Blood and immune disorders ,835,893,872,0.069461078,-0.023516237,0.044311377,683,623,647,-60,24,-36
d72829,d,"Elevated white blood cell count, unspecified",Blood and immune disorders ,12185,11517,12365,-0.054821502,0.073630286,0.014772261,58,61,58,3,-3,0
d7289,d,Other specified disorders of white blood cells,Blood and immune disorders ,59,14,13,-0.762711864,-0.071428571,-0.779661017,3267,5786,5879,2519,93,2612
d729,d,"Disorder of white blood cells, unspecified",Blood and immune disorders ,21,19,17,-0.095238095,-0.105263158,-0.19047619,5163,5218,5408,55,190,245
d730,d,Hyposplenism,Blood and immune disorders ,73,43,18,-0.410958904,-0.581395349,-0.753424658,2939,3618,5292,679,1674,2353
d731,d,Hypersplenism,Blood and immune disorders ,182,162,138,-0.10989011,-0.148148148,-0.241758242,1780,1839,2016,59,177,236
d732,d,Chronic congestive splenomegaly,Blood and immune disorders ,26,34,27,0.307692308,-0.205882353,0.038461538,4743,4005,4528,-738,523,-215
d733,d,Abscess of spleen,Blood and immune disorders ,35,21,35,-0.4,0.666666667,0,4140,5002,4040,862,-962,-100
d734,d,Cyst of spleen,Blood and immune disorders ,24,39,31,0.625,-0.205128205,0.291666667,4888,3784,4286,-1104,502,-602
d735,d,Infarction of spleen,Blood and immune disorders ,211,234,241,0.109004739,0.02991453,0.142180095,1647,1487,1487,-160,0,-160
d7389,d,Other diseases of spleen,Blood and immune disorders ,93,118,119,0.268817204,0.008474576,0.279569892,2574,2170,2184,-404,14,-390
d749,d,"Methemoglobinemia, unspecified",Blood and immune disorders ,12,13,13,0.083333333,0,0.083333333,6092,5884,5871,-208,-13,-221
d751,d,Secondary polycythemia,Blood and immune disorders ,1143,1061,1157,-0.071741032,0.090480679,0.012248469,546,557,529,11,-28,-17
d7581,d,Myelofibrosis,Blood and immune disorders ,139,148,121,0.064748201,-0.182432432,-0.129496403,2053,1919,2157,-134,238,104
d7582,d,Heparin induced thrombocytopenia (HIT),Blood and immune disorders ,108,115,114,0.064814815,-0.008695652,0.055555556,2368,2196,2235,-172,39,-133
d7589,d,Other specified diseases of blood and blood-forming organs,Blood and immune disorders ,675,686,720,0.016296296,0.049562682,0.066666667,796,764,752,-32,-12,-44
d759,d,"Disease of blood and blood-forming organs, unspecified",Blood and immune disorders ,70,52,41,-0.257142857,-0.211538462,-0.414285714,2996,3303,3768,307,465,772
d75a,d,Glucose-6-phosphate dehydrogenase (G6PD) deficiency without anemia,Blood and immune disorders ,20,38,33,0.9,-0.131578947,0.65,5258,3819,4157,-1439,338,-1101
d761,d,Hemophagocytic lymphohistiocytosis,Blood and immune disorders ,23,33,28,0.434782609,-0.151515152,0.217391304,4971,4065,4458,-906,393,-513
d801,d,Nonfamilial hypogammaglobulinemia,Blood and immune disorders ,354,340,344,-0.039548023,0.011764706,-0.028248588,1195,1199,1204,4,5,9
d802,d,Selective deficiency of immunoglobulin A [IgA],Blood and immune disorders ,36,27,22,-0.25,-0.185185185,-0.388888889,4080,4482,4911,402,429,831
d803,d,Selective deficiency of immunoglobulin G [IgG] subclasses,Blood and immune disorders ,78,62,61,-0.205128205,-0.016129032,-0.217948718,2821,3053,3094,232,41,273
d819,d,"Combined immunodeficiency, unspecified",Blood and immune disorders ,16,19,13,0.1875,-0.315789474,-0.1875,5654,5201,5861,-453,660,207
d821,d,Di George's syndrome,Blood and immune disorders ,46,43,31,-0.065217391,-0.279069767,-0.326086957,3643,3608,4276,-35,668,633
d839,d,"Common variable immunodeficiency, unspecified",Blood and immune disorders ,161,145,140,-0.099378882,-0.034482759,-0.130434783,1890,1943,1987,53,44,97
d841,d,Defects in the complement system,Blood and immune disorders ,37,20,33,-0.459459459,0.65,-0.108108108,4024,5101,4154,1077,-947,130
d849,d,"Immunodeficiency, unspecified",Blood and immune disorders ,205,104,1430,-0.492682927,12.75,5.975609756,1680,2293,468,613,-1825,-1212
d860,d,Sarcoidosis of lung,Blood and immune disorders ,104,110,93,0.057692308,-0.154545455,-0.105769231,2415,2238,2484,-177,246,69
d8685,d,Sarcoid myocarditis,Blood and immune disorders ,18,13,11,-0.277777778,-0.153846154,-0.388888889,5446,5868,6089,422,221,643
d8689,d,Sarcoidosis of other sites,Blood and immune disorders ,31,21,26,-0.322580645,0.238095238,-0.161290323,4357,4985,4579,628,-406,222
d869,d,"Sarcoidosis, unspecified",Blood and immune disorders ,275,261,251,-0.050909091,-0.038314176,-0.087272727,1399,1391,1451,-8,60,52
d890,d,Polyclonal hypergammaglobulinemia,Blood and immune disorders ,36,28,34,-0.222222222,0.214285714,-0.055555556,4073,4400,4085,327,-315,12
d891,d,Cryoglobulinemia,Blood and immune disorders ,20,13,22,-0.35,0.692307692,0.1,5246,5865,4902,619,-963,-344
d892,d,"Hypergammaglobulinemia, unspecified",Blood and immune disorders ,22,27,26,0.227272727,-0.037037037,0.181818182,5051,4475,4577,-576,102,-474
d8940,d,"Mast cell activation, unspecified",Blood and immune disorders ,33,47,62,0.424242424,0.319148936,0.878787879,4235,3454,3064,-781,-390,-1171
d89810,d,Acute graft-versus-host disease,Blood and immune disorders ,44,28,34,-0.363636364,0.214285714,-0.227272727,3727,4399,4084,672,-315,357
d89811,d,Chronic graft-versus-host disease,Blood and immune disorders ,81,90,56,0.111111111,-0.377777778,-0.308641975,2763,2499,3221,-264,722,458
d89812,d,Acute on chronic graft-versus-host disease,Blood and immune disorders ,29,16,15,-0.448275862,-0.0625,-0.482758621,4494,5523,5602,1029,79,1108
d89813,d,"Graft-versus-host disease, unspecified",Blood and immune disorders ,100,86,91,-0.14,0.058139535,-0.09,2463,2567,2520,104,-47,57
d8989,d,"Other specified disorders involving the immune mechanism, not elsewhere classified",Blood and immune disorders ,85,76,55,-0.105882353,-0.276315789,-0.352941176,2686,2729,3253,43,524,567
d899,d,"Disorder involving the immune mechanism, unspecified",Blood and immune disorders ,738,765,378,0.036585366,-0.505882353,-0.487804878,741,696,1141,-45,445,400
e010,e,Iodine-deficiency related diffuse (endemic) goiter,"Endocrine, nutritional and metabolic diseases",27,15,11,-0.444444444,-0.266666667,-0.592592593,4644,5619,6077,975,458,1433
e02,e,Subclinical iodine-deficiency hypothyroidism,"Endocrine, nutritional and metabolic diseases",122,139,155,0.139344262,0.115107914,0.270491803,2201,1988,1879,-213,-109,-322
e031,e,Congenital hypothyroidism without goiter,"Endocrine, nutritional and metabolic diseases",52,47,48,-0.096153846,0.021276596,-0.076923077,3442,3449,3472,7,23,30
e032,e,Hypothyroidism due to medicaments and other exogenous substances,"Endocrine, nutritional and metabolic diseases",63,57,53,-0.095238095,-0.070175439,-0.158730159,3152,3163,3308,11,145,156
e034,e,Atrophy of thyroid (acquired),"Endocrine, nutritional and metabolic diseases",93,77,73,-0.172043011,-0.051948052,-0.215053763,2562,2703,2824,141,121,262
e035,e,Myxedema coma,"Endocrine, nutritional and metabolic diseases",27,29,31,0.074074074,0.068965517,0.148148148,4640,4309,4260,-331,-49,-380
e038,e,Other specified hypothyroidism,"Endocrine, nutritional and metabolic diseases",239,226,210,-0.054393305,-0.07079646,-0.121338912,1520,1530,1598,10,68,78
e039,e,"Hypothyroidism, unspecified","Endocrine, nutritional and metabolic diseases",43241,40337,40374,-0.067158484,0.000917272,-0.066302814,11,11,14,0,3,3
e041,e,Nontoxic single thyroid nodule,"Endocrine, nutritional and metabolic diseases",881,826,856,-0.062429058,0.036319613,-0.028376844,652,661,651,9,-10,-1
e042,e,Nontoxic multinodular goiter,"Endocrine, nutritional and metabolic diseases",473,392,399,-0.171247357,0.017857143,-0.156448203,1011,1088,1099,77,11,88
e049,e,"Nontoxic goiter, unspecified","Endocrine, nutritional and metabolic diseases",163,142,129,-0.128834356,-0.091549296,-0.208588957,1872,1960,2079,88,119,207
e0500,e,Thyrotoxicosis with diffuse goiter without thyrotoxic crisis or storm,"Endocrine, nutritional and metabolic diseases",353,306,311,-0.133144476,0.016339869,-0.11898017,1194,1275,1274,81,-1,80
e0501,e,Thyrotoxicosis with diffuse goiter with thyrotoxic crisis or storm,"Endocrine, nutritional and metabolic diseases",14,15,14,0.071428571,-0.066666667,0,5847,5608,5703,-239,95,-144
e0520,e,Thyrotoxicosis with toxic multinodular goiter without thyrotoxic crisis or storm,"Endocrine, nutritional and metabolic diseases",43,39,36,-0.093023256,-0.076923077,-0.162790698,3749,3755,3945,6,190,196
e0580,e,Other thyrotoxicosis without thyrotoxic crisis or storm,"Endocrine, nutritional and metabolic diseases",78,94,79,0.205128205,-0.159574468,0.012820513,2805,2436,2705,-369,269,-100
e0590,e,"Thyrotoxicosis, unspecified without thyrotoxic crisis or storm","Endocrine, nutritional and metabolic diseases",1047,904,956,-0.136580707,0.057522124,-0.086914995,575,614,607,39,-7,32
e0591,e,"Thyrotoxicosis, unspecified with thyrotoxic crisis or storm","Endocrine, nutritional and metabolic diseases",23,25,10,0.086956522,-0.6,-0.565217391,4938,4597,6160,-341,1563,1222
e063,e,Autoimmune thyroiditis,"Endocrine, nutritional and metabolic diseases",869,707,861,-0.186421174,0.217821782,-0.009205984,658,741,648,83,-93,-10
e069,e,"Thyroiditis, unspecified","Endocrine, nutritional and metabolic diseases",24,45,20,0.875,-0.555555556,-0.166666667,4847,3516,5040,-1331,1524,193
e0781,e,Sick-euthyroid syndrome,"Endocrine, nutritional and metabolic diseases",130,132,169,0.015384615,0.28030303,0.3,2108,2043,1789,-65,-254,-319
e0789,e,Other specified disorders of thyroid,"Endocrine, nutritional and metabolic diseases",21,17,21,-0.19047619,0.235294118,0,5112,5393,4959,281,-434,-153
e079,e,"Disorder of thyroid, unspecified","Endocrine, nutritional and metabolic diseases",597,620,701,0.038525963,0.130645161,0.174204355,849,816,760,-33,-56,-89
e0865,e,Diabetes mellitus due to underlying condition with hyperglycemia,"Endocrine, nutritional and metabolic diseases",50,35,42,-0.3,0.2,-0.16,3501,3926,3694,425,-232,193
e089,e,Diabetes mellitus due to underlying condition without complications,"Endocrine, nutritional and metabolic diseases",50,33,31,-0.34,-0.060606061,-0.38,3501,4035,4247,534,212,746
e0922,e,Drug or chemical induced diabetes mellitus with diabetic chronic kidney disease,"Endocrine, nutritional and metabolic diseases",20,34,25,0.7,-0.264705882,0.25,5215,3966,4627,-1249,661,-588
e0965,e,Drug or chemical induced diabetes mellitus with hyperglycemia,"Endocrine, nutritional and metabolic diseases",86,92,68,0.069767442,-0.260869565,-0.209302326,2652,2462,2906,-190,444,254
e099,e,Drug or chemical induced diabetes mellitus without complications,"Endocrine, nutritional and metabolic diseases",71,60,50,-0.154929577,-0.166666667,-0.295774648,2953,3074,3389,121,315,436
e1010,e,Type 1 diabetes mellitus with ketoacidosis without coma,"Endocrine, nutritional and metabolic diseases",1709,1586,1615,-0.071971913,0.018284994,-0.055002926,410,423,431,13,8,21
e1011,e,Type 1 diabetes mellitus with ketoacidosis with coma,"Endocrine, nutritional and metabolic diseases",17,25,15,0.470588235,-0.4,-0.117647059,5503,4587,5574,-916,987,71
e1021,e,Type 1 diabetes mellitus with diabetic nephropathy,"Endocrine, nutritional and metabolic diseases",267,102,118,-0.617977528,0.156862745,-0.558052434,1415,2294,2175,879,-119,760
e1022,e,Type 1 diabetes mellitus with diabetic chronic kidney disease,"Endocrine, nutritional and metabolic diseases",1020,896,939,-0.121568627,0.047991071,-0.079411765,590,615,609,25,-6,19
e10319,e,Type 1 diabetes mellitus with unspecified diabetic retinopathy without macular edema,"Endocrine, nutritional and metabolic diseases",274,247,236,-0.098540146,-0.044534413,-0.138686131,1394,1431,1489,37,58,95
e1036,e,Type 1 diabetes mellitus with diabetic cataract,"Endocrine, nutritional and metabolic diseases",13,15,17,0.153846154,0.133333333,0.307692308,5939,5589,5347,-350,-242,-592
e1040,e,"Type 1 diabetes mellitus with diabetic neuropathy, unspecified","Endocrine, nutritional and metabolic diseases",414,391,314,-0.055555556,-0.196930946,-0.241545894,1080,1084,1261,4,177,181
e1042,e,Type 1 diabetes mellitus with diabetic polyneuropathy,"Endocrine, nutritional and metabolic diseases",473,423,414,-0.105708245,-0.021276596,-0.124735729,1006,1046,1077,40,31,71
e1043,e,Type 1 diabetes mellitus with diabetic autonomic (poly)neuropathy,"Endocrine, nutritional and metabolic diseases",631,529,517,-0.161648177,-0.02268431,-0.18066561,818,897,928,79,31,110
e1051,e,Type 1 diabetes mellitus with diabetic peripheral angiopathy without gangrene,"Endocrine, nutritional and metabolic diseases",248,201,199,-0.189516129,-0.009950249,-0.197580645,1470,1626,1639,156,13,169
e1052,e,Type 1 diabetes mellitus with diabetic peripheral angiopathy with gangrene,"Endocrine, nutritional and metabolic diseases",76,52,53,-0.315789474,0.019230769,-0.302631579,2826,3269,3287,443,18,461
e10610,e,Type 1 diabetes mellitus with diabetic neuropathic arthropathy,"Endocrine, nutritional and metabolic diseases",49,38,34,-0.224489796,-0.105263158,-0.306122449,3516,3779,4052,263,273,536
e10621,e,Type 1 diabetes mellitus with foot ulcer,"Endocrine, nutritional and metabolic diseases",252,224,218,-0.111111111,-0.026785714,-0.134920635,1454,1526,1548,72,22,94
e10622,e,Type 1 diabetes mellitus with other skin ulcer,"Endocrine, nutritional and metabolic diseases",51,36,42,-0.294117647,0.166666667,-0.176470588,3451,3867,3682,416,-185,231
e10628,e,Type 1 diabetes mellitus with other skin complications,"Endocrine, nutritional and metabolic diseases",79,44,64,-0.443037975,0.454545455,-0.189873418,2776,3546,2989,770,-557,213
e10649,e,Type 1 diabetes mellitus with hypoglycemia without coma,"Endocrine, nutritional and metabolic diseases",539,492,483,-0.087198516,-0.018292683,-0.103896104,925,949,974,24,25,49
e1065,e,Type 1 diabetes mellitus with hyperglycemia,"Endocrine, nutritional and metabolic diseases",1081,946,1029,-0.124884366,0.087737844,-0.048103608,562,597,576,35,-21,14
e1069,e,Type 1 diabetes mellitus with other specified complication,"Endocrine, nutritional and metabolic diseases",195,145,144,-0.256410256,-0.006896552,-0.261538462,1692,1923,1939,231,16,247
e109,e,Type 1 diabetes mellitus without complications,"Endocrine, nutritional and metabolic diseases",413,387,409,-0.062953995,0.056847545,-0.00968523,1078,1088,1080,10,-8,2
e1100,e,Type 2 diabetes mellitus with hyperosmolarity without nonketotic hyperglycemic-hyperosmolar coma (NKHHC),"Endocrine, nutritional and metabolic diseases",215,238,275,0.106976744,0.155462185,0.279069767,1608,1454,1360,-154,-94,-248
e1101,e,Type 2 diabetes mellitus with hyperosmolarity with coma,"Endocrine, nutritional and metabolic diseases",42,59,32,0.404761905,-0.457627119,-0.238095238,3759,3083,4163,-676,1080,404
e1110,e,Type 2 diabetes mellitus with ketoacidosis without coma,"Endocrine, nutritional and metabolic diseases",1875,2542,2994,0.355733333,0.177812746,0.5968,383,286,259,-97,-27,-124
e1111,e,Type 2 diabetes mellitus with ketoacidosis with coma,"Endocrine, nutritional and metabolic diseases",21,35,41,0.666666667,0.171428571,0.952380952,5087,3904,3721,-1183,-183,-1366
e1121,e,Type 2 diabetes mellitus with diabetic nephropathy,"Endocrine, nutritional and metabolic diseases",3051,1463,1433,-0.520485087,-0.02050581,-0.530317929,248,446,463,198,17,215
e1122,e,Type 2 diabetes mellitus with diabetic chronic kidney disease,"Endocrine, nutritional and metabolic diseases",24829,24634,25015,-0.007853719,0.015466429,0.00749124,24,23,28,-1,5,4
e1129,e,Type 2 diabetes mellitus with other diabetic kidney complication,"Endocrine, nutritional and metabolic diseases",41,34,28,-0.170731707,-0.176470588,-0.317073171,3800,3941,4399,141,458,599
e11311,e,Type 2 diabetes mellitus with unspecified diabetic retinopathy with macular edema,"Endocrine, nutritional and metabolic diseases",34,25,34,-0.264705882,0.36,0,4130,4564,4040,434,-524,-90
e11319,e,Type 2 diabetes mellitus with unspecified diabetic retinopathy without macular edema,"Endocrine, nutritional and metabolic diseases",1394,1217,1151,-0.12697274,-0.054231717,-0.174318508,477,502,525,25,23,48
e113299,e,"Type 2 diabetes mellitus with mild nonproliferative diabetic retinopathy without macular edema, unspecified eye","Endocrine, nutritional and metabolic diseases",37,41,34,0.108108108,-0.170731707,-0.081081081,3972,3642,4039,-330,397,67
e113593,e,"Type 2 diabetes mellitus with proliferative diabetic retinopathy without macular edema, bilateral","Endocrine, nutritional and metabolic diseases",13,17,16,0.307692308,-0.058823529,0.230769231,5916,5359,5430,-557,71,-486
e113599,e,"Type 2 diabetes mellitus with proliferative diabetic retinopathy without macular edema, unspecified eye","Endocrine, nutritional and metabolic diseases",73,57,48,-0.219178082,-0.157894737,-0.342465753,2888,3130,3437,242,307,549
e1136,e,Type 2 diabetes mellitus with diabetic cataract,"Endocrine, nutritional and metabolic diseases",437,389,206,-0.109839817,-0.470437018,-0.528604119,1044,1080,1593,36,513,549
e1139,e,Type 2 diabetes mellitus with other diabetic ophthalmic complication,"Endocrine, nutritional and metabolic diseases",204,161,169,-0.210784314,0.049689441,-0.171568627,1655,1811,1771,156,-40,116
e1140,e,"Type 2 diabetes mellitus with diabetic neuropathy, unspecified","Endocrine, nutritional and metabolic diseases",7416,6668,6883,-0.100862999,0.032243551,-0.071871629,102,112,111,10,-1,9
e1141,e,Type 2 diabetes mellitus with diabetic mononeuropathy,"Endocrine, nutritional and metabolic diseases",141,111,133,-0.212765957,0.198198198,-0.056737589,1998,2191,2020,193,-171,22
e1142,e,Type 2 diabetes mellitus with diabetic polyneuropathy,"Endocrine, nutritional and metabolic diseases",8347,7598,7812,-0.089732838,0.028165307,-0.064094884,82,93,95,11,2,13
e1143,e,Type 2 diabetes mellitus with diabetic autonomic (poly)neuropathy,"Endocrine, nutritional and metabolic diseases",1357,1292,1306,-0.047899779,0.010835913,-0.037582903,480,486,487,6,1,7
e1144,e,Type 2 diabetes mellitus with diabetic amyotrophy,"Endocrine, nutritional and metabolic diseases",19,10,19,-0.473684211,0.9,0,5269,6131,5099,862,-1032,-170
e1149,e,Type 2 diabetes mellitus with other diabetic neurological complication,"Endocrine, nutritional and metabolic diseases",71,45,58,-0.366197183,0.288888889,-0.183098592,2926,3485,3127,559,-358,201
e1151,e,Type 2 diabetes mellitus with diabetic peripheral angiopathy without gangrene,"Endocrine, nutritional and metabolic diseases",6763,6435,6379,-0.048499187,-0.008702409,-0.056779536,111,115,122,4,7,11
e1152,e,Type 2 diabetes mellitus with diabetic peripheral angiopathy with gangrene,"Endocrine, nutritional and metabolic diseases",1378,1501,1486,0.089259797,-0.009993338,0.078374456,475,433,446,-42,13,-29
e1159,e,Type 2 diabetes mellitus with other circulatory complications,"Endocrine, nutritional and metabolic diseases",176,114,148,-0.352272727,0.298245614,-0.159090909,1773,2165,1900,392,-265,127
e11610,e,Type 2 diabetes mellitus with diabetic neuropathic arthropathy,"Endocrine, nutritional and metabolic diseases",482,491,494,0.018672199,0.00610998,0.024896266,978,939,946,-39,7,-32
e11618,e,Type 2 diabetes mellitus with other diabetic arthropathy,"Endocrine, nutritional and metabolic diseases",17,13,75,-0.235294118,4.769230769,3.411764706,5464,5788,2738,324,-3050,-2726
e11620,e,Type 2 diabetes mellitus with diabetic dermatitis,"Endocrine, nutritional and metabolic diseases",27,25,29,-0.074074074,0.16,0.074074074,4586,4550,4307,-36,-243,-279
e11621,e,Type 2 diabetes mellitus with foot ulcer,"Endocrine, nutritional and metabolic diseases",4404,3827,3930,-0.131017257,0.026914032,-0.107629428,183,204,211,21,7,28
e11622,e,Type 2 diabetes mellitus with other skin ulcer,"Endocrine, nutritional and metabolic diseases",556,507,473,-0.088129496,-0.067061144,-0.149280576,882,919,972,37,53,90
e11628,e,Type 2 diabetes mellitus with other skin complications,"Endocrine, nutritional and metabolic diseases",1136,964,1135,-0.151408451,0.177385892,-0.000880282,536,581,526,45,-55,-10
e11638,e,Type 2 diabetes mellitus with other oral complications,"Endocrine, nutritional and metabolic diseases",10,10,18,0,0.8,0.8,6151,6121,5191,-30,-930,-960
e11641,e,Type 2 diabetes mellitus with hypoglycemia with coma,"Endocrine, nutritional and metabolic diseases",12,17,12,0.416666667,-0.294117647,0,5988,5343,5880,-645,537,-108
e11649,e,Type 2 diabetes mellitus with hypoglycemia without coma,"Endocrine, nutritional and metabolic diseases",3583,3530,3781,-0.014792074,0.071104816,0.055260955,214,215,216,1,1,2
e1165,e,Type 2 diabetes mellitus with hyperglycemia,"Endocrine, nutritional and metabolic diseases",20251,20334,24087,0.004098563,0.184567719,0.189422745,30,30,28,0,-2,-2
e1169,e,Type 2 diabetes mellitus with other specified complication,"Endocrine, nutritional and metabolic diseases",2889,2672,2707,-0.075112496,0.013098802,-0.062997577,255,267,270,12,3,15
e118,e,Type 2 diabetes mellitus with unspecified complications,"Endocrine, nutritional and metabolic diseases",329,217,160,-0.340425532,-0.262672811,-0.513677812,1221,1532,1808,311,276,587
e119,e,Type 2 diabetes mellitus without complications,"Endocrine, nutritional and metabolic diseases",26239,25236,26547,-0.038225542,0.051949596,0.011738252,21,22,24,1,2,3
e1310,e,Other specified diabetes mellitus with ketoacidosis without coma,"Endocrine, nutritional and metabolic diseases",101,32,33,-0.683168317,0.03125,-0.673267327,2403,4047,4079,1644,32,1676
e1322,e,Other specified diabetes mellitus with diabetic chronic kidney disease,"Endocrine, nutritional and metabolic diseases",28,25,17,-0.107142857,-0.32,-0.392857143,4493,4541,5299,48,758,806
e1365,e,Other specified diabetes mellitus with hyperglycemia,"Endocrine, nutritional and metabolic diseases",30,31,20,0.033333333,-0.35483871,-0.333333333,4350,4105,4982,-245,877,632
e139,e,Other specified diabetes mellitus without complications,"Endocrine, nutritional and metabolic diseases",36,40,45,0.111111111,0.125,0.25,4002,3665,3531,-337,-134,-471
e160,e,Drug-induced hypoglycemia without coma,"Endocrine, nutritional and metabolic diseases",42,30,13,-0.285714286,-0.566666667,-0.69047619,3734,4173,5761,439,1588,2027
e161,e,Other hypoglycemia,"Endocrine, nutritional and metabolic diseases",56,44,44,-0.214285714,0,-0.214285714,3268,3516,3568,248,52,300
e162,e,"Hypoglycemia, unspecified","Endocrine, nutritional and metabolic diseases",1904,1847,1900,-0.029936975,0.028695181,-0.00210084,367,371,367,4,-4,0
e209,e,"Hypoparathyroidism, unspecified","Endocrine, nutritional and metabolic diseases",80,71,79,-0.1125,0.112676056,-0.0125,2729,2780,2664,51,-116,-65
e210,e,Primary hyperparathyroidism,"Endocrine, nutritional and metabolic diseases",172,186,182,0.081395349,-0.021505376,0.058139535,1785,1675,1692,-110,17,-93
e211,e,"Secondary hyperparathyroidism, not elsewhere classified","Endocrine, nutritional and metabolic diseases",29,33,56,0.137931034,0.696969697,0.931034483,4417,3981,3163,-436,-818,-1254
e212,e,Other hyperparathyroidism,"Endocrine, nutritional and metabolic diseases",39,41,55,0.051282051,0.341463415,0.41025641,3865,3618,3195,-247,-423,-670
e213,e,"Hyperparathyroidism, unspecified","Endocrine, nutritional and metabolic diseases",616,514,484,-0.165584416,-0.058365759,-0.214285714,815,899,952,84,53,137
e220,e,Acromegaly and pituitary gigantism,"Endocrine, nutritional and metabolic diseases",20,26,29,0.3,0.115384615,0.45,5153,4460,4290,-693,-170,-863
e221,e,Hyperprolactinemia,"Endocrine, nutritional and metabolic diseases",51,62,42,0.215686275,-0.322580645,-0.176470588,3415,2991,3643,-424,652,228
e222,e,Syndrome of inappropriate secretion of antidiuretic hormone,"Endocrine, nutritional and metabolic diseases",1714,2118,2240,0.235705951,0.057601511,0.306884481,397,324,324,-73,0,-73
e230,e,Hypopituitarism,"Endocrine, nutritional and metabolic diseases",227,261,229,0.149779736,-0.122605364,0.008810573,1528,1354,1485,-174,131,-43
e232,e,Diabetes insipidus,"Endocrine, nutritional and metabolic diseases",247,260,224,0.052631579,-0.138461538,-0.093117409,1446,1359,1504,-87,145,58
e236,e,Other disorders of pituitary gland,"Endocrine, nutritional and metabolic diseases",56,63,45,0.125,-0.285714286,-0.196428571,3261,2962,3522,-299,560,261
e237,e,"Disorder of pituitary gland, unspecified","Endocrine, nutritional and metabolic diseases",15,18,15,0.2,-0.166666667,0,5661,5199,5505,-462,306,-156
e242,e,Drug-induced Cushing's syndrome,"Endocrine, nutritional and metabolic diseases",29,27,29,-0.068965517,0.074074074,0,4410,4384,4285,-26,-99,-125
e249,e,"Cushing's syndrome, unspecified","Endocrine, nutritional and metabolic diseases",91,71,88,-0.21978022,0.23943662,-0.032967033,2537,2775,2508,238,-267,-29
e250,e,Congenital adrenogenital disorders associated with enzyme deficiency,"Endocrine, nutritional and metabolic diseases",25,21,24,-0.16,0.142857143,-0.04,4698,4883,4647,185,-236,-51
e2609,e,Other primary hyperaldosteronism,"Endocrine, nutritional and metabolic diseases",18,17,26,-0.055555556,0.529411765,0.444444444,5338,5316,4484,-22,-832,-854
e2681,e,Bartter's syndrome,"Endocrine, nutritional and metabolic diseases",18,11,14,-0.388888889,0.272727273,-0.222222222,5338,5988,5614,650,-374,276
e269,e,"Hyperaldosteronism, unspecified","Endocrine, nutritional and metabolic diseases",51,47,36,-0.078431373,-0.234042553,-0.294117647,3410,3385,3880,-25,495,470
e271,e,Primary adrenocortical insufficiency,"Endocrine, nutritional and metabolic diseases",391,354,351,-0.094629156,-0.008474576,-0.10230179,1085,1125,1158,40,33,73
e272,e,Addisonian crisis,"Endocrine, nutritional and metabolic diseases",112,91,95,-0.1875,0.043956044,-0.151785714,2268,2433,2402,165,-31,134
e273,e,Drug-induced adrenocortical insufficiency,"Endocrine, nutritional and metabolic diseases",142,120,123,-0.154929577,0.025,-0.133802817,1969,2096,2082,127,-14,113
e2740,e,Unspecified adrenocortical insufficiency,"Endocrine, nutritional and metabolic diseases",1419,1275,1253,-0.101479915,-0.017254902,-0.116983791,462,479,493,17,14,31
e2749,e,Other adrenocortical insufficiency,"Endocrine, nutritional and metabolic diseases",164,179,205,0.091463415,0.145251397,0.25,1820,1700,1578,-120,-122,-242
e278,e,Other specified disorders of adrenal gland,"Endocrine, nutritional and metabolic diseases",519,494,523,-0.048169557,0.058704453,0.007707129,928,923,900,-5,-23,-28
e279,e,"Disorder of adrenal gland, unspecified","Endocrine, nutritional and metabolic diseases",312,261,279,-0.163461538,0.068965517,-0.105769231,1268,1351,1325,83,-26,57
e282,e,Polycystic ovarian syndrome,"Endocrine, nutritional and metabolic diseases",985,903,1001,-0.083248731,0.108527132,0.016243655,582,594,569,12,-25,-13
e291,e,Testicular hypofunction,"Endocrine, nutritional and metabolic diseases",299,218,225,-0.27090301,0.032110092,-0.247491639,1305,1516,1494,211,-22,189
e301,e,Precocious puberty,"Endocrine, nutritional and metabolic diseases",26,25,17,-0.038461538,-0.32,-0.346153846,4619,4513,5270,-106,757,651
e310,e,Autoimmune polyglandular failure,"Endocrine, nutritional and metabolic diseases",13,11,20,-0.153846154,0.818181818,0.538461538,5858,5977,4954,119,-1023,-904
e340,e,Carcinoid syndrome,"Endocrine, nutritional and metabolic diseases",28,21,24,-0.25,0.142857143,-0.142857143,4466,4872,4636,406,-236,170
e41,e,Nutritional marasmus,"Endocrine, nutritional and metabolic diseases",47,37,27,-0.212765957,-0.27027027,-0.425531915,3522,3769,4405,247,636,883
e43,e,Unspecified severe protein-calorie malnutrition,"Endocrine, nutritional and metabolic diseases",7825,7548,7999,-0.035399361,0.059750927,0.022236422,88,91,87,3,-4,-1
e440,e,Moderate protein-calorie malnutrition,"Endocrine, nutritional and metabolic diseases",3934,4585,4532,0.165480427,-0.011559433,0.152008134,202,169,185,-33,16,-17
e441,e,Mild protein-calorie malnutrition,"Endocrine, nutritional and metabolic diseases",1788,2199,2756,0.229865772,0.253296953,0.541387025,383,306,262,-77,-44,-121
e46,e,Unspecified protein-calorie malnutrition,"Endocrine, nutritional and metabolic diseases",5964,4541,4802,-0.238598256,0.057476327,-0.194835681,127,171,176,44,5,49
e509,e,"Vitamin A deficiency, unspecified","Endocrine, nutritional and metabolic diseases",36,45,18,0.25,-0.6,-0.5,3974,3449,5149,-525,1700,1175
e512,e,Wernicke's encephalopathy,"Endocrine, nutritional and metabolic diseases",159,186,247,0.169811321,0.327956989,0.553459119,1839,1661,1417,-178,-244,-422
e519,e,"Thiamine deficiency, unspecified","Endocrine, nutritional and metabolic diseases",33,45,45,0.363636364,0,0.363636364,4132,3448,3507,-684,59,-625
e538,e,Deficiency of other specified B group vitamins,"Endocrine, nutritional and metabolic diseases",1627,1576,1628,-0.031346036,0.032994924,0.000614628,407,410,410,3,0,3
e539,e,"Vitamin B deficiency, unspecified","Endocrine, nutritional and metabolic diseases",43,37,23,-0.139534884,-0.378378378,-0.465116279,3669,3761,4699,92,938,1030
e559,e,"Vitamin D deficiency, unspecified","Endocrine, nutritional and metabolic diseases",3617,3336,3117,-0.077688692,-0.065647482,-0.138236107,208,217,239,9,22,31
e561,e,Deficiency of vitamin K,"Endocrine, nutritional and metabolic diseases",48,34,46,-0.291666667,0.352941176,-0.041666667,3490,3885,3465,395,-420,-25
e569,e,"Vitamin deficiency, unspecified","Endocrine, nutritional and metabolic diseases",34,18,21,-0.470588235,0.166666667,-0.382352941,4072,5172,4863,1100,-309,791
e60,e,Dietary zinc deficiency,"Endocrine, nutritional and metabolic diseases",34,34,37,0,0.088235294,0.088235294,4072,3885,3820,-187,-65,-252
e611,e,Iron deficiency,"Endocrine, nutritional and metabolic diseases",475,441,460,-0.071578947,0.0430839,-0.031578947,968,989,975,21,-14,7
e631,e,Imbalance of constituents of food intake,"Endocrine, nutritional and metabolic diseases",13,28,31,1.153846154,0.107142857,1.384615385,5842,4285,4162,-1557,-123,-1680
e639,e,"Nutritional deficiency, unspecified","Endocrine, nutritional and metabolic diseases",80,97,105,0.2125,0.082474227,0.3125,2706,2322,2245,-384,-77,-461
e65,e,Localized adiposity,"Endocrine, nutritional and metabolic diseases",57,40,34,-0.298245614,-0.15,-0.403508772,3220,3632,3982,412,350,762
e6601,e,Morbid (severe) obesity due to excess calories,"Endocrine, nutritional and metabolic diseases",19262,18004,22073,-0.065309937,0.226005332,0.145935002,32,31,28,-1,-3,-4
e6609,e,Other obesity due to excess calories,"Endocrine, nutritional and metabolic diseases",650,662,819,0.018461538,0.237160121,0.26,777,745,643,-32,-102,-134
e662,e,Morbid (severe) obesity with alveolar hypoventilation,"Endocrine, nutritional and metabolic diseases",1672,1813,1840,0.084330144,0.014892443,0.100478469,399,367,368,-32,1,-31
e663,e,Overweight,"Endocrine, nutritional and metabolic diseases",920,920,1219,0,0.325,0.325,596,580,491,-16,-89,-105
e668,e,Other obesity,"Endocrine, nutritional and metabolic diseases",172,217,410,0.261627907,0.889400922,1.38372093,1764,1509,1043,-255,-466,-721
e669,e,"Obesity, unspecified","Endocrine, nutritional and metabolic diseases",25328,24227,29043,-0.043469678,0.198786478,0.146675616,21,23,21,2,-2,0
e7209,e,Other disorders of amino-acid transport,"Endocrine, nutritional and metabolic diseases",17,10,11,-0.411764706,0.1,-0.352941176,5397,6054,5936,657,-118,539
e7211,e,Homocystinuria,"Endocrine, nutritional and metabolic diseases",46,77,38,0.673913043,-0.506493506,-0.173913043,3534,2625,3777,-909,1152,243
e7212,e,Methylenetetrahydrofolate reductase deficiency,"Endocrine, nutritional and metabolic diseases",139,121,171,-0.129496403,0.41322314,0.230215827,1974,2063,1721,89,-342,-253
e7220,e,"Disorder of urea cycle metabolism, unspecified","Endocrine, nutritional and metabolic diseases",513,457,528,-0.109161793,0.15536105,0.029239766,920,964,884,44,-80,-36
e724,e,Disorders of ornithine metabolism,"Endocrine, nutritional and metabolic diseases",42,52,35,0.238095238,-0.326923077,-0.166666667,3691,3202,3915,-489,713,224
e7251,e,Non-ketotic hyperglycinemia,"Endocrine, nutritional and metabolic diseases",37,22,11,-0.405405405,-0.5,-0.702702703,3905,4734,5932,829,1198,2027
e739,e,"Lactose intolerance, unspecified","Endocrine, nutritional and metabolic diseases",232,222,220,-0.043103448,-0.009009009,-0.051724138,1483,1489,1495,6,6,12
e7439,e,Other disorders of intestinal carbohydrate absorption,"Endocrine, nutritional and metabolic diseases",90,89,84,-0.011111111,-0.056179775,-0.066666667,2528,2430,2539,-98,109,11
e7521,e,Fabry (-Anderson) disease,"Endocrine, nutritional and metabolic diseases",19,10,14,-0.473684211,0.4,-0.263157895,5192,6047,5571,855,-476,379
e778,e,Other disorders of glycoprotein metabolism,"Endocrine, nutritional and metabolic diseases",110,126,125,0.145454545,-0.007936508,0.136363636,2266,2021,2040,-245,19,-226
e7800,e,"Pure hypercholesterolemia, unspecified","Endocrine, nutritional and metabolic diseases",19885,16395,17512,-0.175509178,0.068130528,-0.119336183,28,36,34,8,-2,6
e7801,e,Familial hypercholesterolemia,"Endocrine, nutritional and metabolic diseases",61,60,79,-0.016393443,0.316666667,0.295081967,3102,2997,2628,-105,-369,-474
e781,e,Pure hyperglyceridemia,"Endocrine, nutritional and metabolic diseases",1533,1403,1649,-0.084801044,0.17533856,0.075668624,423,438,397,15,-41,-26
e782,e,Mixed hyperlipidemia,"Endocrine, nutritional and metabolic diseases",4440,4555,4964,0.025900901,0.089791438,0.118018018,174,167,162,-7,-5,-12
e783,e,Hyperchylomicronemia,"Endocrine, nutritional and metabolic diseases",15,16,14,0.066666667,-0.125,-0.066666667,5607,5373,5566,-234,193,-41
e7849,e,Other hyperlipidemia,"Endocrine, nutritional and metabolic diseases",355,333,185,-0.061971831,-0.444444444,-0.478873239,1136,1158,1650,22,492,514
e785,e,"Hyperlipidemia, unspecified","Endocrine, nutritional and metabolic diseases",79351,77339,80662,-0.025355698,0.042966679,0.016521531,2,3,4,1,1,2
e786,e,Lipoprotein deficiency,"Endocrine, nutritional and metabolic diseases",24,53,34,1.208333333,-0.358490566,0.416666667,4725,3163,3963,-1562,800,-762
e790,e,Hyperuricemia without signs of inflammatory arthritis and tophaceous disease,"Endocrine, nutritional and metabolic diseases",330,283,293,-0.142424242,0.035335689,-0.112121212,1188,1275,1266,87,-9,78
e8020,e,Unspecified porphyria,"Endocrine, nutritional and metabolic diseases",10,15,18,0.5,0.2,0.8,6065,5467,5116,-598,-351,-949
e8021,e,Acute intermittent (hepatic) porphyria,"Endocrine, nutritional and metabolic diseases",25,15,13,-0.4,-0.133333333,-0.48,4648,5467,5687,819,220,1039
e804,e,Gilbert syndrome,"Endocrine, nutritional and metabolic diseases",147,121,140,-0.176870748,0.157024793,-0.047619048,1907,2054,1904,147,-150,-3
e806,e,Other disorders of bilirubin metabolism,"Endocrine, nutritional and metabolic diseases",814,761,1061,-0.065110565,0.394218134,0.303439803,655,660,536,5,-124,-119
e807,e,"Disorder of bilirubin metabolism, unspecified","Endocrine, nutritional and metabolic diseases",883,811,612,-0.081540204,-0.245376079,-0.306908267,612,635,784,23,149,172
e8301,e,Wilson's disease,"Endocrine, nutritional and metabolic diseases",15,10,18,-0.333333333,0.8,0.2,5599,6032,5113,433,-919,-486
e83110,e,Hereditary hemochromatosis,"Endocrine, nutritional and metabolic diseases",38,46,55,0.210526316,0.195652174,0.447368421,3851,3382,3151,-469,-231,-700
e83111,e,Hemochromatosis due to repeated red blood cell transfusions,"Endocrine, nutritional and metabolic diseases",55,79,65,0.436363636,-0.17721519,0.181818182,3253,2581,2894,-672,313,-359
e83119,e,"Hemochromatosis, unspecified","Endocrine, nutritional and metabolic diseases",221,185,177,-0.162895928,-0.043243243,-0.199095023,1522,1644,1674,122,30,152
e8319,e,Other disorders of iron metabolism,"Endocrine, nutritional and metabolic diseases",25,18,17,-0.28,-0.055555556,-0.32,4642,5139,5221,497,82,579
e8330,e,"Disorder of phosphorus metabolism, unspecified","Endocrine, nutritional and metabolic diseases",39,24,44,-0.384615385,0.833333333,0.128205128,3810,4547,3513,737,-1034,-297
e8339,e,Other disorders of phosphorus metabolism,"Endocrine, nutritional and metabolic diseases",6891,7079,8216,0.027281962,0.160615906,0.192279785,101,95,79,-6,-16,-22
e8341,e,Hypermagnesemia,"Endocrine, nutritional and metabolic diseases",459,483,672,0.052287582,0.391304348,0.464052288,980,917,735,-63,-182,-245
e8342,e,Hypomagnesemia,"Endocrine, nutritional and metabolic diseases",15077,14781,13324,-0.019632553,-0.098572492,-0.116269815,39,36,47,-3,11,8
e8351,e,Hypocalcemia,"Endocrine, nutritional and metabolic diseases",4131,4219,5027,0.021302348,0.191514577,0.216896635,180,177,157,-3,-20,-23
e8352,e,Hypercalcemia,"Endocrine, nutritional and metabolic diseases",2950,2833,3042,-0.039661017,0.073773385,0.031186441,234,244,237,10,-7,3
e8359,e,Other disorders of calcium metabolism,"Endocrine, nutritional and metabolic diseases",115,111,145,-0.034782609,0.306306306,0.260869565,2190,2130,1865,-60,-265,-325
e8389,e,Other disorders of mineral metabolism,"Endocrine, nutritional and metabolic diseases",17,12,21,-0.294117647,0.75,0.235294118,5365,5808,4824,443,-984,-541
e839,e,"Disorder of mineral metabolism, unspecified","Endocrine, nutritional and metabolic diseases",14,13,31,-0.071428571,1.384615385,1.214285714,5687,5686,4126,-1,-1560,-1561
e840,e,Cystic fibrosis with pulmonary manifestations,"Endocrine, nutritional and metabolic diseases",137,96,65,-0.299270073,-0.322916667,-0.525547445,1971,2313,2887,342,574,916
e8419,e,Cystic fibrosis with other intestinal manifestations,"Endocrine, nutritional and metabolic diseases",22,16,14,-0.272727273,-0.125,-0.363636364,4886,5354,5543,468,189,657
e848,e,Cystic fibrosis with other manifestations,"Endocrine, nutritional and metabolic diseases",122,78,74,-0.360655738,-0.051282051,-0.393442623,2108,2584,2695,476,111,587
e849,e,"Cystic fibrosis, unspecified","Endocrine, nutritional and metabolic diseases",97,75,65,-0.226804124,-0.133333333,-0.329896907,2409,2638,2886,229,248,477
e854,e,Organ-limited amyloidosis,"Endocrine, nutritional and metabolic diseases",171,202,198,0.18128655,-0.01980198,0.157894737,1753,1559,1580,-194,21,-173
e8581,e,Light chain (AL) amyloidosis,"Endocrine, nutritional and metabolic diseases",44,45,34,0.022727273,-0.244444444,-0.227272727,3594,3407,3945,-187,538,351
e8589,e,Other amyloidosis,"Endocrine, nutritional and metabolic diseases",10,12,14,0.2,0.166666667,0.4,6041,5801,5539,-240,-262,-502
e859,e,"Amyloidosis, unspecified","Endocrine, nutritional and metabolic diseases",42,52,49,0.238095238,-0.057692308,0.166666667,3665,3176,3321,-489,145,-344
e860,e,Dehydration,"Endocrine, nutritional and metabolic diseases",28636,27063,26352,-0.054930856,-0.026272032,-0.079759743,17,19,23,2,4,6
e861,e,Hypovolemia,"Endocrine, nutritional and metabolic diseases",5009,5167,5584,0.031543222,0.080704471,0.114793372,155,142,135,-13,-7,-20
e869,e,"Volume depletion, unspecified","Endocrine, nutritional and metabolic diseases",2063,2013,2020,-0.024236549,0.003477397,-0.020843432,324,318,333,-6,15,9
e870,e,Hyperosmolality and hypernatremia,"Endocrine, nutritional and metabolic diseases",5381,5897,7351,0.095892957,0.246566051,0.366102955,145,118,91,-27,-27,-54
e871,e,Hypo-osmolality and hyponatremia,"Endocrine, nutritional and metabolic diseases",29894,33888,39169,0.133605406,0.155836874,0.310262929,16,13,13,-3,0,-3
e872,e,Acidosis,"Endocrine, nutritional and metabolic diseases",28250,29443,32866,0.042230088,0.116258533,0.16339823,16,17,17,1,0,1
e873,e,Alkalosis,"Endocrine, nutritional and metabolic diseases",2524,2586,2917,0.024564184,0.127996906,0.15570523,264,255,236,-9,-19,-28
e874,e,Mixed disorder of acid-base balance,"Endocrine, nutritional and metabolic diseases",2117,2388,2818,0.128011337,0.180067002,0.331128956,314,269,239,-45,-30,-75
e875,e,Hyperkalemia,"Endocrine, nutritional and metabolic diseases",12747,13477,14755,0.057268377,0.094828226,0.157527261,43,40,40,-3,0,-3
e876,e,Hypokalemia,"Endocrine, nutritional and metabolic diseases",39187,38932,42711,-0.00650726,0.09706668,0.089927782,10,10,11,0,1,1
e8770,e,"Fluid overload, unspecified","Endocrine, nutritional and metabolic diseases",5127,5305,5154,0.034718159,-0.028463713,0.005266238,148,134,146,-14,12,-2
e8771,e,Transfusion associated circulatory overload,"Endocrine, nutritional and metabolic diseases",27,26,18,-0.037037037,-0.307692308,-0.333333333,4480,4376,5084,-104,708,604
e8779,e,Other fluid overload,"Endocrine, nutritional and metabolic diseases",306,311,334,0.016339869,0.073954984,0.091503268,1245,1189,1153,-56,-36,-92
e878,e,"Other disorders of electrolyte and fluid balance, not elsewhere classified","Endocrine, nutritional and metabolic diseases",2555,2575,3117,0.007827789,0.210485437,0.219960861,258,252,223,-6,-29,-35
e8801,e,Alpha-1-antitrypsin deficiency,"Endocrine, nutritional and metabolic diseases",112,147,109,0.3125,-0.258503401,-0.026785714,2212,1828,2165,-384,337,-47
e8809,e,"Other disorders of plasma-protein metabolism, not elsewhere classified","Endocrine, nutritional and metabolic diseases",2218,2309,3177,0.041027953,0.375920312,0.432371506,296,271,218,-25,-53,-78
e881,e,"Lipodystrophy, not elsewhere classified","Endocrine, nutritional and metabolic diseases",14,11,18,-0.214285714,0.636363636,0.285714286,5664,5893,5080,229,-813,-584
e882,e,"Lipomatosis, not elsewhere classified","Endocrine, nutritional and metabolic diseases",42,35,42,-0.166666667,0.2,0,3650,3789,3567,139,-222,-83
e883,e,Tumor lysis syndrome,"Endocrine, nutritional and metabolic diseases",196,154,210,-0.214285714,0.363636364,0.071428571,1615,1791,1510,176,-281,-105
e8840,e,"Mitochondrial metabolism disorder, unspecified","Endocrine, nutritional and metabolic diseases",25,25,24,0,-0.04,-0.04,4611,4439,4563,-172,124,-48
e8881,e,Metabolic syndrome,"Endocrine, nutritional and metabolic diseases",325,326,384,0.003076923,0.17791411,0.181538462,1185,1152,1056,-33,-96,-129
e8889,e,Other specified metabolic disorders,"Endocrine, nutritional and metabolic diseases",194,211,234,0.087628866,0.109004739,0.206185567,1623,1500,1421,-123,-79,-202
e889,e,"Metabolic disorder, unspecified","Endocrine, nutritional and metabolic diseases",24,12,15,-0.5,0.25,-0.375,4682,5779,5403,1097,-376,721
e890,e,Postprocedural hypothyroidism,"Endocrine, nutritional and metabolic diseases",2309,2032,2473,-0.119965353,0.217027559,0.071026418,286,306,259,20,-47,-27
e891,e,Postprocedural hypoinsulinemia,"Endocrine, nutritional and metabolic diseases",37,30,36,-0.189189189,0.2,-0.027027027,3856,4075,3802,219,-273,-54
e892,e,Postprocedural hypoparathyroidism,"Endocrine, nutritional and metabolic diseases",117,84,77,-0.282051282,-0.083333333,-0.341880342,2147,2474,2621,327,147,474
e893,e,Postprocedural hypopituitarism,"Endocrine, nutritional and metabolic diseases",21,16,16,-0.238095238,0,-0.238095238,4942,5325,5284,383,-41,342
e896,e,Postprocedural adrenocortical (-medullary) hypofunction,"Endocrine, nutritional and metabolic diseases",28,18,35,-0.357142857,0.944444444,0.25,4387,5102,3865,715,-1237,-522
f0150,f,Vascular dementia without behavioral disturbance,Mental and behavioural disorders,684,702,646,0.026315789,-0.07977208,-0.055555556,731,692,733,-39,41,2
f0151,f,Vascular dementia with behavioral disturbance,Mental and behavioural disorders,224,171,272,-0.236607143,0.590643275,0.214285714,1488,1674,1299,186,-375,-189
f0280,f,Dementia in other diseases classified elsewhere without behavioral disturbance,Mental and behavioural disorders,3520,3475,3371,-0.012784091,-0.029928058,-0.042329545,199,194,208,-5,14,9
f0281,f,Dementia in other diseases classified elsewhere with behavioral disturbance,Mental and behavioural disorders,680,657,705,-0.033823529,0.073059361,0.036764706,731,719,702,-12,-17,-29
f0390,f,Unspecified dementia without behavioral disturbance,Mental and behavioural disorders,9558,9506,9870,-0.005440469,0.038291605,0.032642812,59,62,60,3,-2,1
f0391,f,Unspecified dementia with behavioral disturbance,Mental and behavioural disorders,691,755,858,0.092619392,0.136423841,0.241678726,723,642,591,-81,-51,-132
f04,f,Amnestic disorder due to known physiological condition,Mental and behavioural disorders,25,19,18,-0.24,-0.052631579,-0.28,4599,4992,5065,393,73,466
f05,f,Delirium due to known physiological condition,Mental and behavioural disorders,2301,2172,2399,-0.056062581,0.104511971,0.042590178,285,285,267,0,-18,-18
f061,f,Catatonic disorder due to known physiological condition,Mental and behavioural disorders,79,79,68,0,-0.139240506,-0.139240506,2664,2545,2786,-119,241,122
f062,f,Psychotic disorder with delusions due to known physiological condition,Mental and behavioural disorders,12,11,11,-0.083333333,0,-0.083333333,5841,5873,5855,32,-18,14
f0630,f,"Mood disorder due to known physiological condition, unspecified",Mental and behavioural disorders,59,38,41,-0.355932203,0.078947368,-0.305084746,3105,3644,3598,539,-46,493
f0631,f,Mood disorder due to known physiological condition with depressive features,Mental and behavioural disorders,50,35,30,-0.3,-0.142857143,-0.4,3364,3775,4141,411,366,777
f064,f,Anxiety disorder due to known physiological condition,Mental and behavioural disorders,220,197,229,-0.104545455,0.162436548,0.040909091,1498,1558,1429,60,-129,-69
f068,f,Other specified mental disorders due to known physiological condition,Mental and behavioural disorders,55,49,42,-0.109090909,-0.142857143,-0.236363636,3212,3231,3553,19,322,341
f070,f,Personality change due to known physiological condition,Mental and behavioural disorders,15,32,19,1.133333333,-0.40625,0.266666667,5540,3935,4957,-1605,1022,-583
f0781,f,Postconcussional syndrome,Mental and behavioural disorders,212,159,193,-0.25,0.213836478,-0.089622642,1534,1740,1573,206,-167,39
f09,f,Unspecified mental disorder due to known physiological condition,Mental and behavioural disorders,285,261,297,-0.084210526,0.137931034,0.042105263,1283,1302,1223,19,-79,-60
f1010,f,"Alcohol abuse, uncomplicated",Mental and behavioural disorders,6945,7028,7745,0.011951044,0.102020489,0.115190785,93,89,82,-4,-7,-11
f1011,f,"Alcohol abuse, in remission",Mental and behavioural disorders,855,846,790,-0.010526316,-0.066193853,-0.076023392,607,590,634,-17,44,27
f10120,f,"Alcohol abuse with intoxication, uncomplicated",Mental and behavioural disorders,144,181,157,0.256944444,-0.132596685,0.090277778,1889,1626,1749,-263,123,-140
f10121,f,Alcohol abuse with intoxication delirium,Mental and behavioural disorders,42,34,44,-0.19047619,0.294117647,0.047619048,3628,3805,3468,177,-337,-160
f10129,f,"Alcohol abuse with intoxication, unspecified",Mental and behavioural disorders,1441,1397,1406,-0.030534351,0.006442377,-0.024288688,419,415,420,-4,5,1
f1014,f,Alcohol abuse with alcohol-induced mood disorder,Mental and behavioural disorders,47,47,23,0,-0.510638298,-0.510638298,3440,3294,4608,-146,1314,1168
f10188,f,Alcohol abuse with other alcohol-induced disorder,Mental and behavioural disorders,118,141,77,0.194915254,-0.453900709,-0.347457627,2121,1856,2607,-265,751,486
f1019,f,Alcohol abuse with unspecified alcohol-induced disorder,Mental and behavioural disorders,15,15,19,0,0.266666667,0.266666667,5531,5397,4948,-134,-449,-583
f1020,f,"Alcohol dependence, uncomplicated",Mental and behavioural disorders,5889,5605,5998,-0.048225505,0.070115968,0.018509085,118,122,115,4,-7,-3
f1021,f,"Alcohol dependence, in remission",Mental and behavioural disorders,1325,1183,1069,-0.107169811,-0.096365173,-0.193207547,442,461,507,19,46,65
f10220,f,"Alcohol dependence with intoxication, uncomplicated",Mental and behavioural disorders,141,156,178,0.106382979,0.141025641,0.262411348,1904,1756,1631,-148,-125,-273
f10221,f,Alcohol dependence with intoxication delirium,Mental and behavioural disorders,84,51,76,-0.392857143,0.490196078,-0.095238095,2556,3164,2623,608,-541,67
f10229,f,"Alcohol dependence with intoxication, unspecified",Mental and behavioural disorders,1678,1522,1656,-0.092967819,0.08804205,-0.013110846,371,387,370,16,-17,-1
f10230,f,"Alcohol dependence with withdrawal, uncomplicated",Mental and behavioural disorders,554,683,853,0.232851986,0.248901903,0.539711191,826,695,587,-131,-108,-239
f10231,f,Alcohol dependence with withdrawal delirium,Mental and behavioural disorders,1039,936,1040,-0.099133782,0.111111111,0.000962464,520,542,515,22,-27,-5
f10232,f,Alcohol dependence with withdrawal with perceptual disturbance,Mental and behavioural disorders,113,94,121,-0.168141593,0.287234043,0.07079646,2170,2305,2018,135,-287,-152
f10239,f,"Alcohol dependence with withdrawal, unspecified",Mental and behavioural disorders,5892,6071,6273,0.030380177,0.033272937,0.064663951,117,107,107,-10,0,-10
f1024,f,Alcohol dependence with alcohol-induced mood disorder,Mental and behavioural disorders,130,149,177,0.146153846,0.187919463,0.361538462,1984,1788,1630,-196,-158,-354
f10251,f,Alcohol dependence with alcohol-induced psychotic disorder with hallucinations,Mental and behavioural disorders,23,28,38,0.217391304,0.357142857,0.652173913,4733,4190,3697,-543,-493,-1036
f10259,f,"Alcohol dependence with alcohol-induced psychotic disorder, unspecified",Mental and behavioural disorders,16,19,12,0.1875,-0.368421053,-0.25,5400,4965,5707,-435,742,307
f1026,f,Alcohol dependence with alcohol-induced persisting amnestic disorder,Mental and behavioural disorders,23,21,27,-0.086956522,0.285714286,0.173913043,4733,4757,4296,24,-461,-437
f1027,f,Alcohol dependence with alcohol-induced persisting dementia,Mental and behavioural disorders,68,63,70,-0.073529412,0.111111111,0.029411765,2868,2865,2744,-3,-121,-124
f10280,f,Alcohol dependence with alcohol-induced anxiety disorder,Mental and behavioural disorders,40,39,59,-0.025,0.512820513,0.475,3692,3582,2985,-110,-597,-707
f10288,f,Alcohol dependence with other alcohol-induced disorder,Mental and behavioural disorders,142,207,96,0.457746479,-0.536231884,-0.323943662,1893,1502,2301,-391,799,408
f1029,f,Alcohol dependence with unspecified alcohol-induced disorder,Mental and behavioural disorders,16,22,41,0.375,0.863636364,1.5625,5396,4644,3575,-752,-1069,-1821
f10920,f,"Alcohol use, unspecified with intoxication, uncomplicated",Mental and behavioural disorders,19,12,15,-0.368421053,0.25,-0.210526316,5097,5733,5358,636,-375,261
f10929,f,"Alcohol use, unspecified with intoxication, unspecified",Mental and behavioural disorders,91,78,77,-0.142857143,-0.012820513,-0.153846154,2445,2537,2597,92,60,152
f1094,f,"Alcohol use, unspecified with alcohol-induced mood disorder",Mental and behavioural disorders,10,19,12,0.9,-0.368421053,0.2,5968,4959,5700,-1009,741,-268
f1097,f,"Alcohol use, unspecified with alcohol-induced persisting dementia",Mental and behavioural disorders,20,18,16,-0.1,-0.111111111,-0.2,5007,5060,5242,53,182,235
f10988,f,"Alcohol use, unspecified with other alcohol-induced disorder",Mental and behavioural disorders,26,20,17,-0.230769231,-0.15,-0.346153846,4502,4862,5139,360,277,637
f1099,f,"Alcohol use, unspecified with unspecified alcohol-induced disorder",Mental and behavioural disorders,43,53,51,0.23255814,-0.037735849,0.186046512,3576,3099,3205,-477,106,-371
f1110,f,"Opioid abuse, uncomplicated",Mental and behavioural disorders,2175,2122,2277,-0.024367816,0.073044298,0.046896552,290,291,286,1,-5,-4
f1111,f,"Opioid abuse, in remission",Mental and behavioural disorders,231,230,172,-0.004329004,-0.252173913,-0.255411255,1440,1408,1657,-32,249,217
f11120,f,"Opioid abuse with intoxication, uncomplicated",Mental and behavioural disorders,14,13,10,-0.071428571,-0.230769231,-0.285714286,5605,5605,5910,0,305,305
f11129,f,"Opioid abuse with intoxication, unspecified",Mental and behavioural disorders,37,50,37,0.351351351,-0.26,0,3817,3175,3722,-642,547,-95
f1120,f,"Opioid dependence, uncomplicated",Mental and behavioural disorders,7490,6772,6720,-0.095861148,-0.007678677,-0.102803738,86,91,97,5,6,11
f1121,f,"Opioid dependence, in remission",Mental and behavioural disorders,316,257,247,-0.186708861,-0.038910506,-0.21835443,1194,1306,1360,112,54,166
f11229,f,"Opioid dependence with intoxication, unspecified",Mental and behavioural disorders,30,29,34,-0.033333333,0.172413793,0.133333333,4206,4099,3880,-107,-219,-326
f1123,f,Opioid dependence with withdrawal,Mental and behavioural disorders,4430,4251,5234,-0.040406321,0.231239708,0.181489842,158,162,136,4,-26,-22
f1124,f,Opioid dependence with opioid-induced mood disorder,Mental and behavioural disorders,58,30,59,-0.482758621,0.966666667,0.017241379,3108,4031,2978,923,-1053,-130
f11288,f,Opioid dependence with other opioid-induced disorder,Mental and behavioural disorders,30,22,12,-0.266666667,-0.454545455,-0.6,4204,4634,5689,430,1055,1485
f1129,f,Opioid dependence with unspecified opioid-induced disorder,Mental and behavioural disorders,74,70,85,-0.054054054,0.214285714,0.148648649,2738,2688,2460,-50,-228,-278
f1190,f,"Opioid use, unspecified, uncomplicated",Mental and behavioural disorders,744,654,622,-0.120967742,-0.048929664,-0.163978495,660,705,741,45,36,81
f1193,f,"Opioid use, unspecified with withdrawal",Mental and behavioural disorders,10,34,58,2.4,0.705882353,4.8,5953,3779,2997,-2174,-782,-2956
f1199,f,"Opioid use, unspecified with unspecified opioid-induced disorder",Mental and behavioural disorders,48,52,68,0.083333333,0.307692308,0.416666667,3394,3120,2758,-274,-362,-636
f1210,f,"Cannabis abuse, uncomplicated",Mental and behavioural disorders,4241,4386,4909,0.03419005,0.119243046,0.157510021,163,157,147,-6,-10,-16
f1211,f,"Cannabis abuse, in remission",Mental and behavioural disorders,147,119,139,-0.19047619,0.168067227,-0.054421769,1854,2016,1859,162,-157,5
f12129,f,"Cannabis abuse with intoxication, unspecified",Mental and behavioural disorders,16,16,20,0,0.25,0.25,5377,5264,4817,-113,-447,-560
f12159,f,"Cannabis abuse with psychotic disorder, unspecified",Mental and behavioural disorders,30,11,20,-0.633333333,0.818181818,-0.333333333,4199,5818,4817,1619,-1001,618
f12188,f,Cannabis abuse with other cannabis-induced disorder,Mental and behavioural disorders,41,52,43,0.268292683,-0.173076923,0.048780488,3639,3118,3480,-521,362,-159
f1220,f,"Cannabis dependence, uncomplicated",Mental and behavioural disorders,2049,2182,2522,0.064909712,0.155820348,0.230844314,305,276,245,-29,-31,-60
f1221,f,"Cannabis dependence, in remission",Mental and behavioural disorders,155,96,91,-0.380645161,-0.052083333,-0.412903226,1800,2260,2369,460,109,569
f1223,f,Cannabis dependence with withdrawal,Mental and behavioural disorders,18,21,32,0.166666667,0.523809524,0.777777778,5177,4733,3981,-444,-752,-1196
f1290,f,"Cannabis use, unspecified, uncomplicated",Mental and behavioural disorders,5656,5562,5222,-0.016619519,-0.06112909,-0.076732673,126,120,136,-6,16,10
f12929,f,"Cannabis use, unspecified with intoxication, unspecified",Mental and behavioural disorders,23,28,22,0.217391304,-0.214285714,-0.043478261,4708,4167,4655,-541,488,-53
f12988,f,"Cannabis use, unspecified with other cannabis-induced disorder",Mental and behavioural disorders,46,40,37,-0.130434783,-0.075,-0.195652174,3440,3526,3708,86,182,268
f1299,f,"Cannabis use, unspecified with unspecified cannabis-induced disorder",Mental and behavioural disorders,62,101,64,0.629032258,-0.366336634,0.032258065,2999,2173,2840,-826,667,-159
f1310,f,"Sedative, hypnotic or anxiolytic abuse, uncomplicated",Mental and behavioural disorders,417,402,579,-0.035971223,0.440298507,0.388489209,988,987,781,-1,-206,-207
f1311,f,"Sedative, hypnotic or anxiolytic abuse, in remission",Mental and behavioural disorders,12,27,12,1.25,-0.555555556,0,5778,4235,5672,-1543,1437,-106
f1320,f,"Sedative, hypnotic or anxiolytic dependence, uncomplicated",Mental and behavioural disorders,581,598,596,0.029259897,-0.003344482,0.025817556,783,753,756,-30,3,-27
f1321,f,"Sedative, hypnotic or anxiolytic dependence, in remission",Mental and behavioural disorders,26,19,29,-0.269230769,0.526315789,0.115384615,4478,4931,4136,453,-795,-342
f13230,f,"Sedative, hypnotic or anxiolytic dependence with withdrawal, uncomplicated",Mental and behavioural disorders,105,163,226,0.552380952,0.386503067,1.152380952,2246,1695,1419,-551,-276,-827
f13231,f,"Sedative, hypnotic or anxiolytic dependence with withdrawal delirium",Mental and behavioural disorders,10,11,17,0.1,0.545454545,0.7,5935,5805,5110,-130,-695,-825
f13239,f,"Sedative, hypnotic or anxiolytic dependence with withdrawal, unspecified",Mental and behavioural disorders,353,366,449,0.036827195,0.226775956,0.271954674,1095,1038,935,-57,-103,-160
f1390,f,"Sedative, hypnotic, or anxiolytic use, unspecified, uncomplicated",Mental and behavioural disorders,80,106,98,0.325,-0.075471698,0.225,2613,2114,2260,-499,146,-353
f1410,f,"Cocaine abuse, uncomplicated",Mental and behavioural disorders,1166,1307,1286,0.120926244,-0.01606733,0.102915952,471,427,437,-44,10,-34
f1411,f,"Cocaine abuse, in remission",Mental and behavioural disorders,152,161,138,0.059210526,-0.142857143,-0.092105263,1809,1702,1862,-107,160,53
f14129,f,"Cocaine abuse with intoxication, unspecified",Mental and behavioural disorders,35,39,42,0.114285714,0.076923077,0.2,3891,3555,3506,-336,-49,-385
f1420,f,"Cocaine dependence, uncomplicated",Mental and behavioural disorders,260,301,256,0.157692308,-0.149501661,-0.015384615,1324,1182,1323,-142,141,-1
f1421,f,"Cocaine dependence, in remission",Mental and behavioural disorders,71,73,45,0.028169014,-0.383561644,-0.366197183,2788,2617,3392,-171,775,604
f1423,f,Cocaine dependence with withdrawal,Mental and behavioural disorders,30,43,44,0.433333333,0.023255814,0.466666667,4183,3392,3426,-791,34,-757
f1490,f,"Cocaine use, unspecified, uncomplicated",Mental and behavioural disorders,460,431,367,-0.063043478,-0.148491879,-0.202173913,936,948,1055,12,107,119
f1510,f,"Other stimulant abuse, uncomplicated",Mental and behavioural disorders,7140,7217,7856,0.010784314,0.088540945,0.100280112,87,86,78,-1,-8,-9
f1511,f,"Other stimulant abuse, in remission",Mental and behavioural disorders,503,488,417,-0.029821074,-0.145491803,-0.170974155,884,868,976,-16,108,92
f15120,f,"Other stimulant abuse with intoxication, uncomplicated",Mental and behavioural disorders,29,22,12,-0.24137931,-0.454545455,-0.586206897,4249,4606,5657,357,1051,1408
f15121,f,Other stimulant abuse with intoxication delirium,Mental and behavioural disorders,25,30,19,0.2,-0.366666667,-0.24,4531,4005,4891,-526,886,360
f15129,f,"Other stimulant abuse with intoxication, unspecified",Mental and behavioural disorders,228,212,247,-0.070175439,0.16509434,0.083333333,1436,1463,1347,27,-116,-89
f1514,f,Other stimulant abuse with stimulant-induced mood disorder,Mental and behavioural disorders,69,98,61,0.420289855,-0.37755102,-0.115942029,2822,2208,2901,-614,693,79
f15151,f,Other stimulant abuse with stimulant-induced psychotic disorder with hallucinations,Mental and behavioural disorders,23,24,17,0.043478261,-0.291666667,-0.260869565,4687,4434,5096,-253,662,409
f15159,f,"Other stimulant abuse with stimulant-induced psychotic disorder, unspecified",Mental and behavioural disorders,98,94,116,-0.040816327,0.234042553,0.183673469,2327,2277,2048,-50,-229,-279
f15188,f,Other stimulant abuse with other stimulant-induced disorder,Mental and behavioural disorders,45,46,48,0.022222222,0.043478261,0.066666667,3465,3286,3273,-179,-13,-192
f1519,f,Other stimulant abuse with unspecified stimulant-induced disorder,Mental and behavioural disorders,21,21,14,0,-0.333333333,-0.333333333,4857,4707,5419,-150,712,562
f1520,f,"Other stimulant dependence, uncomplicated",Mental and behavioural disorders,3650,3697,3853,0.012876712,0.042196375,0.055616438,182,179,181,-3,2,-1
f1521,f,"Other stimulant dependence, in remission",Mental and behavioural disorders,331,267,248,-0.193353474,-0.071161049,-0.250755287,1132,1259,1342,127,83,210
f15229,f,"Other stimulant dependence with intoxication, unspecified",Mental and behavioural disorders,43,74,32,0.720930233,-0.567567568,-0.255813953,3542,2577,3958,-965,1381,416
f1523,f,Other stimulant dependence with withdrawal,Mental and behavioural disorders,687,867,1079,0.262008734,0.244521338,0.570596798,708,558,491,-150,-67,-217
f1524,f,Other stimulant dependence with stimulant-induced mood disorder,Mental and behavioural disorders,40,42,70,0.05,0.666666667,0.75,3652,3419,2714,-233,-705,-938
f15251,f,Other stimulant dependence with stimulant-induced psychotic disorder with hallucinations,Mental and behavioural disorders,33,32,22,-0.03030303,-0.3125,-0.333333333,3985,3870,4629,-115,759,644
f15259,f,"Other stimulant dependence with stimulant-induced psychotic disorder, unspecified",Mental and behavioural disorders,238,206,162,-0.134453782,-0.213592233,-0.319327731,1398,1486,1691,88,205,293
f1529,f,Other stimulant dependence with unspecified stimulant-induced disorder,Mental and behavioural disorders,28,26,41,-0.071428571,0.576923077,0.464285714,4304,4279,3533,-25,-746,-771
f1590,f,"Other stimulant use, unspecified, uncomplicated",Mental and behavioural disorders,1765,1708,1632,-0.032294618,-0.044496487,-0.075354108,346,345,367,-1,22,21
f15929,f,"Other stimulant use, unspecified with intoxication, unspecified",Mental and behavioural disorders,27,24,19,-0.111111111,-0.208333333,-0.296296296,4383,4423,4878,40,455,495
f1593,f,"Other stimulant use, unspecified with withdrawal",Mental and behavioural disorders,61,88,80,0.442622951,-0.090909091,0.31147541,3001,2351,2516,-650,165,-485
f1594,f,"Other stimulant use, unspecified with stimulant-induced mood disorder",Mental and behavioural disorders,16,24,17,0.5,-0.291666667,0.0625,5334,4422,5083,-912,661,-251
f15959,f,"Other stimulant use, unspecified with stimulant-induced psychotic disorder, unspecified",Mental and behavioural disorders,54,54,40,0,-0.259259259,-0.259259259,3182,3036,3563,-146,527,381
f1599,f,"Other stimulant use, unspecified with unspecified stimulant-induced disorder",Mental and behavioural disorders,75,91,113,0.213333333,0.241758242,0.506666667,2682,2314,2073,-368,-241,-609
f1610,f,"Hallucinogen abuse, uncomplicated",Mental and behavioural disorders,124,171,262,0.379032258,0.532163743,1.112903226,2020,1633,1294,-387,-339,-726
f1620,f,"Hallucinogen dependence, uncomplicated",Mental and behavioural disorders,45,53,59,0.177777778,0.113207547,0.311111111,3456,3061,2946,-395,-115,-510
f1690,f,"Hallucinogen use, unspecified, uncomplicated",Mental and behavioural disorders,29,44,40,0.517241379,-0.090909091,0.379310345,4232,3351,3560,-881,209,-672
f17200,f,"Nicotine dependence, unspecified, uncomplicated",Mental and behavioural disorders,9362,8441,8393,-0.098376415,-0.00568653,-0.103503525,61,70,69,9,-1,8
f17201,f,"Nicotine dependence, unspecified, in remission",Mental and behavioural disorders,37,88,75,1.378378378,-0.147727273,1.027027027,3773,2348,2594,-1425,246,-1179
f17203,f,"Nicotine dependence unspecified, with withdrawal",Mental and behavioural disorders,69,62,46,-0.101449275,-0.258064516,-0.333333333,2813,2848,3334,35,486,521
f17210,f,"Nicotine dependence, cigarettes, uncomplicated",Mental and behavioural disorders,43868,42376,42028,-0.034011124,-0.008212196,-0.041944014,8,9,11,1,2,3
f17211,f,"Nicotine dependence, cigarettes, in remission",Mental and behavioural disorders,117,83,92,-0.290598291,0.108433735,-0.213675214,2094,2439,2323,345,-116,229
f17213,f,"Nicotine dependence, cigarettes, with withdrawal",Mental and behavioural disorders,391,391,287,0,-0.265984655,-0.265984655,1011,986,1223,-25,237,212
f17218,f,"Nicotine dependence, cigarettes, with other nicotine-induced disorders",Mental and behavioural disorders,18,35,14,0.944444444,-0.6,-0.222222222,5128,3696,5396,-1432,1700,268
f17220,f,"Nicotine dependence, chewing tobacco, uncomplicated",Mental and behavioural disorders,842,758,794,-0.09976247,0.047493404,-0.057007126,593,618,609,25,-9,16
f17290,f,"Nicotine dependence, other tobacco product, uncomplicated",Mental and behavioural disorders,2131,2037,2348,-0.044110746,0.152675503,0.101830127,290,289,266,-1,-23,-24
f1810,f,"Inhalant abuse, uncomplicated",Mental and behavioural disorders,29,30,36,0.034482759,0.2,0.24137931,4224,3978,3707,-246,-271,-517
f1910,f,"Other psychoactive substance abuse, uncomplicated",Mental and behavioural disorders,1461,1389,1549,-0.049281314,0.115190785,0.060232717,399,401,379,2,-22,-20
f1911,f,"Other psychoactive substance abuse, in remission",Mental and behavioural disorders,209,201,154,-0.038277512,-0.233830846,-0.263157895,1516,1499,1731,-17,232,215
f19129,f,"Other psychoactive substance abuse with intoxication, unspecified",Mental and behavioural disorders,31,31,30,0,-0.032258065,-0.032258065,4085,3907,4050,-178,143,-35
f1914,f,Other psychoactive substance abuse with psychoactive substance-induced mood disorder,Mental and behavioural disorders,35,27,49,-0.228571429,0.814814815,0.4,3860,4190,3221,330,-969,-639
f19159,f,"Other psychoactive substance abuse with psychoactive substance-induced psychotic disorder, unspecified",Mental and behavioural disorders,11,14,15,0.272727273,0.071428571,0.363636364,5808,5422,5278,-386,-144,-530
f1919,f,Other psychoactive substance abuse with unspecified psychoactive substance-induced disorder,Mental and behavioural disorders,28,20,32,-0.285714286,0.6,0.142857143,4284,4784,3935,500,-849,-349
f1920,f,"Other psychoactive substance dependence, uncomplicated",Mental and behavioural disorders,234,218,178,-0.068376068,-0.183486239,-0.239316239,1406,1430,1598,24,168,192
f1921,f,"Other psychoactive substance dependence, in remission",Mental and behavioural disorders,46,34,32,-0.260869565,-0.058823529,-0.304347826,3405,3727,3934,322,207,529
f19230,f,"Other psychoactive substance dependence with withdrawal, uncomplicated",Mental and behavioural disorders,11,10,10,-0.090909091,0,-0.090909091,5805,5849,5827,44,-22,22
f19239,f,"Other psychoactive substance dependence with withdrawal, unspecified",Mental and behavioural disorders,76,33,58,-0.565789474,0.757575758,-0.236842105,2652,3789,2956,1137,-833,304
f1924,f,Other psychoactive substance dependence with psychoactive substance-induced mood disorder,Mental and behavioural disorders,27,24,30,-0.111111111,0.25,0.111111111,4360,4400,4045,40,-355,-315
f1990,f,"Other psychoactive substance use, unspecified, uncomplicated",Mental and behavioural disorders,247,242,231,-0.020242915,-0.045454545,-0.064777328,1356,1328,1384,-28,56,28
f19921,f,"Other psychoactive substance use, unspecified with intoxication with delirium",Mental and behavioural disorders,12,13,16,0.083333333,0.230769231,0.333333333,5719,5521,5158,-198,-363,-561
f19939,f,"Other psychoactive substance use, unspecified with withdrawal, unspecified",Mental and behavioural disorders,30,28,16,-0.066666667,-0.428571429,-0.466666667,4147,4115,5158,-32,1043,1011
f1994,f,"Other psychoactive substance use, unspecified with psychoactive substance-induced mood disorder",Mental and behavioural disorders,116,134,191,0.155172414,0.425373134,0.646551724,2096,1863,1542,-233,-321,-554
f19959,f,"Other psychoactive substance use, unspecified with psychoactive substance-induced psychotic disorder, unspecified",Mental and behavioural disorders,41,47,41,0.146341463,-0.127659574,0,3593,3224,3513,-369,289,-80
f1999,f,"Other psychoactive substance use, unspecified with unspecified psychoactive substance-induced disorder",Mental and behavioural disorders,46,22,42,-0.52173913,0.909090909,-0.086956522,3402,4561,3471,1159,-1090,69
f200,f,Paranoid schizophrenia,Mental and behavioural disorders,553,613,580,0.108499096,-0.053833605,0.048824593,809,731,765,-78,34,-44
f201,f,Disorganized schizophrenia,Mental and behavioural disorders,19,28,13,0.473684211,-0.535714286,-0.315789474,5008,4112,5498,-896,1386,490
f202,f,Catatonic schizophrenia,Mental and behavioural disorders,64,64,66,0,0.03125,0.03125,2918,2791,2760,-127,-31,-158
f203,f,Undifferentiated schizophrenia,Mental and behavioural disorders,15,17,13,0.133333333,-0.235294118,-0.133333333,5418,5083,5497,-335,414,79
f2089,f,Other schizophrenia,Mental and behavioural disorders,35,15,19,-0.571428571,0.266666667,-0.457142857,3851,5282,4848,1431,-434,997
f209,f,"Schizophrenia, unspecified",Mental and behavioural disorders,2707,2729,2897,0.008127078,0.061561011,0.0701884,231,228,219,-3,-9,-12
f21,f,Schizotypal disorder,Mental and behavioural disorders,14,14,17,0,0.214285714,0.214285714,5513,5406,5052,-107,-354,-461
f22,f,Delusional disorders,Mental and behavioural disorders,619,551,598,-0.109854604,0.085299456,-0.033925687,743,782,743,39,-39,0
f23,f,Brief psychotic disorder,Mental and behavioural disorders,428,519,484,0.212616822,-0.06743738,0.130841121,957,816,874,-141,58,-83
f250,f,"Schizoaffective disorder, bipolar type",Mental and behavioural disorders,1936,2179,2341,0.125516529,0.07434603,0.209194215,314,271,265,-43,-6,-49
f251,f,"Schizoaffective disorder, depressive type",Mental and behavioural disorders,643,535,520,-0.167962675,-0.028037383,-0.191290824,723,794,828,71,34,105
f258,f,Other schizoaffective disorders,Mental and behavioural disorders,14,17,10,0.214285714,-0.411764706,-0.285714286,5509,5078,5808,-431,730,299
f259,f,"Schizoaffective disorder, unspecified",Mental and behavioural disorders,1950,1914,1928,-0.018461538,0.007314525,-0.011282051,311,305,312,-6,7,1
f28,f,Other psychotic disorder not due to a substance or known physiological condition,Mental and behavioural disorders,112,92,63,-0.178571429,-0.315217391,-0.4375,2136,2282,2823,146,541,687
f29,f,Unspecified psychosis not due to a substance or known physiological condition,Mental and behavioural disorders,3037,3259,3289,0.073098452,0.009205278,0.082976622,207,195,198,-12,3,-9
f302,f,"Manic episode, severe with psychotic symptoms",Mental and behavioural disorders,20,15,16,-0.25,0.066666667,-0.2,4910,5273,5143,363,-130,233
f309,f,"Manic episode, unspecified",Mental and behavioural disorders,50,31,37,-0.38,0.193548387,-0.26,3281,3891,3649,610,-242,368
f310,f,"Bipolar disorder, current episode hypomanic",Mental and behavioural disorders,24,29,27,0.208333333,-0.068965517,0.125,4547,4022,4203,-525,181,-344
f3110,f,"Bipolar disorder, current episode manic without psychotic features, unspecified",Mental and behavioural disorders,69,74,95,0.072463768,0.283783784,0.376811594,2793,2550,2268,-243,-282,-525
f3112,f,"Bipolar disorder, current episode manic without psychotic features, moderate",Mental and behavioural disorders,46,30,38,-0.347826087,0.266666667,-0.173913043,3390,3957,3615,567,-342,225
f3113,f,"Bipolar disorder, current episode manic without psychotic features, severe",Mental and behavioural disorders,70,67,84,-0.042857143,0.253731343,0.2,2771,2714,2426,-57,-288,-345
f312,f,"Bipolar disorder, current episode manic severe with psychotic features",Mental and behavioural disorders,324,387,489,0.194444444,0.263565891,0.509259259,1138,981,860,-157,-121,-278
f3130,f,"Bipolar disorder, current episode depressed, mild or moderate severity, unspecified",Mental and behavioural disorders,469,379,457,-0.191897655,0.205804749,-0.025586354,905,994,903,89,-91,-2
f3131,f,"Bipolar disorder, current episode depressed, mild",Mental and behavioural disorders,17,23,15,0.352941176,-0.347826087,-0.117647059,5183,4464,5247,-719,783,64
f3132,f,"Bipolar disorder, current episode depressed, moderate",Mental and behavioural disorders,115,94,78,-0.182608696,-0.170212766,-0.32173913,2096,2251,2530,155,279,434
f314,f,"Bipolar disorder, current episode depressed, severe, without psychotic features",Mental and behavioural disorders,688,652,622,-0.052325581,-0.04601227,-0.095930233,697,691,724,-6,33,27
f315,f,"Bipolar disorder, current episode depressed, severe, with psychotic features",Mental and behavioural disorders,554,498,456,-0.101083032,-0.084337349,-0.176895307,799,840,903,41,63,104
f3160,f,"Bipolar disorder, current episode mixed, unspecified",Mental and behavioural disorders,238,207,159,-0.130252101,-0.231884058,-0.331932773,1378,1460,1681,82,221,303
f3162,f,"Bipolar disorder, current episode mixed, moderate",Mental and behavioural disorders,68,141,56,1.073529412,-0.602836879,-0.176470588,2802,1799,2986,-1003,1187,184
f3163,f,"Bipolar disorder, current episode mixed, severe, without psychotic features",Mental and behavioural disorders,168,151,289,-0.101190476,0.913907285,0.720238095,1683,1730,1201,47,-529,-482
f3164,f,"Bipolar disorder, current episode mixed, severe, with psychotic features",Mental and behavioural disorders,261,247,287,-0.053639847,0.16194332,0.099616858,1296,1301,1207,5,-94,-89
f3170,f,"Bipolar disorder, currently in remission, most recent episode unspecified",Mental and behavioural disorders,24,18,28,-0.25,0.555555556,0.166666667,4535,4944,4133,409,-811,-402
f3181,f,Bipolar II disorder,Mental and behavioural disorders,523,548,588,0.047801147,0.072992701,0.124282983,845,779,750,-66,-29,-95
f3189,f,Other bipolar disorder,Mental and behavioural disorders,289,251,280,-0.131487889,0.115537849,-0.031141869,1230,1284,1224,54,-60,-6
f319,f,"Bipolar disorder, unspecified",Mental and behavioural disorders,8021,7763,8055,-0.032165565,0.037614324,0.004238873,72,74,71,2,-3,-1
f320,f,"Major depressive disorder, single episode, mild",Mental and behavioural disorders,75,96,92,0.28,-0.041666667,0.226666667,2649,2210,2296,-439,86,-353
f321,f,"Major depressive disorder, single episode, moderate",Mental and behavioural disorders,268,277,249,0.03358209,-0.101083032,-0.070895522,1279,1213,1313,-66,100,34
f322,f,"Major depressive disorder, single episode, severe without psychotic features",Mental and behavioural disorders,1727,1646,1569,-0.046902142,-0.046780073,-0.09148813,345,347,369,2,22,24
f323,f,"Major depressive disorder, single episode, severe with psychotic features",Mental and behavioural disorders,547,497,486,-0.091407678,-0.022132797,-0.111517367,810,840,862,30,22,52
f324,f,"Major depressive disorder, single episode, in partial remission",Mental and behavioural disorders,17,26,15,0.529411765,-0.423076923,-0.117647059,5168,4219,5232,-949,1013,64
f325,f,"Major depressive disorder, single episode, in full remission",Mental and behavioural disorders,54,58,47,0.074074074,-0.189655172,-0.12962963,3139,2900,3258,-239,358,119
f3281,f,Premenstrual dysphoric disorder,Mental and behavioural disorders,14,20,21,0.428571429,0.05,0.5,5480,4740,4643,-740,-97,-837
f3289,f,Other specified depressive episodes,Mental and behavioural disorders,716,704,550,-0.016759777,-0.21875,-0.231843575,667,654,791,-13,137,124
f329,f,"Major depressive disorder, single episode, unspecified",Mental and behavioural disorders,36813,33103,35147,-0.100779616,0.061746669,-0.045255752,11,12,13,1,1,2
f330,f,"Major depressive disorder, recurrent, mild",Mental and behavioural disorders,193,203,209,0.051813472,0.02955665,0.082901554,1555,1468,1440,-87,-28,-115
f331,f,"Major depressive disorder, recurrent, moderate",Mental and behavioural disorders,1291,1243,1118,-0.03718048,-0.100563154,-0.134004648,426,424,465,-2,41,39
f332,f,"Major depressive disorder, recurrent severe without psychotic features",Mental and behavioural disorders,6260,6225,6930,-0.005591054,0.113253012,0.107028754,99,98,87,-1,-11,-12
f333,f,"Major depressive disorder, recurrent, severe with psychotic symptoms",Mental and behavioural disorders,1935,1912,2068,-0.011886305,0.081589958,0.06873385,309,302,295,-7,-7,-14
f3340,f,"Major depressive disorder, recurrent, in remission, unspecified",Mental and behavioural disorders,51,43,29,-0.156862745,-0.325581395,-0.431372549,3221,3324,4047,103,723,826
f3341,f,"Major depressive disorder, recurrent, in partial remission",Mental and behavioural disorders,129,97,82,-0.248062016,-0.154639175,-0.364341085,1929,2184,2438,255,254,509
f3342,f,"Major depressive disorder, recurrent, in full remission",Mental and behavioural disorders,27,46,28,0.703703704,-0.391304348,0.037037037,4315,3225,4117,-1090,892,-198
f338,f,Other recurrent depressive disorders,Mental and behavioural disorders,45,56,64,0.244444444,0.142857143,0.422222222,3402,2940,2773,-462,-167,-629
f339,f,"Major depressive disorder, recurrent, unspecified",Mental and behavioural disorders,2152,1849,1710,-0.140799257,-0.075175771,-0.205390335,278,315,336,37,21,58
f340,f,Cyclothymic disorder,Mental and behavioural disorders,10,10,10,0,0,0,5819,5788,5767,-31,-21,-52
f341,f,Dysthymic disorder,Mental and behavioural disorders,230,182,166,-0.208695652,-0.087912088,-0.27826087,1388,1556,1629,168,73,241
f3481,f,Disruptive mood dysregulation disorder,Mental and behavioural disorders,699,878,965,0.256080114,0.099088838,0.380543634,674,534,514,-140,-20,-160
f3489,f,Other specified persistent mood disorders,Mental and behavioural disorders,31,34,15,0.096774194,-0.558823529,-0.516129032,4033,3682,5217,-351,1535,1184
f349,f,"Persistent mood [affective] disorder, unspecified",Mental and behavioural disorders,32,20,16,-0.375,-0.2,-0.5,3979,4726,5106,747,380,1127
f39,f,Unspecified mood [affective] disorder,Mental and behavioural disorders,2601,2524,2506,-0.029603998,-0.007131537,-0.036524414,235,238,236,3,-2,1
f4000,f,"Agoraphobia, unspecified",Mental and behavioural disorders,56,57,59,0.017857143,0.035087719,0.053571429,3070,2912,2895,-158,-17,-175
f4001,f,Agoraphobia with panic disorder,Mental and behavioural disorders,73,65,62,-0.109589041,-0.046153846,-0.150684932,2685,2731,2815,46,84,130
f4010,f,"Social phobia, unspecified",Mental and behavioural disorders,191,164,177,-0.141361257,0.079268293,-0.073298429,1554,1634,1569,80,-65,15
f40240,f,Claustrophobia,Mental and behavioural disorders,706,571,647,-0.19121813,0.133099825,-0.083569405,668,747,688,79,-59,20
f410,f,Panic disorder [episodic paroxysmal anxiety],Mental and behavioural disorders,2366,1949,2369,-0.17624683,0.215495126,0.001267963,261,292,252,31,-40,-9
f411,f,Generalized anxiety disorder,Mental and behavioural disorders,4852,4454,5073,-0.08202803,0.138976201,0.045548228,141,147,135,6,-12,-6
f413,f,Other mixed anxiety disorders,Mental and behavioural disorders,34,19,10,-0.441176471,-0.473684211,-0.705882353,3855,4812,5756,957,944,1901
f418,f,Other specified anxiety disorders,Mental and behavioural disorders,3563,3167,3499,-0.111142296,0.10483107,-0.017962391,176,194,188,18,-6,12
f419,f,"Anxiety disorder, unspecified",Mental and behavioural disorders,37170,34708,37785,-0.066236212,0.088653913,0.016545601,10,10,11,0,1,1
f424,f,Excoriation (skin-picking) disorder,Mental and behavioural disorders,28,29,37,0.035714286,0.275862069,0.321428571,4220,3979,3609,-241,-370,-611
f428,f,Other obsessive-compulsive disorder,Mental and behavioural disorders,42,14,13,-0.666666667,-0.071428571,-0.69047619,3501,5345,5435,1844,90,1934
f429,f,"Obsessive-compulsive disorder, unspecified",Mental and behavioural disorders,725,741,708,0.022068966,-0.044534413,-0.023448276,647,612,653,-35,41,6
f430,f,Acute stress reaction,Mental and behavioural disorders,123,114,150,-0.073170732,0.315789474,0.219512195,1982,1989,1718,7,-271,-264
f4310,f,"Post-traumatic stress disorder, unspecified",Mental and behavioural disorders,7555,6553,7385,-0.132627399,0.126964749,-0.022501655,77,88,78,11,-10,1
f4311,f,"Post-traumatic stress disorder, acute",Mental and behavioural disorders,108,74,92,-0.314814815,0.243243243,-0.148148148,2137,2514,2274,377,-240,137
f4312,f,"Post-traumatic stress disorder, chronic",Mental and behavioural disorders,1339,1386,1354,0.035100822,-0.023088023,0.01120239,407,385,396,-22,11,-11
f4320,f,"Adjustment disorder, unspecified",Mental and behavioural disorders,468,479,464,0.023504274,-0.03131524,-0.008547009,885,841,874,-44,33,-11
f4321,f,Adjustment disorder with depressed mood,Mental and behavioural disorders,674,715,758,0.060830861,0.06013986,0.12462908,682,626,615,-56,-11,-67
f4322,f,Adjustment disorder with anxiety,Mental and behavioural disorders,367,332,381,-0.095367847,0.147590361,0.038147139,1015,1065,990,50,-75,-25
f4323,f,Adjustment disorder with mixed anxiety and depressed mood,Mental and behavioural disorders,583,648,633,0.111492281,-0.023148148,0.085763293,745,675,699,-70,24,-46
f4324,f,Adjustment disorder with disturbance of conduct,Mental and behavioural disorders,28,21,48,-0.25,1.285714286,0.714285714,4210,4599,3192,389,-1407,-1018
f4325,f,Adjustment disorder with mixed disturbance of emotions and conduct,Mental and behavioural disorders,223,239,217,0.071748879,-0.092050209,-0.02690583,1402,1298,1386,-104,88,-16
f4329,f,Adjustment disorder with other symptoms,Mental and behavioural disorders,45,46,50,0.022222222,0.086956522,0.111111111,3380,3202,3125,-178,-77,-255
f438,f,Other reactions to severe stress,Mental and behavioural disorders,22,22,42,0,0.909090909,0.909090909,4659,4491,3410,-168,-1081,-1249
f439,f,"Reaction to severe stress, unspecified",Mental and behavioural disorders,162,111,117,-0.314814815,0.054054054,-0.277777778,1681,2002,1975,321,-27,294
f444,f,Conversion disorder with motor symptom or deficit,Mental and behavioural disorders,66,68,54,0.03030303,-0.205882353,-0.181818182,2820,2641,3007,-179,366,187
f445,f,Conversion disorder with seizures or convulsions,Mental and behavioural disorders,201,142,175,-0.293532338,0.232394366,-0.129353234,1501,1757,1563,256,-194,62
f4481,f,Dissociative identity disorder,Mental and behavioural disorders,73,71,72,-0.02739726,0.014084507,-0.01369863,2667,2574,2591,-93,17,-76
f4489,f,Other dissociative and conversion disorders,Mental and behavioural disorders,23,19,23,-0.173913043,0.210526316,0,4569,4792,4440,223,-352,-129
f449,f,"Dissociative and conversion disorder, unspecified",Mental and behavioural disorders,61,55,60,-0.098360656,0.090909091,-0.016393443,2926,2936,2848,10,-88,-78
f450,f,Somatization disorder,Mental and behavioural disorders,20,10,12,-0.5,0.2,-0.4,4841,5753,5521,912,-232,680
f4522,f,Body dysmorphic disorder,Mental and behavioural disorders,12,15,14,0.25,-0.066666667,0.166666667,5626,5202,5294,-424,92,-332
f4542,f,Pain disorder with related psychological factors,Mental and behavioural disorders,29,157,80,4.413793103,-0.49044586,1.75862069,4139,1664,2450,-2475,786,-1689
f458,f,Other somatoform disorders,Mental and behavioural disorders,83,52,47,-0.373493976,-0.096153846,-0.43373494,2474,3010,3220,536,210,746
f459,f,"Somatoform disorder, unspecified",Mental and behavioural disorders,53,40,50,-0.245283019,0.25,-0.056603774,3125,3412,3119,287,-293,-6
f482,f,Pseudobulbar affect,Mental and behavioural disorders,38,31,24,-0.184210526,-0.225806452,-0.368421053,3647,3830,4366,183,536,719
f5000,f,"Anorexia nervosa, unspecified",Mental and behavioural disorders,96,81,87,-0.15625,0.074074074,-0.09375,2286,2397,2337,111,-60,51
f5001,f,"Anorexia nervosa, restricting type",Mental and behavioural disorders,17,21,28,0.235294118,0.333333333,0.647058824,5115,4586,4081,-529,-505,-1034
f5002,f,"Anorexia nervosa, binge eating/purging type",Mental and behavioural disorders,16,15,13,-0.0625,-0.133333333,-0.1875,5214,5196,5409,-18,213,195
f502,f,Bulimia nervosa,Mental and behavioural disorders,104,98,137,-0.057692308,0.397959184,0.317307692,2178,2142,1806,-36,-336,-372
f5081,f,Binge eating disorder,Mental and behavioural disorders,20,25,23,0.25,-0.08,0.15,4835,4239,4432,-596,193,-403
f5089,f,Other specified eating disorder,Mental and behavioural disorders,56,49,71,-0.125,0.448979592,0.267857143,3045,3087,2618,42,-469,-427
f509,f,"Eating disorder, unspecified",Mental and behavioural disorders,224,234,270,0.044642857,0.153846154,0.205357143,1401,1312,1225,-89,-87,-176
f5101,f,Primary insomnia,Mental and behavioural disorders,75,90,74,0.2,-0.177777778,-0.013333333,2613,2254,2544,-359,290,-69
f5104,f,Psychophysiologic insomnia,Mental and behavioural disorders,330,309,324,-0.063636364,0.048543689,-0.018181818,1093,1112,1092,19,-20,-1
f5105,f,Insomnia due to other mental disorder,Mental and behavioural disorders,62,80,109,0.290322581,0.3625,0.758064516,2898,2410,2047,-488,-363,-851
f513,f,Sleepwalking [somnambulism],Mental and behavioural disorders,30,15,18,-0.5,0.2,-0.4,4061,5189,4858,1128,-331,797
f514,f,Sleep terrors [night terrors],Mental and behavioural disorders,64,51,56,-0.203125,0.098039216,-0.125,2854,3028,2935,174,-93,81
f515,f,Nightmare disorder,Mental and behavioural disorders,334,249,254,-0.254491018,0.020080321,-0.239520958,1081,1266,1274,185,8,193
f530,f,Postpartum depression,Mental and behavioural disorders,100,88,74,-0.12,-0.159090909,-0.26,2222,2280,2541,58,261,319
f600,f,Paranoid personality disorder,Mental and behavioural disorders,52,50,46,-0.038461538,-0.08,-0.115384615,3147,3048,3243,-99,195,96
f602,f,Antisocial personality disorder,Mental and behavioural disorders,338,324,294,-0.041420118,-0.092592593,-0.130177515,1072,1082,1162,10,80,90
f603,f,Borderline personality disorder,Mental and behavioural disorders,1952,1793,1738,-0.081454918,-0.030674847,-0.109631148,299,314,325,15,11,26
f605,f,Obsessive-compulsive personality disorder,Mental and behavioural disorders,22,24,20,0.090909091,-0.166666667,-0.090909091,4635,4304,4658,-331,354,23
f607,f,Dependent personality disorder,Mental and behavioural disorders,39,26,26,-0.333333333,0,-0.333333333,3596,4161,4190,565,29,594
f6081,f,Narcissistic personality disorder,Mental and behavioural disorders,29,27,39,-0.068965517,0.444444444,0.344827586,4121,4093,3502,-28,-591,-619
f6089,f,Other specific personality disorders,Mental and behavioural disorders,104,144,171,0.384615385,0.1875,0.644230769,2173,1735,1583,-438,-152,-590
f609,f,"Personality disorder, unspecified",Mental and behavioural disorders,630,553,503,-0.122222222,-0.090415913,-0.201587302,707,753,821,46,68,114
f633,f,Trichotillomania,Mental and behavioural disorders,11,24,27,1.181818182,0.125,1.454545455,5681,4300,4121,-1381,-179,-1560
f6381,f,Intermittent explosive disorder,Mental and behavioural disorders,95,121,108,0.273684211,-0.107438017,0.136842105,2291,1911,2050,-380,139,-241
f639,f,"Impulse disorder, unspecified",Mental and behavioural disorders,37,33,54,-0.108108108,0.636363636,0.459459459,3669,3699,2988,30,-711,-681
f640,f,Transsexualism,Mental and behavioural disorders,113,102,83,-0.097345133,-0.18627451,-0.265486726,2073,2072,2386,-1,314,313
f642,f,Gender identity disorder of childhood,Mental and behavioural disorders,40,31,39,-0.225,0.258064516,-0.025,3541,3812,3497,271,-315,-44
f648,f,Other gender identity disorders,Mental and behavioural disorders,21,22,12,0.047619048,-0.454545455,-0.428571429,4711,4458,5489,-253,1031,778
f649,f,"Gender identity disorder, unspecified",Mental and behavioural disorders,285,231,261,-0.189473684,0.12987013,-0.084210526,1207,1333,1248,126,-85,41
f6810,f,"Factitious disorder imposed on self, unspecified",Mental and behavioural disorders,28,17,19,-0.392857143,0.117647059,-0.321428571,4176,4973,4744,797,-229,568
f688,f,Other specified disorders of adult personality and behavior,Mental and behavioural disorders,14,10,10,-0.285714286,0,-0.285714286,5400,5718,5697,318,-21,297
f70,f,Mild intellectual disabilities,Mental and behavioural disorders,178,173,153,-0.028089888,-0.115606936,-0.140449438,1593,1564,1680,-29,116,87
f71,f,Moderate intellectual disabilities,Mental and behavioural disorders,70,73,62,0.042857143,-0.150684932,-0.114285714,2709,2518,2778,-191,260,69
f72,f,Severe intellectual disabilities,Mental and behavioural disorders,125,101,121,-0.192,0.198019802,-0.032,1943,2084,1922,141,-162,-21
f73,f,Profound intellectual disabilities,Mental and behavioural disorders,57,68,42,0.192982456,-0.382352941,-0.263157895,3007,2620,3380,-387,760,373
f78,f,Other intellectual disabilities,Mental and behavioural disorders,11,26,10,1.363636364,-0.615384615,-0.090909091,5669,4149,5693,-1520,1544,24
f79,f,Unspecified intellectual disabilities,Mental and behavioural disorders,523,494,559,-0.055449331,0.131578947,0.068833652,822,820,759,-2,-61,-63
f801,f,Expressive language disorder,Mental and behavioural disorders,30,29,37,-0.033333333,0.275862069,0.233333333,4042,3934,3562,-108,-372,-480
f802,f,Mixed receptive-expressive language disorder,Mental and behavioural disorders,35,33,25,-0.057142857,-0.242424242,-0.285714286,3755,3692,4248,-63,556,493
f8081,f,Childhood onset fluency disorder,Mental and behavioural disorders,35,34,39,-0.028571429,0.147058824,0.114285714,3755,3631,3491,-124,-140,-264
f8089,f,Other developmental disorders of speech and language,Mental and behavioural disorders,15,14,10,-0.066666667,-0.285714286,-0.333333333,5295,5282,5689,-13,407,394
f809,f,"Developmental disorder of speech and language, unspecified",Mental and behavioural disorders,142,117,106,-0.176056338,-0.094017094,-0.253521127,1802,1941,2068,139,127,266
f810,f,Specific reading disorder,Mental and behavioural disorders,15,14,13,-0.066666667,-0.071428571,-0.133333333,5294,5281,5374,-13,93,80
f819,f,"Developmental disorder of scholastic skills, unspecified",Mental and behavioural disorders,147,122,151,-0.170068027,0.237704918,0.027210884,1771,1901,1696,130,-205,-75
f82,f,Specific developmental disorder of motor function,Mental and behavioural disorders,48,39,47,-0.1875,0.205128205,-0.020833333,3259,3423,3195,164,-228,-64
f840,f,Autistic disorder,Mental and behavioural disorders,1118,993,1061,-0.111806798,0.068479355,-0.0509839,458,493,475,35,-18,17
f842,f,Rett's syndrome,Mental and behavioural disorders,22,19,13,-0.136363636,-0.315789474,-0.409090909,4613,4747,5371,134,624,758
f845,f,Asperger's syndrome,Mental and behavioural disorders,144,112,147,-0.222222222,0.3125,0.020833333,1789,1981,1714,192,-267,-75
f849,f,"Pervasive developmental disorder, unspecified",Mental and behavioural disorders,15,14,21,-0.066666667,0.5,0.4,5289,5276,4559,-13,-717,-730
f88,f,Other disorders of psychological development,Mental and behavioural disorders,628,628,515,0,-0.179936306,-0.179936306,708,689,805,-19,116,97
f89,f,Unspecified disorder of psychological development,Mental and behavioural disorders,29,24,42,-0.172413793,0.75,0.448275862,4100,4280,3373,180,-907,-727
f900,f,"Attention-deficit hyperactivity disorder, predominantly inattentive type",Mental and behavioural disorders,158,147,187,-0.069620253,0.272108844,0.183544304,1691,1708,1510,17,-198,-181
f901,f,"Attention-deficit hyperactivity disorder, predominantly hyperactive type",Mental and behavioural disorders,96,64,65,-0.333333333,0.015625,-0.322916667,2266,2706,2707,440,1,441
f902,f,"Attention-deficit hyperactivity disorder, combined type",Mental and behavioural disorders,453,424,396,-0.06401766,-0.066037736,-0.125827815,900,906,956,6,50,56
f908,f,"Attention-deficit hyperactivity disorder, other type",Mental and behavioural disorders,20,26,38,0.3,0.461538462,0.9,4792,4136,3519,-656,-617,-1273
f909,f,"Attention-deficit hyperactivity disorder, unspecified type",Mental and behavioural disorders,3262,2901,3112,-0.110668302,0.07273354,-0.045984059,190,207,201,17,-6,11
f911,f,"Conduct disorder, childhood-onset type",Mental and behavioural disorders,30,31,13,0.033333333,-0.580645161,-0.566666667,4030,3794,5362,-236,1568,1332
f913,f,Oppositional defiant disorder,Mental and behavioural disorders,305,307,363,0.006557377,0.182410423,0.190163934,1158,1112,1014,-46,-98,-144
f918,f,Other conduct disorders,Mental and behavioural disorders,115,65,94,-0.434782609,0.446153846,-0.182608696,2038,2681,2217,643,-464,179
f919,f,"Conduct disorder, unspecified",Mental and behavioural disorders,174,161,189,-0.074712644,0.173913043,0.086206897,1605,1624,1499,19,-125,-106
f940,f,Selective mutism,Mental and behavioural disorders,37,28,26,-0.243243243,-0.071428571,-0.297297297,3648,3995,4159,347,164,511
f941,f,Reactive attachment disorder of childhood,Mental and behavioural disorders,28,46,44,0.642857143,-0.043478261,0.571428571,4152,3160,3289,-992,129,-863
f952,f,Tourette's disorder,Mental and behavioural disorders,91,95,115,0.043956044,0.210526316,0.263736264,2325,2170,1971,-155,-199,-354
f959,f,"Tic disorder, unspecified",Mental and behavioural disorders,22,21,22,-0.045454545,0.047619048,0,4599,4533,4468,-66,-65,-131
f984,f,Stereotyped movement disorders,Mental and behavioural disorders,48,32,34,-0.333333333,0.0625,-0.291666667,3248,3733,3699,485,-34,451
f988,f,Other specified behavioral and emotional disorders with onset usually occurring in childhood and adolescence,Mental and behavioural disorders,358,327,296,-0.086592179,-0.094801223,-0.173184358,1025,1065,1149,40,84,124
f99,f,"Mental disorder, not otherwise specified",Mental and behavioural disorders,120,137,111,0.141666667,-0.189781022,-0.075,1980,1775,2005,-205,230,25
g009,g,"Bacterial meningitis, unspecified",Diseases of the nervous system,57,74,70,0.298245614,-0.054054054,0.228070175,2991,2474,2608,-517,134,-383
g030,g,Nonpyogenic meningitis,Diseases of the nervous system,103,76,77,-0.262135922,0.013157895,-0.252427184,2163,2444,2468,281,24,305
g031,g,Chronic meningitis,Diseases of the nervous system,16,12,11,-0.25,-0.083333333,-0.3125,5154,5475,5566,321,91,412
g038,g,Meningitis due to other specified causes,Diseases of the nervous system,24,30,24,0.25,-0.2,0,4424,3848,4311,-576,463,-113
g039,g,"Meningitis, unspecified",Diseases of the nervous system,184,155,146,-0.157608696,-0.058064516,-0.206521739,1552,1659,1714,107,55,162
g0481,g,Other encephalitis and encephalomyelitis,Diseases of the nervous system,75,60,48,-0.2,-0.2,-0.36,2583,2780,3143,197,363,560
g0489,g,Other myelitis,Diseases of the nervous system,16,13,10,-0.1875,-0.230769231,-0.375,5151,5353,5657,202,304,506
g0490,g,"Encephalitis and encephalomyelitis, unspecified",Diseases of the nervous system,135,111,118,-0.177777778,0.063063063,-0.125925926,1843,1976,1944,133,-32,101
g0491,g,"Myelitis, unspecified",Diseases of the nervous system,18,21,15,0.166666667,-0.285714286,-0.166666667,4959,4524,5118,-435,594,159
g060,g,Intracranial abscess and granuloma,Diseases of the nervous system,105,116,104,0.104761905,-0.103448276,-0.00952381,2143,1938,2076,-205,138,-67
g061,g,Intraspinal abscess and granuloma,Diseases of the nervous system,341,343,273,0.005865103,-0.204081633,-0.19941349,1059,1031,1209,-28,178,150
g062,g,"Extradural and subdural abscess, unspecified",Diseases of the nervous system,81,74,77,-0.086419753,0.040540541,-0.049382716,2479,2469,2464,-10,-5,-15
g08,g,Intracranial and intraspinal phlebitis and thrombophlebitis,Diseases of the nervous system,57,86,81,0.50877193,-0.058139535,0.421052632,2984,2288,2396,-696,108,-588
g09,g,Sequelae of inflammatory diseases of central nervous system,Diseases of the nervous system,18,16,13,-0.111111111,-0.1875,-0.277777778,4955,5031,5341,76,310,386
g10,g,Huntington's disease,Diseases of the nervous system,44,56,29,0.272727273,-0.482142857,-0.340909091,3365,2869,3954,-496,1085,589
g114,g,Hereditary spastic paraplegia,Diseases of the nervous system,22,21,23,-0.045454545,0.095238095,0.045454545,4585,4519,4371,-66,-148,-214
g119,g,"Hereditary ataxia, unspecified",Diseases of the nervous system,45,39,36,-0.133333333,-0.076923077,-0.2,3324,3399,3569,75,170,245
g1221,g,Amyotrophic lateral sclerosis,Diseases of the nervous system,147,128,104,-0.129251701,-0.1875,-0.292517007,1761,1834,2075,73,241,314
g129,g,"Spinal muscular atrophy, unspecified",Diseases of the nervous system,13,30,20,1.307692308,-0.333333333,0.538461538,5451,3838,4603,-1613,765,-848
g131,g,Other systemic atrophy primarily affecting central nervous system in neoplastic disease,Diseases of the nervous system,16,15,10,-0.0625,-0.333333333,-0.375,5140,5120,5645,-20,525,505
g14,g,Postpolio syndrome,Diseases of the nervous system,148,117,141,-0.209459459,0.205128205,-0.047297297,1756,1928,1742,172,-186,-14
g20,g,Parkinson's disease,Diseases of the nervous system,3532,3388,3352,-0.040770102,-0.010625738,-0.050962627,177,179,189,2,10,12
g210,g,Malignant neuroleptic syndrome,Diseases of the nervous system,20,14,14,-0.3,0,-0.3,4764,5238,5213,474,-25,449
g2119,g,Other drug induced secondary parkinsonism,Diseases of the nervous system,32,21,37,-0.34375,0.761904762,0.15625,3889,4514,3530,625,-984,-359
g231,g,Progressive supranuclear ophthalmoplegia [Steele-Richardson-Olszewski],Diseases of the nervous system,45,32,30,-0.288888889,-0.0625,-0.333333333,3321,3717,3906,396,189,585
g2401,g,Drug induced subacute dyskinesia,Diseases of the nervous system,199,195,206,-0.020100503,0.056410256,0.035175879,1494,1469,1417,-25,-52,-77
g243,g,Spasmodic torticollis,Diseases of the nervous system,29,24,31,-0.172413793,0.291666667,0.068965517,4070,4247,3852,177,-395,-218
g248,g,Other dystonia,Diseases of the nervous system,20,22,18,0.1,-0.181818182,-0.1,4760,4407,4788,-353,381,28
g249,g,"Dystonia, unspecified",Diseases of the nervous system,388,269,252,-0.306701031,-0.063197026,-0.350515464,970,1198,1266,228,68,296
g250,g,Essential tremor,Diseases of the nervous system,1155,1100,1146,-0.047619048,0.041818182,-0.007792208,445,443,439,-2,-4,-6
g251,g,Drug-induced tremor,Diseases of the nervous system,51,47,40,-0.078431373,-0.14893617,-0.215686275,3138,3104,3416,-34,312,278
g252,g,Other specified forms of tremor,Diseases of the nervous system,206,175,173,-0.150485437,-0.011428571,-0.160194175,1467,1545,1558,78,13,91
g253,g,Myoclonus,Diseases of the nervous system,335,332,360,-0.008955224,0.084337349,0.074626866,1065,1054,1021,-11,-33,-44
g255,g,Other chorea,Diseases of the nervous system,34,26,36,-0.235294118,0.384615385,0.058823529,3766,4102,3559,336,-543,-207
g2571,g,Drug induced akathisia,Diseases of the nervous system,65,56,54,-0.138461538,-0.035714286,-0.169230769,2787,2861,2951,74,90,164
g2579,g,Other drug induced movement disorders,Diseases of the nervous system,13,13,18,0,0.384615385,0.384615385,5435,5325,4781,-110,-544,-654
g2581,g,Restless legs syndrome,Diseases of the nervous system,4337,4018,4113,-0.073553147,0.023643604,-0.051648605,149,159,164,10,5,15
g2582,g,Stiff-man syndrome,Diseases of the nervous system,21,16,15,-0.238095238,-0.0625,-0.285714286,4650,5011,5093,361,82,443
g2589,g,Other specified extrapyramidal and movement disorders,Diseases of the nervous system,24,23,18,-0.041666667,-0.217391304,-0.25,4400,4321,4780,-79,459,380
g259,g,"Extrapyramidal and movement disorder, unspecified",Diseases of the nervous system,330,302,240,-0.084848485,-0.205298013,-0.272727273,1077,1116,1295,39,179,218
g300,g,Alzheimer's disease with early onset,Diseases of the nervous system,82,65,68,-0.207317073,0.046153846,-0.170731707,2445,2659,2612,214,-47,167
g301,g,Alzheimer's disease with late onset,Diseases of the nervous system,225,238,224,0.057777778,-0.058823529,-0.004444444,1378,1282,1345,-96,63,-33
g308,g,Other Alzheimer's disease,Diseases of the nervous system,20,20,21,0,0.05,0.05,4747,4600,4511,-147,-89,-236
g309,g,"Alzheimer's disease, unspecified",Diseases of the nervous system,2663,2524,2431,-0.052196771,-0.036846276,-0.08711979,225,231,236,6,5,11
g3109,g,Other frontotemporal dementia,Diseases of the nervous system,62,66,57,0.064516129,-0.136363636,-0.080645161,2848,2639,2861,-209,222,13
g312,g,Degeneration of nervous system due to alcohol,Diseases of the nervous system,171,195,198,0.140350877,0.015384615,0.157894737,1611,1462,1448,-149,-14,-163
g3183,g,Dementia with Lewy bodies,Diseases of the nervous system,198,197,222,-0.005050505,0.126903553,0.121212121,1488,1450,1349,-38,-101,-139
g3184,g,"Mild cognitive impairment, so stated",Diseases of the nervous system,788,810,772,0.027918782,-0.04691358,-0.020304569,603,565,598,-38,33,-5
g3189,g,Other specified degenerative diseases of nervous system,Diseases of the nervous system,40,38,48,-0.05,0.263157895,0.2,3487,3417,3120,-70,-297,-367
g319,g,"Degenerative disease of nervous system, unspecified",Diseases of the nervous system,206,203,197,-0.014563107,-0.02955665,-0.04368932,1461,1425,1451,-36,26,-10
g35,g,Multiple sclerosis,Diseases of the nervous system,1466,1353,1321,-0.077080491,-0.023651146,-0.098908595,377,393,397,16,4,20
g360,g,Neuromyelitis optica [Devic],Diseases of the nervous system,31,33,40,0.064516129,0.212121212,0.290322581,3920,3641,3401,-279,-240,-519
g372,g,Central pontine myelinolysis,Diseases of the nervous system,11,26,15,1.363636364,-0.423076923,0.363636364,5586,4088,5079,-1498,991,-507
g373,g,Acute transverse myelitis in demyelinating disease of central nervous system,Diseases of the nervous system,70,82,90,0.171428571,0.097560976,0.285714286,2667,2339,2253,-328,-86,-414
g379,g,"Demyelinating disease of central nervous system, unspecified",Diseases of the nervous system,38,42,44,0.105263158,0.047619048,0.157894737,3570,3257,3255,-313,-2,-315
g40009,g,"Localization-related (focal) (partial) idiopathic epilepsy and epileptic syndromes with seizures of localized onset, not intractable, without status epilepticus",Diseases of the nervous system,78,80,68,0.025641026,-0.15,-0.128205128,2508,2362,2604,-146,242,96
g40019,g,"Localization-related (focal) (partial) idiopathic epilepsy and epileptic syndromes with seizures of localized onset, intractable, without status epilepticus",Diseases of the nervous system,35,21,39,-0.4,0.857142857,0.114285714,3700,4485,3438,785,-1047,-262
g40101,g,"Localization-related (focal) (partial) symptomatic epilepsy and epileptic syndromes with simple partial seizures, not intractable, with status epilepticus",Diseases of the nervous system,57,41,60,-0.280701754,0.463414634,0.052631579,2962,3297,2784,335,-513,-178
g40109,g,"Localization-related (focal) (partial) symptomatic epilepsy and epileptic syndromes with simple partial seizures, not intractable, without status epilepticus",Diseases of the nervous system,242,163,194,-0.326446281,0.190184049,-0.198347107,1312,1598,1457,286,-141,145
g40111,g,"Localization-related (focal) (partial) symptomatic epilepsy and epileptic syndromes with simple partial seizures, intractable, with status epilepticus",Diseases of the nervous system,19,21,21,0.105263158,0,0.105263158,4813,4483,4496,-330,13,-317
g40119,g,"Localization-related (focal) (partial) symptomatic epilepsy and epileptic syndromes with simple partial seizures, intractable, without status epilepticus",Diseases of the nervous system,84,68,62,-0.19047619,-0.088235294,-0.261904762,2402,2578,2732,176,154,330
g40201,g,"Localization-related (focal) (partial) symptomatic epilepsy and epileptic syndromes with complex partial seizures, not intractable, with status epilepticus",Diseases of the nervous system,18,24,18,0.333333333,-0.25,0,4912,4220,4759,-692,539,-153
g40209,g,"Localization-related (focal) (partial) symptomatic epilepsy and epileptic syndromes with complex partial seizures, not intractable, without status epilepticus",Diseases of the nervous system,239,191,190,-0.20083682,-0.005235602,-0.205020921,1324,1477,1476,153,-1,152
g40211,g,"Localization-related (focal) (partial) symptomatic epilepsy and epileptic syndromes with complex partial seizures, intractable, with status epilepticus",Diseases of the nervous system,30,36,21,0.2,-0.416666667,-0.3,3977,3493,4494,-484,1001,517
g40219,g,"Localization-related (focal) (partial) symptomatic epilepsy and epileptic syndromes with complex partial seizures, intractable, without status epilepticus",Diseases of the nervous system,158,116,152,-0.265822785,0.310344828,-0.037974684,1667,1918,1662,251,-256,-5
g40309,g,"Generalized idiopathic epilepsy and epileptic syndromes, not intractable, without status epilepticus",Diseases of the nervous system,81,80,67,-0.012345679,-0.1625,-0.172839506,2457,2359,2617,-98,258,160
g40319,g,"Generalized idiopathic epilepsy and epileptic syndromes, intractable, without status epilepticus",Diseases of the nervous system,15,28,18,0.866666667,-0.357142857,0.2,5208,3943,4755,-1265,812,-453
g40a01,g,"Absence epileptic syndrome, not intractable, with status epilepticus",Diseases of the nervous system,14,17,20,0.214285714,0.176470588,0.428571429,5301,4880,4564,-421,-316,-737
g40a09,g,"Absence epileptic syndrome, not intractable, without status epilepticus",Diseases of the nervous system,61,73,97,0.196721311,0.328767123,0.590163934,2856,2472,2148,-384,-324,-708
g40401,g,"Other generalized epilepsy and epileptic syndromes, not intractable, with status epilepticus",Diseases of the nervous system,72,65,81,-0.097222222,0.246153846,0.125,2623,2643,2374,20,-269,-249
g40409,g,"Other generalized epilepsy and epileptic syndromes, not intractable, without status epilepticus",Diseases of the nervous system,547,411,416,-0.248628885,0.01216545,-0.239488117,781,916,923,135,7,142
g40411,g,"Other generalized epilepsy and epileptic syndromes, intractable, with status epilepticus",Diseases of the nervous system,32,42,16,0.3125,-0.619047619,-0.5,3855,3248,4951,-607,1703,1096
g40419,g,"Other generalized epilepsy and epileptic syndromes, intractable, without status epilepticus",Diseases of the nervous system,76,38,40,-0.5,0.052631579,-0.473684211,2535,3402,3389,867,-13,854
g40501,g,"Epileptic seizures related to external causes, not intractable, with status epilepticus",Diseases of the nervous system,27,18,26,-0.333333333,0.444444444,-0.037037037,4169,4760,4102,591,-658,-67
g40509,g,"Epileptic seizures related to external causes, not intractable, without status epilepticus",Diseases of the nervous system,147,126,124,-0.142857143,-0.015873016,-0.156462585,1741,1839,1866,98,27,125
g40801,g,"Other epilepsy, not intractable, with status epilepticus",Diseases of the nervous system,10,15,12,0.5,-0.2,0.2,5636,5067,5381,-569,314,-255
g40802,g,"Other epilepsy, not intractable, without status epilepticus",Diseases of the nervous system,70,56,48,-0.2,-0.142857143,-0.314285714,2657,2839,3106,182,267,449
g40812,g,"Lennox-Gastaut syndrome, not intractable, without status epilepticus",Diseases of the nervous system,22,24,24,0.090909091,0,0.090909091,4537,4208,4258,-329,50,-279
g40813,g,"Lennox-Gastaut syndrome, intractable, with status epilepticus",Diseases of the nervous system,18,13,10,-0.277777778,-0.230769231,-0.444444444,4899,5283,5587,384,304,688
g40814,g,"Lennox-Gastaut syndrome, intractable, without status epilepticus",Diseases of the nervous system,73,66,74,-0.095890411,0.121212121,0.01369863,2600,2624,2485,24,-139,-115
g40822,g,"Epileptic spasms, not intractable, without status epilepticus",Diseases of the nervous system,24,16,18,-0.333333333,0.125,-0.25,4368,4971,4745,603,-226,377
g4089,g,Other seizures,Diseases of the nervous system,696,754,549,0.083333333,-0.271883289,-0.211206897,662,590,766,-72,176,104
g40901,g,"Epilepsy, unspecified, not intractable, with status epilepticus",Diseases of the nervous system,377,391,432,0.037135279,0.104859335,0.145888594,981,935,901,-46,-34,-80
g40909,g,"Epilepsy, unspecified, not intractable, without status epilepticus",Diseases of the nervous system,8256,7826,8095,-0.052083333,0.034372604,-0.019500969,66,71,68,5,-3,2
g40911,g,"Epilepsy, unspecified, intractable, with status epilepticus",Diseases of the nervous system,114,135,128,0.184210526,-0.051851852,0.122807018,2018,1766,1830,-252,64,-188
g40919,g,"Epilepsy, unspecified, intractable, without status epilepticus",Diseases of the nervous system,230,204,234,-0.113043478,0.147058824,0.017391304,1345,1415,1307,70,-108,-38
g43009,g,"Migraine without aura, not intractable, without status migrainosus",Diseases of the nervous system,116,99,108,-0.146551724,0.090909091,-0.068965517,1996,2071,2005,75,-66,9
g43011,g,"Migraine without aura, intractable, with status migrainosus",Diseases of the nervous system,12,10,12,-0.166666667,0.2,0,5472,5595,5371,123,-224,-101
g43019,g,"Migraine without aura, intractable, without status migrainosus",Diseases of the nervous system,17,15,15,-0.117647059,0,-0.117647059,4979,5057,5047,78,-10,68
g43109,g,"Migraine with aura, not intractable, without status migrainosus",Diseases of the nervous system,213,185,185,-0.131455399,0,-0.131455399,1415,1494,1492,79,-2,77
g43409,g,"Hemiplegic migraine, not intractable, without status migrainosus",Diseases of the nervous system,28,16,27,-0.428571429,0.6875,-0.035714286,4084,4964,4027,880,-937,-57
g43709,g,"Chronic migraine without aura, not intractable, without status migrainosus",Diseases of the nervous system,150,68,79,-0.546666667,0.161764706,-0.473333333,1715,2565,2404,850,-161,689
g43719,g,"Chronic migraine without aura, intractable, without status migrainosus",Diseases of the nervous system,17,11,10,-0.352941176,-0.090909091,-0.411764706,4976,5493,5574,517,81,598
g43a0,g,"Cyclical vomiting, in migraine, not intractable",Diseases of the nervous system,90,10,19,-0.888888889,0.9,-0.788888889,2303,5590,4640,3287,-950,2337
g43809,g,"Other migraine, not intractable, without status migrainosus",Diseases of the nervous system,72,68,58,-0.055555556,-0.147058824,-0.194444444,2610,2565,2810,-45,245,200
g43901,g,"Migraine, unspecified, not intractable, with status migrainosus",Diseases of the nervous system,67,50,66,-0.253731343,0.32,-0.014925373,2711,2969,2627,258,-342,-84
g43909,g,"Migraine, unspecified, not intractable, without status migrainosus",Diseases of the nervous system,7097,5833,6681,-0.178103424,0.145379736,-0.058616317,81,102,89,21,-13,8
g43911,g,"Migraine, unspecified, intractable, with status migrainosus",Diseases of the nervous system,21,19,25,-0.095238095,0.315789474,0.19047619,4602,4648,4158,46,-490,-444
g43919,g,"Migraine, unspecified, intractable, without status migrainosus",Diseases of the nervous system,67,59,51,-0.119402985,-0.13559322,-0.23880597,2710,2755,2999,45,244,289
g44009,g,"Cluster headache syndrome, unspecified, not intractable",Diseases of the nervous system,72,48,41,-0.333333333,-0.145833333,-0.430555556,2609,3032,3343,423,311,734
g44209,g,"Tension-type headache, unspecified, not intractable",Diseases of the nervous system,204,173,182,-0.151960784,0.052023121,-0.107843137,1457,1533,1501,76,-32,44
g44229,g,"Chronic tension-type headache, not intractable",Diseases of the nervous system,29,14,13,-0.517241379,-0.071428571,-0.551724138,4016,5165,5259,1149,94,1243
g44309,g,"Post-traumatic headache, unspecified, not intractable",Diseases of the nervous system,84,59,61,-0.297619048,0.033898305,-0.273809524,2387,2754,2735,367,-19,348
g4440,g,"Drug-induced headache, not elsewhere classified, not intractable",Diseases of the nervous system,76,45,39,-0.407894737,-0.133333333,-0.486842105,2522,3131,3410,609,279,888
g4453,g,Primary thunderclap headache,Diseases of the nervous system,20,23,14,0.15,-0.391304348,-0.3,4696,4271,5137,-425,866,441
g4489,g,Other headache syndrome,Diseases of the nervous system,100,96,115,-0.04,0.197916667,0.15,2163,2117,1938,-46,-179,-225
g450,g,Vertebro-basilar artery syndrome,Diseases of the nervous system,26,36,20,0.384615385,-0.444444444,-0.230769231,4211,3466,4536,-745,1070,325
g453,g,Amaurosis fugax,Diseases of the nervous system,33,41,34,0.242424242,-0.170731707,0.03030303,3770,3268,3628,-502,360,-142
g454,g,Transient global amnesia,Diseases of the nervous system,38,37,40,-0.026315789,0.081081081,0.052631579,3538,3424,3370,-114,-54,-168
g458,g,Other transient cerebral ischemic attacks and related syndromes,Diseases of the nervous system,63,40,46,-0.365079365,0.15,-0.26984127,2792,3308,3156,516,-152,364
g459,g,"Transient cerebral ischemic attack, unspecified",Diseases of the nervous system,759,742,782,-0.022397892,0.053908356,0.03030303,614,593,588,-21,-5,-26
g460,g,Middle cerebral artery syndrome,Diseases of the nervous system,49,50,61,0.020408163,0.22,0.244897959,3146,2963,2733,-183,-230,-413
g463,g,Brain stem stroke syndrome,Diseases of the nervous system,21,22,29,0.047619048,0.318181818,0.380952381,4589,4340,3887,-249,-453,-702
g464,g,Cerebellar stroke syndrome,Diseases of the nervous system,13,18,13,0.384615385,-0.277777778,0,5361,4730,5248,-631,518,-113
g4700,g,"Insomnia, unspecified",Diseases of the nervous system,11475,10323,11358,-0.100392157,0.100261552,-0.010196078,43,52,46,9,-6,3
g4701,g,Insomnia due to medical condition,Diseases of the nervous system,41,51,53,0.243902439,0.039215686,0.292682927,3411,2940,2932,-471,-8,-479
g4709,g,Other insomnia,Diseases of the nervous system,53,48,37,-0.094339623,-0.229166667,-0.301886792,3023,3025,3470,2,445,447
g4710,g,"Hypersomnia, unspecified",Diseases of the nervous system,162,146,142,-0.098765432,-0.02739726,-0.12345679,1635,1681,1709,46,28,74
g4720,g,"Circadian rhythm sleep disorder, unspecified type",Diseases of the nervous system,27,24,12,-0.111111111,-0.5,-0.555555556,4137,4180,5342,43,1162,1205
g4730,g,"Sleep apnea, unspecified",Diseases of the nervous system,6035,4946,4906,-0.18044739,-0.008087343,-0.187075394,100,125,134,25,9,34
g4731,g,Primary central sleep apnea,Diseases of the nervous system,108,113,96,0.046296296,-0.150442478,-0.111111111,2066,1932,2145,-134,213,79
g4733,g,Obstructive sleep apnea (adult) (pediatric),Diseases of the nervous system,19015,17393,17755,-0.085301078,0.020812971,-0.066263476,22,26,24,4,-2,2
g4734,g,Idiopathic sleep related nonobstructive alveolar hypoventilation,Diseases of the nervous system,43,36,58,-0.162790698,0.611111111,0.348837209,3334,3454,2798,120,-656,-536
g4736,g,Sleep related hypoventilation in conditions classified elsewhere,Diseases of the nervous system,30,27,37,-0.1,0.37037037,0.233333333,3936,3971,3465,35,-506,-471
g4739,g,Other sleep apnea,Diseases of the nervous system,25,29,17,0.16,-0.413793103,-0.32,4261,3827,4810,-434,983,549
g47411,g,Narcolepsy with cataplexy,Diseases of the nervous system,17,22,14,0.294117647,-0.363636364,-0.176470588,4945,4329,5119,-616,790,174
g47419,g,Narcolepsy without cataplexy,Diseases of the nervous system,218,166,143,-0.23853211,-0.138554217,-0.344036697,1384,1566,1698,182,132,314
g4752,g,REM sleep behavior disorder,Diseases of the nervous system,12,18,16,0.5,-0.111111111,0.333333333,5433,4717,4906,-716,189,-527
g4761,g,Periodic limb movement disorder,Diseases of the nervous system,19,13,12,-0.315789474,-0.076923077,-0.368421053,4756,5237,5333,481,96,577
g478,g,Other sleep disorders,Diseases of the nervous system,34,22,26,-0.352941176,0.181818182,-0.235294118,3705,4328,4065,623,-263,360
g479,g,"Sleep disorder, unspecified",Diseases of the nervous system,439,362,403,-0.175398633,0.113259669,-0.082004556,895,975,931,80,-44,36
g500,g,Trigeminal neuralgia,Diseases of the nervous system,365,343,365,-0.060273973,0.064139942,0,995,1015,990,20,-25,-5
g510,g,Bell's palsy,Diseases of the nervous system,567,514,488,-0.093474427,-0.050583658,-0.139329806,741,780,823,39,43,82
g540,g,Brachial plexus disorders,Diseases of the nervous system,78,69,87,-0.115384615,0.260869565,0.115384615,2478,2529,2261,51,-268,-217
g546,g,Phantom limb syndrome with pain,Diseases of the nervous system,283,234,203,-0.173144876,-0.132478632,-0.282685512,1181,1277,1409,96,132,228
g5600,g,"Carpal tunnel syndrome, unspecified upper limb",Diseases of the nervous system,147,105,105,-0.285714286,0,-0.285714286,1723,1984,2018,261,34,295
g5601,g,"Carpal tunnel syndrome, right upper limb",Diseases of the nervous system,78,57,48,-0.269230769,-0.157894737,-0.384615385,2476,2788,3074,312,286,598
g5602,g,"Carpal tunnel syndrome, left upper limb",Diseases of the nervous system,62,58,54,-0.064516129,-0.068965517,-0.129032258,2797,2765,2898,-32,133,101
g5603,g,"Carpal tunnel syndrome, bilateral upper limbs",Diseases of the nervous system,58,67,61,0.155172414,-0.089552239,0.051724138,2892,2573,2721,-319,148,-171
g5620,g,"Lesion of ulnar nerve, unspecified upper limb",Diseases of the nervous system,21,14,12,-0.333333333,-0.142857143,-0.428571429,4567,5129,5323,562,194,756
g5621,g,"Lesion of ulnar nerve, right upper limb",Diseases of the nervous system,26,20,19,-0.230769231,-0.05,-0.269230769,4185,4519,4603,334,84,418
g5622,g,"Lesion of ulnar nerve, left upper limb",Diseases of the nervous system,27,26,23,-0.037037037,-0.115384615,-0.148148148,4121,4026,4279,-95,253,158
g5631,g,"Lesion of radial nerve, right upper limb",Diseases of the nervous system,24,36,22,0.5,-0.388888889,-0.083333333,4318,3444,4360,-874,916,42
g5632,g,"Lesion of radial nerve, left upper limb",Diseases of the nervous system,22,18,24,-0.181818182,0.333333333,0.090909091,4484,4704,4212,220,-492,-272
g5732,g,"Lesion of lateral popliteal nerve, left lower limb",Diseases of the nervous system,12,10,10,-0.166666667,0,-0.166666667,5417,5540,5523,123,-17,106
g5790,g,Unspecified mononeuropathy of unspecified lower limb,Diseases of the nervous system,55,40,34,-0.272727273,-0.15,-0.381818182,2963,3289,3605,326,316,642
g5791,g,Unspecified mononeuropathy of right lower limb,Diseases of the nervous system,21,18,24,-0.142857143,0.333333333,0.142857143,4562,4703,4211,141,-492,-351
g5792,g,Unspecified mononeuropathy of left lower limb,Diseases of the nervous system,28,27,22,-0.035714286,-0.185185185,-0.214285714,4046,3958,4357,-88,399,311
g5793,g,Unspecified mononeuropathy of bilateral lower limbs,Diseases of the nervous system,57,56,60,-0.01754386,0.071428571,0.052631579,2915,2808,2746,-107,-62,-169
g588,g,Other specified mononeuropathies,Diseases of the nervous system,56,47,58,-0.160714286,0.234042553,0.035714286,2931,3041,2789,110,-252,-142
g589,g,"Mononeuropathy, unspecified",Diseases of the nervous system,53,29,36,-0.452830189,0.24137931,-0.320754717,3006,3813,3486,807,-327,480
g600,g,Hereditary motor and sensory neuropathy,Diseases of the nervous system,107,100,97,-0.065420561,-0.03,-0.093457944,2072,2040,2125,-32,85,53
g603,g,Idiopathic progressive neuropathy,Diseases of the nervous system,32,20,18,-0.375,-0.1,-0.4375,3804,4511,4687,707,176,883
g608,g,Other hereditary and idiopathic neuropathies,Diseases of the nervous system,51,54,68,0.058823529,0.259259259,0.333333333,3068,2846,2571,-222,-275,-497
g609,g,"Hereditary and idiopathic neuropathy, unspecified",Diseases of the nervous system,358,300,232,-0.162011173,-0.226666667,-0.351955307,1006,1104,1305,98,201,299
g610,g,Guillain-Barre syndrome,Diseases of the nervous system,240,215,242,-0.104166667,0.125581395,0.008333333,1304,1358,1273,54,-85,-31
g6181,g,Chronic inflammatory demyelinating polyneuritis,Diseases of the nervous system,176,170,147,-0.034090909,-0.135294118,-0.164772727,1559,1536,1670,-23,134,111
g620,g,Drug-induced polyneuropathy,Diseases of the nervous system,439,424,324,-0.034168565,-0.235849057,-0.261958998,894,891,1065,-3,174,171
g621,g,Alcoholic polyneuropathy,Diseases of the nervous system,137,138,157,0.00729927,0.137681159,0.145985401,1781,1726,1606,-55,-120,-175
g622,g,Polyneuropathy due to other toxic agents,Diseases of the nervous system,13,16,21,0.230769231,0.3125,0.615384615,5318,4902,4422,-416,-480,-896
g6281,g,Critical illness polyneuropathy,Diseases of the nervous system,49,69,154,0.408163265,1.231884058,2.142857143,3119,2521,1627,-598,-894,-1492
g6289,g,Other specified polyneuropathies,Diseases of the nervous system,121,117,107,-0.033057851,-0.085470085,-0.115702479,1921,1886,1995,-35,109,74
g629,g,"Polyneuropathy, unspecified",Diseases of the nervous system,8680,7908,7545,-0.088940092,-0.045902883,-0.130760369,61,68,74,7,6,13
g63,g,Polyneuropathy in diseases classified elsewhere,Diseases of the nervous system,28,19,16,-0.321428571,-0.157894737,-0.428571429,4032,4592,4874,560,282,842
g650,g,Sequelae of Guillain-Barre syndrome,Diseases of the nervous system,30,22,15,-0.266666667,-0.318181818,-0.5,3910,4302,4981,392,679,1071
g7000,g,Myasthenia gravis without (acute) exacerbation,Diseases of the nervous system,381,370,395,-0.028871391,0.067567568,0.036745407,962,960,939,-2,-21,-23
g7001,g,Myasthenia gravis with (acute) exacerbation,Diseases of the nervous system,99,96,77,-0.03030303,-0.197916667,-0.222222222,2151,2096,2404,-55,308,253
g709,g,"Myoneural disorder, unspecified",Diseases of the nervous system,49,55,48,0.12244898,-0.127272727,-0.020408163,3115,2815,3058,-300,243,-57
g7100,g,"Muscular dystrophy, unspecified",Diseases of the nervous system,127,114,115,-0.102362205,0.00877193,-0.094488189,1859,1907,1920,48,13,61
g7101,g,Duchenne or Becker muscular dystrophy,Diseases of the nervous system,38,34,14,-0.105263158,-0.588235294,-0.631578947,3499,3504,5079,5,1575,1580
g7109,g,Other specified muscular dystrophies,Diseases of the nervous system,18,31,23,0.722222222,-0.258064516,0.277777778,4816,3673,4259,-1143,586,-557
g7111,g,Myotonic muscular dystrophy,Diseases of the nervous system,42,41,36,-0.023809524,-0.12195122,-0.142857143,3339,3233,3472,-106,239,133
g720,g,Drug-induced myopathy,Diseases of the nervous system,128,97,89,-0.2421875,-0.082474227,-0.3046875,1850,2079,2229,229,150,379
g721,g,Alcoholic myopathy,Diseases of the nervous system,17,20,18,0.176470588,-0.1,0.058823529,4901,4493,4670,-408,177,-231
g7241,g,Inclusion body myositis [IBM],Diseases of the nervous system,28,29,24,0.035714286,-0.172413793,-0.142857143,4024,3795,4192,-229,397,168
g7281,g,Critical illness myopathy,Diseases of the nervous system,721,870,998,0.20665742,0.147126437,0.384188627,631,517,479,-114,-38,-152
g7289,g,Other specified myopathies,Diseases of the nervous system,242,197,214,-0.185950413,0.086294416,-0.115702479,1294,1427,1354,133,-73,60
g729,g,"Myopathy, unspecified",Diseases of the nervous system,36,76,85,1.111111111,0.118421053,1.361111111,3576,2378,2278,-1198,-100,-1298
g737,g,Myopathy in diseases classified elsewhere,Diseases of the nervous system,10,11,44,0.1,3,3.4,5534,5410,3187,-124,-2223,-2347
g800,g,Spastic quadriplegic cerebral palsy,Diseases of the nervous system,283,262,235,-0.074204947,-0.103053435,-0.169611307,1176,1185,1293,9,108,117
g801,g,Spastic diplegic cerebral palsy,Diseases of the nervous system,105,87,68,-0.171428571,-0.218390805,-0.352380952,2084,2212,2555,128,343,471
g802,g,Spastic hemiplegic cerebral palsy,Diseases of the nervous system,28,34,24,0.214285714,-0.294117647,-0.142857143,4019,3497,4186,-522,689,167
g808,g,Other cerebral palsy,Diseases of the nervous system,99,84,83,-0.151515152,-0.011904762,-0.161616162,2145,2256,2301,111,45,156
g809,g,"Cerebral palsy, unspecified",Diseases of the nervous system,698,627,609,-0.101719198,-0.028708134,-0.127507163,651,673,693,22,20,42
g8101,g,Flaccid hemiplegia affecting right dominant side,Diseases of the nervous system,68,57,57,-0.161764706,0,-0.161764706,2642,2766,2790,124,24,148
g8104,g,Flaccid hemiplegia affecting left nondominant side,Diseases of the nervous system,57,53,47,-0.070175439,-0.113207547,-0.175438596,2896,2851,3079,-45,228,183
g8111,g,Spastic hemiplegia affecting right dominant side,Diseases of the nervous system,25,37,37,0.48,0,0.48,4212,3376,3428,-836,52,-784
g8114,g,Spastic hemiplegia affecting left nondominant side,Diseases of the nervous system,35,26,35,-0.257142857,0.346153846,0,3617,3990,3519,373,-471,-98
g8190,g,"Hemiplegia, unspecified affecting unspecified side",Diseases of the nervous system,92,70,87,-0.239130435,0.242857143,-0.054347826,2240,2481,2243,241,-238,3
g8191,g,"Hemiplegia, unspecified affecting right dominant side",Diseases of the nervous system,1992,2013,1883,0.010542169,-0.064580229,-0.054718876,284,269,299,-15,30,15
g8192,g,"Hemiplegia, unspecified affecting left dominant side",Diseases of the nervous system,24,28,27,0.166666667,-0.035714286,0.125,4278,3856,3958,-422,102,-320
g8193,g,"Hemiplegia, unspecified affecting right nondominant side",Diseases of the nervous system,31,38,30,0.225806452,-0.210526316,-0.032258065,3826,3331,3792,-495,461,-34
g8194,g,"Hemiplegia, unspecified affecting left nondominant side",Diseases of the nervous system,2137,2204,2115,0.031352363,-0.040381125,-0.010294806,266,248,271,-18,23,5
g8220,g,"Paraplegia, unspecified",Diseases of the nervous system,1240,1145,1098,-0.076612903,-0.041048035,-0.114516129,416,421,442,5,21,26
g8221,g,"Paraplegia, complete",Diseases of the nervous system,83,67,79,-0.192771084,0.179104478,-0.048192771,2368,2549,2366,181,-183,-2
g8222,g,"Paraplegia, incomplete",Diseases of the nervous system,135,137,179,0.014814815,0.306569343,0.325925926,1787,1724,1489,-63,-235,-298
g8250,g,"Quadriplegia, unspecified",Diseases of the nervous system,635,563,561,-0.113385827,-0.003552398,-0.116535433,683,720,738,37,18,55
g8252,g,"Quadriplegia, C1-C4 incomplete",Diseases of the nervous system,55,62,43,0.127272727,-0.306451613,-0.218181818,2934,2650,3211,-284,561,277
g8253,g,"Quadriplegia, C5-C7 complete",Diseases of the nervous system,17,15,11,-0.117647059,-0.266666667,-0.352941176,4878,4955,5376,77,421,498
g8254,g,"Quadriplegia, C5-C7 incomplete",Diseases of the nervous system,100,92,99,-0.08,0.076086957,-0.01,2130,2140,2080,10,-60,-50
g8310,g,Monoplegia of lower limb affecting unspecified side,Diseases of the nervous system,27,20,15,-0.259259259,-0.25,-0.444444444,4074,4469,4948,395,479,874
g8311,g,Monoplegia of lower limb affecting right dominant side,Diseases of the nervous system,57,53,64,-0.070175439,0.20754717,0.122807018,2888,2842,2624,-46,-218,-264
g8314,g,Monoplegia of lower limb affecting left nondominant side,Diseases of the nervous system,54,63,72,0.166666667,0.142857143,0.333333333,2955,2625,2474,-330,-151,-481
g8321,g,Monoplegia of upper limb affecting right dominant side,Diseases of the nervous system,160,137,150,-0.14375,0.094890511,-0.0625,1622,1723,1640,101,-83,18
g8324,g,Monoplegia of upper limb affecting left nondominant side,Diseases of the nervous system,165,148,162,-0.103030303,0.094594595,-0.018181818,1598,1643,1570,45,-73,-28
g834,g,Cauda equina syndrome,Diseases of the nervous system,212,257,226,0.212264151,-0.120622568,0.066037736,1395,1202,1311,-193,109,-84
g835,g,Locked-in state,Diseases of the nervous system,18,10,11,-0.444444444,0.1,-0.388888889,4784,5479,5369,695,-110,585
g8384,g,Todd's paralysis (postepileptic),Diseases of the nervous system,135,93,98,-0.311111111,0.053763441,-0.274074074,1783,2122,2090,339,-32,307
g8389,g,Other specified paralytic syndromes,Diseases of the nervous system,25,20,26,-0.2,0.3,0.04,4194,4463,4007,269,-456,-187
g839,g,"Paralytic syndrome, unspecified",Diseases of the nervous system,107,81,105,-0.242990654,0.296296296,-0.018691589,2049,2290,1996,241,-294,-53
g890,g,Central pain syndrome,Diseases of the nervous system,13,10,10,-0.230769231,0,-0.230769231,5269,5476,5458,207,-18,189
g8911,g,Acute pain due to trauma,Diseases of the nervous system,621,637,495,0.025764895,-0.222919937,-0.202898551,692,665,804,-27,139,112
g8912,g,Acute post-thoracotomy pain,Diseases of the nervous system,28,27,35,-0.035714286,0.296296296,0.25,3996,3906,3502,-90,-404,-494
g8918,g,Other acute postprocedural pain,Diseases of the nervous system,3540,2864,3152,-0.190960452,0.100558659,-0.10960452,168,202,189,34,-13,21
g8921,g,Chronic pain due to trauma,Diseases of the nervous system,132,112,108,-0.151515152,-0.035714286,-0.181818182,1799,1906,1968,107,62,169
g8928,g,Other chronic postprocedural pain,Diseases of the nervous system,51,18,26,-0.647058824,0.444444444,-0.490196078,3030,4640,4002,1610,-638,972
g8929,g,Other chronic pain,Diseases of the nervous system,24935,22091,20464,-0.114056547,-0.073649903,-0.179306196,13,16,20,3,4,7
g893,g,Neoplasm related pain (acute) (chronic),Diseases of the nervous system,2033,1893,1675,-0.068863748,-0.11516112,-0.176094442,275,286,320,11,34,45
g894,g,Chronic pain syndrome,Diseases of the nervous system,5622,4786,4774,-0.14870153,-0.002507313,-0.150836001,113,128,139,15,11,26
g9009,g,Other idiopathic peripheral autonomic neuropathy,Diseases of the nervous system,34,40,43,0.176470588,0.075,0.264705882,3642,3240,3197,-402,-43,-445
g901,g,Familial dysautonomia [Riley-Day],Diseases of the nervous system,82,68,75,-0.170731707,0.102941176,-0.085365854,2370,2511,2405,141,-106,35
g902,g,Horner's syndrome,Diseases of the nervous system,33,25,28,-0.242424242,0.12,-0.151515152,3691,4023,3879,332,-144,188
g903,g,Multi-system degeneration of the autonomic nervous system,Diseases of the nervous system,59,61,62,0.033898305,0.016393443,0.050847458,2824,2657,2656,-167,-1,-168
g904,g,Autonomic dysreflexia,Diseases of the nervous system,86,59,81,-0.313953488,0.372881356,-0.058139535,2304,2696,2313,392,-383,9
g9050,g,"Complex regional pain syndrome I, unspecified",Diseases of the nervous system,112,98,100,-0.125,0.020408163,-0.107142857,1994,2042,2054,48,12,60
g90521,g,Complex regional pain syndrome I of right lower limb,Diseases of the nervous system,12,12,12,0,0,0,5338,5260,5242,-78,-18,-96
g9059,g,Complex regional pain syndrome I of other specified site,Diseases of the nervous system,10,13,11,0.3,-0.153846154,0.1,5487,5145,5351,-342,206,-136
g908,g,Other disorders of autonomic nervous system,Diseases of the nervous system,41,28,32,-0.317073171,0.142857143,-0.219512195,3340,3830,3655,490,-175,315
g909,g,"Disorder of the autonomic nervous system, unspecified",Diseases of the nervous system,181,169,191,-0.066298343,0.130177515,0.055248619,1516,1523,1437,7,-86,-79
g910,g,Communicating hydrocephalus,Diseases of the nervous system,78,92,83,0.179487179,-0.097826087,0.064102564,2435,2128,2280,-307,152,-155
g911,g,Obstructive hydrocephalus,Diseases of the nervous system,283,296,305,0.045936396,0.030405405,0.077738516,1166,1099,1097,-67,-2,-69
g912,g,(Idiopathic) normal pressure hydrocephalus,Diseases of the nervous system,440,389,416,-0.115909091,0.06940874,-0.054545455,881,917,902,36,-15,21
g913,g,"Post-traumatic hydrocephalus, unspecified",Diseases of the nervous system,17,11,27,-0.352941176,1.454545455,0.588235294,4848,5359,3925,511,-1434,-923
g914,g,Hydrocephalus in diseases classified elsewhere,Diseases of the nervous system,51,48,62,-0.058823529,0.291666667,0.215686275,3019,2956,2650,-63,-306,-369
g918,g,Other hydrocephalus,Diseases of the nervous system,46,37,39,-0.195652174,0.054054054,-0.152173913,3154,3343,3329,189,-14,175
g919,g,"Hydrocephalus, unspecified",Diseases of the nervous system,699,642,658,-0.081545064,0.024922118,-0.058655222,641,653,648,12,-5,7
g92,g,Toxic encephalopathy,Diseases of the nervous system,5962,6071,6546,0.018282456,0.078240817,0.097953707,98,93,88,-5,-5,-10
g930,g,Cerebral cysts,Diseases of the nervous system,182,156,168,-0.142857143,0.076923077,-0.076923077,1506,1595,1526,89,-69,20
g931,g,"Anoxic brain damage, not elsewhere classified",Diseases of the nervous system,1263,1357,1540,0.07442597,0.134856301,0.219319082,406,378,346,-28,-32,-60
g932,g,Benign intracranial hypertension,Diseases of the nervous system,304,260,344,-0.144736842,0.323076923,0.131578947,1121,1180,1008,59,-172,-113
g9340,g,"Encephalopathy, unspecified",Diseases of the nervous system,4032,4214,4479,0.045138889,0.062885619,0.110863095,150,143,143,-7,0,-7
g9341,g,Metabolic encephalopathy,Diseases of the nervous system,12634,14238,16454,0.126959,0.155639837,0.302358715,37,32,27,-5,-5,-10
g9349,g,Other encephalopathy,Diseases of the nervous system,1217,1249,1587,0.026294166,0.270616493,0.304026294,410,391,338,-19,-53,-72
g935,g,Compression of brain,Diseases of the nervous system,1279,1345,1291,0.051602815,-0.040148699,0.00938233,396,378,389,-18,11,-7
g936,g,Cerebral edema,Diseases of the nervous system,2674,2604,2487,-0.02617801,-0.044930876,-0.069932685,210,212,217,2,5,7
g9381,g,Temporal sclerosis,Diseases of the nervous system,40,26,19,-0.35,-0.269230769,-0.525,3359,3943,4511,584,568,1152
g9382,g,Brain death,Diseases of the nervous system,171,197,202,0.152046784,0.025380711,0.18128655,1555,1404,1384,-151,-20,-171
g9389,g,Other specified disorders of brain,Diseases of the nervous system,1449,1368,1503,-0.055900621,0.098684211,0.037267081,362,371,343,9,-28,-19
g939,g,"Disorder of brain, unspecified",Diseases of the nervous system,217,204,205,-0.059907834,0.004901961,-0.055299539,1362,1376,1367,14,-9,5
g950,g,Syringomyelia and syringobulbia,Diseases of the nervous system,84,84,80,0,-0.047619048,-0.047619048,2320,2221,2312,-99,91,-8
g9511,g,Acute infarction of spinal cord (embolic) (nonembolic),Diseases of the nervous system,24,19,26,-0.208333333,0.368421053,0.083333333,4225,4514,3971,289,-543,-254
g9519,g,Other vascular myelopathies,Diseases of the nervous system,106,120,98,0.132075472,-0.183333333,-0.075471698,2035,1828,2066,-207,238,31
g9520,g,Unspecified cord compression,Diseases of the nervous system,292,272,285,-0.068493151,0.047794118,-0.023972603,1139,1144,1131,5,-13,-8
g9529,g,Other cord compression,Diseases of the nervous system,239,210,218,-0.121338912,0.038095238,-0.087866109,1280,1347,1313,67,-34,33
g9589,g,Other specified diseases of spinal cord,Diseases of the nervous system,209,213,205,0.019138756,-0.037558685,-0.019138756,1395,1335,1365,-60,30,-30
g959,g,"Disease of spinal cord, unspecified",Diseases of the nervous system,200,207,194,0.035,-0.062801932,-0.03,1426,1361,1407,-65,46,-19
g9611,g,Dural tear,Diseases of the nervous system,46,26,20,-0.434782609,-0.230769231,-0.565217391,3135,3934,4408,799,474,1273
g9612,g,Meningeal adhesions (cerebral) (spinal),Diseases of the nervous system,46,22,36,-0.52173913,0.636363636,-0.217391304,3135,4222,3408,1087,-814,273
g971,g,Other reaction to spinal and lumbar puncture,Diseases of the nervous system,148,102,95,-0.310810811,-0.068627451,-0.358108108,1677,1963,2098,286,135,421
g9741,g,Accidental puncture or laceration of dura during a procedure,Diseases of the nervous system,275,251,247,-0.087272727,-0.015936255,-0.101818182,1170,1197,1234,27,37,64
g9751,g,Postprocedural hemorrhage of a nervous system organ or structure following a nervous system procedure,Diseases of the nervous system,23,21,17,-0.086956522,-0.19047619,-0.260869565,4295,4318,4689,23,371,394
g9761,g,Postprocedural hematoma of a nervous system organ or structure following a nervous system procedure,Diseases of the nervous system,39,33,37,-0.153846154,0.121212121,-0.051282051,3394,3495,3374,101,-121,-20
g9763,g,Postprocedural seroma of a nervous system organ or structure following a nervous system procedure,Diseases of the nervous system,19,15,15,-0.210526316,0,-0.210526316,4634,4897,4891,263,-6,257
g9782,g,Other postprocedural complications and disorders of nervous system,Diseases of the nervous system,89,84,54,-0.056179775,-0.357142857,-0.393258427,2238,2214,2822,-24,608,584
g992,g,Myelopathy in diseases classified elsewhere,Diseases of the nervous system,309,344,350,0.113268608,0.01744186,0.132686084,1096,985,993,-111,8,-103
h00016,h,"Hordeolum externum left eye, unspecified eyelid",Diseases of the eye and ear,16,10,11,-0.375,0.1,-0.3125,4909,5422,5313,513,-109,404
h01006,h,"Unspecified blepharitis left eye, unspecified eyelid",Diseases of the eye and ear,12,14,14,0.166666667,0,0.166666667,5299,5011,4989,-288,-22,-310
h02401,h,Unspecified ptosis of right eyelid,Diseases of the eye and ear,75,65,66,-0.133333333,0.015384615,-0.12,2457,2546,2541,89,-5,84
h02402,h,Unspecified ptosis of left eyelid,Diseases of the eye and ear,82,96,79,0.170731707,-0.177083333,-0.036585366,2342,2051,2324,-291,273,-18
h04123,h,Dry eye syndrome of bilateral lacrimal glands,Diseases of the eye and ear,110,124,103,0.127272727,-0.169354839,-0.063636364,1990,1789,1992,-201,203,2
h04129,h,Dry eye syndrome of unspecified lacrimal gland,Diseases of the eye and ear,95,70,74,-0.263157895,0.057142857,-0.221052632,2161,2434,2392,273,-42,231
h05011,h,Cellulitis of right orbit,Diseases of the eye and ear,32,51,32,0.59375,-0.37254902,0,3711,2844,3620,-867,776,-91
h05012,h,Cellulitis of left orbit,Diseases of the eye and ear,45,34,40,-0.244444444,0.176470588,-0.111111111,3162,3430,3264,268,-166,102
h0520,h,Unspecified exophthalmos,Diseases of the eye and ear,105,98,104,-0.066666667,0.06122449,-0.00952381,2041,2017,1982,-24,-35,-59
h1010,h,"Acute atopic conjunctivitis, unspecified eye",Diseases of the eye and ear,26,18,19,-0.307692308,0.055555556,-0.269230769,4074,4588,4487,514,-101,413
h1031,h,"Unspecified acute conjunctivitis, right eye",Diseases of the eye and ear,25,22,14,-0.12,-0.363636364,-0.44,4137,4210,4981,73,771,844
h1032,h,"Unspecified acute conjunctivitis, left eye",Diseases of the eye and ear,31,29,29,-0.064516129,0,-0.064516129,3758,3719,3768,-39,49,10
h1033,h,"Unspecified acute conjunctivitis, bilateral",Diseases of the eye and ear,40,46,26,0.15,-0.434782609,-0.35,3338,2992,3952,-346,960,614
h1089,h,Other conjunctivitis,Diseases of the eye and ear,51,53,47,0.039215686,-0.113207547,-0.078431373,2991,2794,3021,-197,227,30
h109,h,Unspecified conjunctivitis,Diseases of the eye and ear,355,451,330,0.270422535,-0.268292683,-0.070422535,990,843,1033,-147,190,43
h1130,h,"Conjunctival hemorrhage, unspecified eye",Diseases of the eye and ear,15,21,13,0.4,-0.380952381,-0.133333333,5007,4303,5092,-704,789,85
h1131,h,"Conjunctival hemorrhage, right eye",Diseases of the eye and ear,63,48,59,-0.238095238,0.229166667,-0.063492063,2704,2925,2691,221,-234,-13
h1132,h,"Conjunctival hemorrhage, left eye",Diseases of the eye and ear,81,61,61,-0.24691358,0,-0.24691358,2359,2623,2642,264,19,283
h1133,h,"Conjunctival hemorrhage, bilateral",Diseases of the eye and ear,20,21,22,0.05,0.047619048,0.1,4537,4301,4243,-236,-58,-294
h179,h,Unspecified corneal scar and opacity,Diseases of the eye and ear,16,14,14,-0.125,0,-0.125,4893,4994,4974,101,-20,81
h209,h,Unspecified iridocyclitis,Diseases of the eye and ear,36,39,35,0.083333333,-0.102564103,-0.027777778,3498,3230,3451,-268,221,-47
h2513,h,"Age-related nuclear cataract, bilateral",Diseases of the eye and ear,12,15,10,0.25,-0.333333333,-0.166666667,5280,4877,5383,-403,506,103
h269,h,Unspecified cataract,Diseases of the eye and ear,512,494,410,-0.03515625,-0.170040486,-0.19921875,791,782,901,-9,119,110
h3320,h,"Serous retinal detachment, unspecified eye",Diseases of the eye and ear,11,23,16,1.090909091,-0.304347826,0.454545455,5354,4126,4765,-1228,639,-589
h3321,h,"Serous retinal detachment, right eye",Diseases of the eye and ear,23,17,20,-0.260869565,0.176470588,-0.130434783,4275,4684,4386,409,-298,111
h3411,h,"Central retinal artery occlusion, right eye",Diseases of the eye and ear,16,12,17,-0.25,0.416666667,0.0625,4890,5198,4668,308,-530,-222
h3412,h,"Central retinal artery occlusion, left eye",Diseases of the eye and ear,17,11,11,-0.352941176,0,-0.352941176,4797,5302,5289,505,-13,492
h349,h,Unspecified retinal vascular occlusion,Diseases of the eye and ear,21,19,16,-0.095238095,-0.157894737,-0.238095238,4437,4482,4763,45,281,326
h3500,h,Unspecified background retinopathy,Diseases of the eye and ear,15,16,14,0.066666667,-0.125,-0.066666667,4997,4783,4968,-214,185,-29
h35039,h,"Hypertensive retinopathy, unspecified eye",Diseases of the eye and ear,13,14,12,0.076923077,-0.142857143,-0.076923077,5191,4987,5178,-204,191,-13
h35109,h,"Retinopathy of prematurity, unspecified, unspecified eye",Diseases of the eye and ear,35,35,28,0,-0.2,-0.2,3543,3386,3830,-157,444,287
h35113,h,"Retinopathy of prematurity, stage 0, bilateral",Diseases of the eye and ear,36,51,93,0.416666667,0.823529412,1.583333333,3497,2839,2114,-658,-725,-1383
h35123,h,"Retinopathy of prematurity, stage 1, bilateral",Diseases of the eye and ear,32,41,31,0.28125,-0.243902439,-0.03125,3700,3156,3668,-544,512,-32
h35133,h,"Retinopathy of prematurity, stage 2, bilateral",Diseases of the eye and ear,18,18,16,0,-0.111111111,-0.111111111,4707,4572,4760,-135,188,53
h35143,h,"Retinopathy of prematurity, stage 3, bilateral",Diseases of the eye and ear,11,12,16,0.090909091,0.333333333,0.454545455,5344,5191,4760,-153,-431,-584
h3530,h,Unspecified macular degeneration,Diseases of the eye and ear,1522,1186,1022,-0.220762155,-0.138279933,-0.328515112,349,400,455,51,55,106
h353290,h,"Exudative age-related macular degeneration, unspecified eye, stage unspecified",Diseases of the eye and ear,20,19,15,-0.05,-0.210526316,-0.25,4529,4478,4862,-51,384,333
h3552,h,Pigmentary retinal dystrophy,Diseases of the eye and ear,23,32,30,0.391304348,-0.0625,0.304347826,4271,3530,3718,-741,188,-553
h3563,h,"Retinal hemorrhage, bilateral",Diseases of the eye and ear,27,17,17,-0.37037037,0,-0.37037037,4000,4676,4663,676,-13,663
h40009,h,"Preglaucoma, unspecified, unspecified eye",Diseases of the eye and ear,15,11,10,-0.266666667,-0.090909091,-0.333333333,4989,5290,5366,301,76,377
h4010x0,h,"Unspecified open-angle glaucoma, stage unspecified",Diseases of the eye and ear,33,48,39,0.454545455,-0.1875,0.181818182,3638,2921,3293,-717,372,-345
h401190,h,"Primary open-angle glaucoma, unspecified eye, stage unspecified",Diseases of the eye and ear,25,24,20,-0.04,-0.166666667,-0.2,4123,4041,4380,-82,339,257
h409,h,Unspecified glaucoma,Diseases of the eye and ear,3973,3412,3228,-0.141203121,-0.053927315,-0.187515731,154,165,180,11,15,26
h42,h,Glaucoma in diseases classified elsewhere,Diseases of the eye and ear,76,57,64,-0.25,0.122807018,-0.157894737,2431,2704,2573,273,-131,142
h4311,h,"Vitreous hemorrhage, right eye",Diseases of the eye and ear,14,13,12,-0.071428571,-0.076923077,-0.142857143,5075,5069,5165,-6,96,90
h468,h,Other optic neuritis,Diseases of the eye and ear,13,17,20,0.307692308,0.176470588,0.538461538,5177,4672,4378,-505,-294,-799
h469,h,Unspecified optic neuritis,Diseases of the eye and ear,73,87,93,0.191780822,0.068965517,0.273972603,2494,2162,2112,-332,-50,-382
h47039,h,"Optic nerve hypoplasia, unspecified eye",Diseases of the eye and ear,18,17,18,-0.055555556,0.058823529,0,4698,4671,4558,-27,-113,-140
h4710,h,Unspecified papilledema,Diseases of the eye and ear,50,59,56,0.18,-0.050847458,0.12,3012,2657,2747,-355,90,-265
h4711,h,Papilledema associated with increased intracranial pressure,Diseases of the eye and ear,14,13,14,-0.071428571,0.076923077,0,5072,5065,4951,-7,-114,-121
h4720,h,Unspecified optic atrophy,Diseases of the eye and ear,21,20,13,-0.047619048,-0.35,-0.380952381,4425,4384,5063,-41,679,638
h4742,h,Disorders of optic chiasm in (due to) neoplasm,Diseases of the eye and ear,38,25,18,-0.342105263,-0.28,-0.526315789,3411,3962,4557,551,595,1146
h47619,h,"Cortical blindness, unspecified side of brain",Diseases of the eye and ear,72,68,80,-0.055555556,0.176470588,0.111111111,2512,2474,2296,-38,-178,-216
h4900,h,"Third [oculomotor] nerve palsy, unspecified eye",Diseases of the eye and ear,19,19,17,0,-0.105263158,-0.105263158,4596,4468,4653,-128,185,57
h4901,h,"Third [oculomotor] nerve palsy, right eye",Diseases of the eye and ear,55,41,44,-0.254545455,0.073170732,-0.2,2876,3149,3111,273,-38,235
h4902,h,"Third [oculomotor] nerve palsy, left eye",Diseases of the eye and ear,51,53,55,0.039215686,0.037735849,0.078431373,2981,2785,2775,-196,-10,-206
h4920,h,"Sixth [abducent] nerve palsy, unspecified eye",Diseases of the eye and ear,22,21,28,-0.045454545,0.333333333,0.272727273,4342,4283,3818,-59,-465,-524
h4921,h,"Sixth [abducent] nerve palsy, right eye",Diseases of the eye and ear,42,53,51,0.261904762,-0.037735849,0.214285714,3253,2785,2884,-468,99,-369
h4922,h,"Sixth [abducent] nerve palsy, left eye",Diseases of the eye and ear,44,45,52,0.022727273,0.155555556,0.181818182,3186,3009,2855,-177,-154,-331
h4923,h,"Sixth [abducent] nerve palsy, bilateral",Diseases of the eye and ear,16,13,15,-0.1875,0.153846154,-0.0625,4864,5056,4844,192,-212,-20
h499,h,Unspecified paralytic strabismus,Diseases of the eye and ear,23,15,33,-0.347826087,1.2,0.434782609,4258,4847,3545,589,-1302,-713
h5000,h,Unspecified esotropia,Diseases of the eye and ear,18,20,15,0.111111111,-0.25,-0.166666667,4687,4377,4843,-310,466,156
h5010,h,Unspecified exotropia,Diseases of the eye and ear,23,26,12,0.130434783,-0.538461538,-0.47826087,4258,3899,5148,-359,1249,890
h509,h,Unspecified strabismus,Diseases of the eye and ear,41,24,27,-0.414634146,0.125,-0.341463415,3288,4030,3867,742,-163,579
h510,h,Palsy (spasm) of conjugate gaze,Diseases of the eye and ear,55,47,35,-0.145454545,-0.255319149,-0.363636364,2876,2942,3438,66,496,562
h518,h,Other specified disorders of binocular movement,Diseases of the eye and ear,88,105,89,0.193181818,-0.152380952,0.011363636,2242,1929,2175,-313,246,-67
h524,h,Presbyopia,Diseases of the eye and ear,23,19,14,-0.173913043,-0.263157895,-0.391304348,4255,4458,4937,203,479,682
h53149,h,"Visual discomfort, unspecified",Diseases of the eye and ear,66,50,62,-0.242424242,0.24,-0.060606061,2632,2849,2614,217,-235,-18
h532,h,Diplopia,Diseases of the eye and ear,830,711,695,-0.143373494,-0.022503516,-0.162650602,548,592,619,44,27,71
h5340,h,Unspecified visual field defects,Diseases of the eye and ear,145,149,150,0.027586207,0.006711409,0.034482759,1683,1607,1606,-76,-1,-77
h53451,h,"Other localized visual field defect, right eye",Diseases of the eye and ear,25,15,15,-0.4,0,-0.4,4107,4838,4837,731,-1,730
h53452,h,"Other localized visual field defect, left eye",Diseases of the eye and ear,29,12,16,-0.586206897,0.333333333,-0.448275862,3855,5156,4734,1301,-422,879
h53461,h,"Homonymous bilateral field defects, right side",Diseases of the eye and ear,202,208,189,0.02970297,-0.091346154,-0.064356436,1410,1346,1422,-64,76,12
h53462,h,"Homonymous bilateral field defects, left side",Diseases of the eye and ear,230,258,213,0.12173913,-0.174418605,-0.073913043,1297,1174,1325,-123,151,28
h53469,h,"Homonymous bilateral field defects, unspecified side",Diseases of the eye and ear,23,29,35,0.260869565,0.206896552,0.52173913,4248,3690,3432,-558,-258,-816
h5347,h,Heteronymous bilateral field defects,Diseases of the eye and ear,131,137,150,0.045801527,0.094890511,0.145038168,1772,1686,1604,-86,-82,-168
h538,h,Other visual disturbances,Diseases of the eye and ear,795,683,738,-0.140880503,0.080527086,-0.071698113,574,619,592,45,-27,18
h539,h,Unspecified visual disturbance,Diseases of the eye and ear,506,413,424,-0.183794466,0.026634383,-0.162055336,795,878,877,83,-1,82
h543,h,"Unqualified visual loss, both eyes",Diseases of the eye and ear,147,117,142,-0.204081633,0.213675214,-0.034013605,1669,1832,1644,163,-188,-25
h5440,h,"Blindness, one eye, unspecified eye",Diseases of the eye and ear,157,154,167,-0.01910828,0.084415584,0.063694268,1607,1583,1503,-24,-80,-104
h54413a,h,"Blindness right eye category 3, normal vision left eye",Diseases of the eye and ear,16,12,16,-0.25,0.333333333,0,4844,5148,4726,304,-422,-118
h5461,h,"Unqualified visual loss, right eye, normal vision left eye",Diseases of the eye and ear,534,511,544,-0.043071161,0.064579256,0.018726592,766,760,742,-6,-18,-24
h5462,h,"Unqualified visual loss, left eye, normal vision right eye",Diseases of the eye and ear,559,523,485,-0.064400716,-0.072657744,-0.132379249,729,742,798,13,56,69
h547,h,Unspecified visual loss,Diseases of the eye and ear,996,883,887,-0.113453815,0.004530011,-0.109437751,474,495,506,21,11,32
h548,h,"Legal blindness, as defined in USA",Diseases of the eye and ear,842,838,749,-0.004750594,-0.106205251,-0.110451306,541,523,584,-18,61,43
h5500,h,Unspecified nystagmus,Diseases of the eye and ear,179,173,198,-0.033519553,0.144508671,0.106145251,1490,1473,1381,-17,-92,-109
h5501,h,Congenital nystagmus,Diseases of the eye and ear,13,22,26,0.692307692,0.181818182,1,5137,4164,3910,-973,-254,-1227
h5509,h,Other forms of nystagmus,Diseases of the eye and ear,89,76,86,-0.146067416,0.131578947,-0.033707865,2216,2306,2193,90,-113,-23
h5702,h,Anisocoria,Diseases of the eye and ear,112,114,136,0.017857143,0.192982456,0.214285714,1953,1848,1688,-105,-160,-265
h5703,h,Miosis,Diseases of the eye and ear,21,13,18,-0.380952381,0.384615385,-0.142857143,4392,5029,4528,637,-501,136
h5704,h,Mydriasis,Diseases of the eye and ear,79,101,99,0.278481013,-0.01980198,0.253164557,2371,1953,2026,-418,73,-345
h5711,h,"Ocular pain, right eye",Diseases of the eye and ear,53,46,55,-0.132075472,0.195652174,0.037735849,2898,2957,2756,59,-201,-142
h5712,h,"Ocular pain, left eye",Diseases of the eye and ear,57,47,68,-0.175438596,0.446808511,0.192982456,2813,2923,2475,110,-448,-338
h5713,h,"Ocular pain, bilateral",Diseases of the eye and ear,19,14,16,-0.263157895,0.142857143,-0.157894737,4561,4932,4714,371,-218,153
h5789,h,Other specified disorders of eye and adnexa,Diseases of the eye and ear,98,99,73,0.010204082,-0.262626263,-0.255102041,2100,1982,2388,-118,406,288
h579,h,Unspecified disorder of eye and adnexa,Diseases of the eye and ear,22,17,38,-0.227272727,1.235294118,0.727272727,4310,4632,3296,322,-1336,-1014
h6001,h,Abscess of right external ear,Diseases of the eye and ear,10,11,15,0.1,0.363636364,0.5,5353,5234,4812,-119,-422,-541
h6011,h,Cellulitis of right external ear,Diseases of the eye and ear,28,30,23,0.071428571,-0.233333333,-0.178571429,3895,3613,4117,-282,504,222
h6090,h,"Unspecified otitis externa, unspecified ear",Diseases of the eye and ear,23,31,27,0.347826087,-0.129032258,0.173913043,4231,3550,3842,-681,292,-389
h6091,h,"Unspecified otitis externa, right ear",Diseases of the eye and ear,49,60,50,0.224489796,-0.166666667,0.020408163,3009,2616,2890,-393,274,-119
h6092,h,"Unspecified otitis externa, left ear",Diseases of the eye and ear,42,40,29,-0.047619048,-0.275,-0.30952381,3228,3159,3721,-69,562,493
h6093,h,"Unspecified otitis externa, bilateral",Diseases of the eye and ear,15,16,10,0.066666667,-0.375,-0.333333333,4933,4724,5305,-209,581,372
h6120,h,"Impacted cerumen, unspecified ear",Diseases of the eye and ear,45,32,32,-0.288888889,0,-0.288888889,3124,3495,3573,371,78,449
h6121,h,"Impacted cerumen, right ear",Diseases of the eye and ear,49,47,29,-0.040816327,-0.382978723,-0.408163265,3009,2921,3720,-88,799,711
h6122,h,"Impacted cerumen, left ear",Diseases of the eye and ear,54,39,23,-0.277777778,-0.41025641,-0.574074074,2876,3190,4112,314,922,1236
h6123,h,"Impacted cerumen, bilateral",Diseases of the eye and ear,85,94,63,0.105882353,-0.329787234,-0.258823529,2272,2054,2573,-218,519,301
h6690,h,"Otitis media, unspecified, unspecified ear",Diseases of the eye and ear,199,190,106,-0.045226131,-0.442105263,-0.467336683,1413,1417,1943,4,526,530
h6691,h,"Otitis media, unspecified, right ear",Diseases of the eye and ear,187,249,102,0.331550802,-0.590361446,-0.454545455,1453,1190,1982,-263,792,529
h6692,h,"Otitis media, unspecified, left ear",Diseases of the eye and ear,207,208,105,0.004830918,-0.495192308,-0.492753623,1386,1338,1948,-48,610,562
h6693,h,"Otitis media, unspecified, bilateral",Diseases of the eye and ear,133,202,38,0.518796992,-0.811881188,-0.714285714,1745,1360,3291,-385,1931,1546
h70001,h,"Acute mastoiditis without complications, right ear",Diseases of the eye and ear,30,22,11,-0.266666667,-0.5,-0.633333333,3765,4146,5208,381,1062,1443
h70002,h,"Acute mastoiditis without complications, left ear",Diseases of the eye and ear,27,21,18,-0.222222222,-0.142857143,-0.333333333,3952,4241,4511,289,270,559
h7090,h,"Unspecified mastoiditis, unspecified ear",Diseases of the eye and ear,28,34,36,0.214285714,0.058823529,0.285714286,3884,3376,3351,-508,-25,-533
h7091,h,"Unspecified mastoiditis, right ear",Diseases of the eye and ear,41,41,40,0,-0.024390244,-0.024390244,3255,3116,3220,-139,104,-35
h7092,h,"Unspecified mastoiditis, left ear",Diseases of the eye and ear,33,42,27,0.272727273,-0.357142857,-0.181818182,3593,3076,3831,-517,755,238
h7093,h,"Unspecified mastoiditis, bilateral",Diseases of the eye and ear,33,32,37,-0.03030303,0.15625,0.121212121,3593,3485,3319,-108,-166,-274
h7291,h,"Unspecified perforation of tympanic membrane, right ear",Diseases of the eye and ear,16,23,14,0.4375,-0.391304348,-0.125,4812,4067,4890,-745,823,78
h73892,h,"Other specified disorders of tympanic membrane, left ear",Diseases of the eye and ear,16,19,19,0.1875,0,0.1875,4812,4416,4415,-396,-1,-397
h8109,h,"Meniere's disease, unspecified ear",Diseases of the eye and ear,207,190,155,-0.082125604,-0.184210526,-0.251207729,1386,1414,1563,28,149,177
h8110,h,"Benign paroxysmal vertigo, unspecified ear",Diseases of the eye and ear,391,251,263,-0.358056266,0.047808765,-0.327365729,918,1184,1177,266,-7,259
h81399,h,"Other peripheral vertigo, unspecified ear",Diseases of the eye and ear,31,20,19,-0.35483871,-0.05,-0.387096774,3697,4329,4413,632,84,716
h8309,h,"Labyrinthitis, unspecified ear",Diseases of the eye and ear,23,16,13,-0.304347826,-0.1875,-0.434782609,4212,4705,4996,493,291,784
h900,h,"Conductive hearing loss, bilateral",Diseases of the eye and ear,15,21,23,0.4,0.095238095,0.533333333,4913,4234,4101,-679,-133,-812
h902,h,"Conductive hearing loss, unspecified",Diseases of the eye and ear,31,28,24,-0.096774194,-0.142857143,-0.225806452,3697,3728,4038,31,310,341
h903,h,"Sensorineural hearing loss, bilateral",Diseases of the eye and ear,150,171,172,0.14,0.005847953,0.146666667,1639,1474,1476,-165,2,-163
h9041,h,"Sensorineural hearing loss, unilateral, right ear, with unrestricted hearing on the contralateral side",Diseases of the eye and ear,22,15,21,-0.318181818,0.4,-0.045454545,4286,4789,4250,503,-539,-36
h9042,h,"Sensorineural hearing loss, unilateral, left ear, with unrestricted hearing on the contralateral side",Diseases of the eye and ear,34,25,18,-0.264705882,-0.28,-0.470588235,3540,3912,4499,372,587,959
h905,h,Unspecified sensorineural hearing loss,Diseases of the eye and ear,194,187,182,-0.036082474,-0.026737968,-0.06185567,1425,1420,1438,-5,18,13
h906,h,"Mixed conductive and sensorineural hearing loss, bilateral",Diseases of the eye and ear,16,16,11,0,-0.3125,-0.3125,4803,4700,5191,-103,491,388
h9110,h,"Presbycusis, unspecified ear",Diseases of the eye and ear,40,47,60,0.175,0.276595745,0.5,3284,2912,2630,-372,-282,-654
h9113,h,"Presbycusis, bilateral",Diseases of the eye and ear,17,11,11,-0.352941176,0,-0.352941176,4710,5201,5190,491,-11,480
h913,h,"Deaf nonspeaking, not elsewhere classified",Diseases of the eye and ear,58,61,54,0.051724138,-0.114754098,-0.068965517,2780,2590,2773,-190,183,-7
h918x2,h,"Other specified hearing loss, left ear",Diseases of the eye and ear,14,15,10,0.071428571,-0.333333333,-0.285714286,4992,4784,5275,-208,491,283
h918x3,h,"Other specified hearing loss, bilateral",Diseases of the eye and ear,33,26,15,-0.212121212,-0.423076923,-0.545454545,3586,3852,4783,266,931,1197
h9190,h,"Unspecified hearing loss, unspecified ear",Diseases of the eye and ear,5485,4998,5832,-0.088787603,0.166866747,0.063263446,114,117,101,3,-16,-13
h9191,h,"Unspecified hearing loss, right ear",Diseases of the eye and ear,331,309,340,-0.066465257,0.100323625,0.027190332,1020,1046,1002,26,-44,-18
h9192,h,"Unspecified hearing loss, left ear",Diseases of the eye and ear,342,299,261,-0.125730994,-0.127090301,-0.236842105,1000,1067,1179,67,112,179
h9193,h,"Unspecified hearing loss, bilateral",Diseases of the eye and ear,804,697,747,-0.133084577,0.071736011,-0.070895522,563,606,584,43,-22,21
h9201,h,"Otalgia, right ear",Diseases of the eye and ear,101,81,97,-0.198019802,0.197530864,-0.03960396,2050,2217,2037,167,-180,-13
h9202,h,"Otalgia, left ear",Diseases of the eye and ear,112,94,82,-0.160714286,-0.127659574,-0.267857143,1941,2042,2235,101,193,294
h9203,h,"Otalgia, bilateral",Diseases of the eye and ear,31,33,29,0.064516129,-0.121212121,-0.064516129,3685,3418,3700,-267,282,15
h9209,h,"Otalgia, unspecified ear",Diseases of the eye and ear,29,28,22,-0.034482759,-0.214285714,-0.24137931,3806,3717,4166,-89,449,360
h9222,h,"Otorrhagia, left ear",Diseases of the eye and ear,14,11,12,-0.214285714,0.090909091,-0.142857143,4983,5190,5074,207,-116,91
h9311,h,"Tinnitus, right ear",Diseases of the eye and ear,39,28,25,-0.282051282,-0.107142857,-0.358974359,3323,3717,3941,394,224,618
h9312,h,"Tinnitus, left ear",Diseases of the eye and ear,24,20,28,-0.166666667,0.4,0.166666667,4117,4312,3765,195,-547,-352
h9313,h,"Tinnitus, bilateral",Diseases of the eye and ear,69,59,50,-0.144927536,-0.152542373,-0.275362319,2530,2620,2874,90,254,344
h9319,h,"Tinnitus, unspecified ear",Diseases of the eye and ear,252,191,224,-0.242063492,0.172774869,-0.111111111,1217,1403,1280,186,-123,63
i00,i,Rheumatic fever without heart involvement,Diseases of the circulatory system,17,21,12,0.235294118,-0.428571429,-0.294117647,4696,4216,5070,-480,854,374
i050,i,Rheumatic mitral stenosis,Diseases of the circulatory system,204,173,155,-0.151960784,-0.104046243,-0.240196078,1391,1461,1555,70,94,164
i051,i,Rheumatic mitral insufficiency,Diseases of the circulatory system,12,12,13,0,0.083333333,0.083333333,5156,5083,4974,-73,-109,-182
i052,i,Rheumatic mitral stenosis with insufficiency,Diseases of the circulatory system,70,57,42,-0.185714286,-0.263157895,-0.4,2510,2662,3137,152,475,627
i059,i,"Rheumatic mitral valve disease, unspecified",Diseases of the circulatory system,111,106,105,-0.045045045,-0.009433962,-0.054054054,1946,1889,1938,-57,49,-8
i060,i,Rheumatic aortic stenosis,Diseases of the circulatory system,13,12,14,-0.076923077,0.166666667,0.076923077,5074,5081,4862,7,-219,-212
i071,i,Rheumatic tricuspid insufficiency,Diseases of the circulatory system,1256,1231,1201,-0.019904459,-0.024370431,-0.043789809,401,387,402,-14,15,1
i079,i,"Rheumatic tricuspid valve disease, unspecified",Diseases of the circulatory system,38,26,26,-0.315789474,0,-0.315789474,3352,3837,3869,485,32,517
i080,i,Rheumatic disorders of both mitral and aortic valves,Diseases of the circulatory system,1032,979,946,-0.051356589,-0.033707865,-0.083333333,458,463,476,5,13,18
i081,i,Rheumatic disorders of both mitral and tricuspid valves,Diseases of the circulatory system,1495,1517,1338,0.014715719,-0.117996045,-0.105016722,354,336,371,-18,35,17
i082,i,Rheumatic disorders of both aortic and tricuspid valves,Diseases of the circulatory system,237,233,204,-0.016877637,-0.124463519,-0.139240506,1264,1233,1347,-31,114,83
i083,i,"Combined rheumatic disorders of mitral, aortic and tricuspid valves",Diseases of the circulatory system,935,863,766,-0.077005348,-0.11239861,-0.180748663,492,499,569,7,70,77
i088,i,Other rheumatic multiple valve diseases,Diseases of the circulatory system,85,86,53,0.011764706,-0.38372093,-0.376470588,2250,2137,2778,-113,641,528
i089,i,"Rheumatic multiple valve disease, unspecified",Diseases of the circulatory system,15,20,13,0.333333333,-0.35,-0.133333333,4880,4299,4964,-581,665,84
i099,i,"Rheumatic heart disease, unspecified",Diseases of the circulatory system,28,14,18,-0.5,0.285714286,-0.357142857,3850,4870,4474,1020,-396,624
i10,i,Essential (primary) hypertension,Diseases of the circulatory system,103037,96804,102006,-0.060492833,0.053737449,-0.010006114,1,1,1,0,0,0
i110,i,Hypertensive heart disease with heart failure,Diseases of the circulatory system,16747,17829,16627,0.064608587,-0.067418251,-0.007165462,24,21,24,-3,3,0
i119,i,Hypertensive heart disease without heart failure,Diseases of the circulatory system,1353,1368,1134,0.011086475,-0.171052632,-0.161862528,374,366,415,-8,49,41
i120,i,Hypertensive chronic kidney disease with stage 5 chronic kidney disease or end stage renal disease,Diseases of the circulatory system,6147,5767,6173,-0.061818773,0.070400555,0.004229706,90,98,90,8,-8,0
i129,i,"Hypertensive chronic kidney disease with stage 1 through stage 4 chronic kidney disease, or unspecified chronic kidney disease",Diseases of the circulatory system,19798,18262,19356,-0.077583594,0.059905815,-0.022325487,18,19,19,1,0,1
i130,i,"Hypertensive heart and chronic kidney disease with heart failure and stage 1 through stage 4 chronic kidney disease, or unspecified chronic kidney disease",Diseases of the circulatory system,11314,11560,11023,0.021742973,-0.046453287,-0.025720346,39,37,41,-2,4,2
i1310,i,"Hypertensive heart and chronic kidney disease without heart failure, with stage 1 through stage 4 chronic kidney disease, or unspecified chronic kidney disease",Diseases of the circulatory system,550,532,496,-0.032727273,-0.067669173,-0.098181818,726,718,771,-8,53,45
i1311,i,"Hypertensive heart and chronic kidney disease without heart failure, with stage 5 chronic kidney disease, or end stage renal disease",Diseases of the circulatory system,142,208,154,0.464788732,-0.259615385,0.084507042,1662,1321,1550,-341,229,-112
i132,i,"Hypertensive heart and chronic kidney disease with heart failure and with stage 5 chronic kidney disease, or end stage renal disease",Diseases of the circulatory system,3530,3672,3599,0.040226629,-0.019880174,0.019546742,157,154,163,-3,9,6
i150,i,Renovascular hypertension,Diseases of the circulatory system,60,31,40,-0.483333333,0.290322581,-0.333333333,2692,3503,3188,811,-315,496
i151,i,Hypertension secondary to other renal disorders,Diseases of the circulatory system,102,98,108,-0.039215686,0.102040816,0.058823529,2018,1966,1900,-52,-66,-118
i152,i,Hypertension secondary to endocrine disorders,Diseases of the circulatory system,35,28,39,-0.2,0.392857143,0.114285714,3460,3695,3222,235,-473,-238
i158,i,Other secondary hypertension,Diseases of the circulatory system,195,234,167,0.2,-0.286324786,-0.143589744,1398,1215,1477,-183,262,79
i159,i,"Secondary hypertension, unspecified",Diseases of the circulatory system,133,103,132,-0.22556391,0.281553398,-0.007518797,1720,1901,1692,181,-209,-28
i160,i,Hypertensive urgency,Diseases of the circulatory system,4162,4249,4412,0.020903412,0.038361968,0.060067275,137,135,137,-2,2,0
i161,i,Hypertensive emergency,Diseases of the circulatory system,2453,2478,2568,0.010191602,0.036319613,0.04688137,220,213,205,-7,-8,-15
i169,i,"Hypertensive crisis, unspecified",Diseases of the circulatory system,339,331,399,-0.02359882,0.205438066,0.17699115,987,986,885,-1,-101,-102
i200,i,Unstable angina,Diseases of the circulatory system,218,187,206,-0.142201835,0.101604278,-0.055045872,1312,1397,1326,85,-71,14
i201,i,Angina pectoris with documented spasm,Diseases of the circulatory system,28,32,38,0.142857143,0.1875,0.357142857,3832,3445,3249,-387,-196,-583
i208,i,Other forms of angina pectoris,Diseases of the circulatory system,62,32,46,-0.483870968,0.4375,-0.258064516,2653,3445,2973,792,-472,320
i209,i,"Angina pectoris, unspecified",Diseases of the circulatory system,176,143,139,-0.1875,-0.027972028,-0.210227273,1477,1604,1631,127,27,154
i2102,i,ST elevation (STEMI) myocardial infarction involving left anterior descending coronary artery,Diseases of the circulatory system,122,133,150,0.090163934,0.127819549,0.229508197,1812,1673,1567,-139,-106,-245
i2109,i,ST elevation (STEMI) myocardial infarction involving other coronary artery of anterior wall,Diseases of the circulatory system,364,372,323,0.021978022,-0.13172043,-0.112637363,945,906,1013,-39,107,68
i2111,i,ST elevation (STEMI) myocardial infarction involving right coronary artery,Diseases of the circulatory system,116,80,108,-0.310344828,0.35,-0.068965517,1874,2203,1891,329,-312,17
i2119,i,ST elevation (STEMI) myocardial infarction involving other coronary artery of inferior wall,Diseases of the circulatory system,573,560,528,-0.022687609,-0.057142857,-0.078534031,695,689,738,-6,49,43
i2121,i,ST elevation (STEMI) myocardial infarction involving left circumflex coronary artery,Diseases of the circulatory system,12,16,17,0.333333333,0.0625,0.416666667,5119,4648,4542,-471,-106,-577
i2129,i,ST elevation (STEMI) myocardial infarction involving other sites,Diseases of the circulatory system,101,84,88,-0.168316832,0.047619048,-0.128712871,2020,2144,2125,124,-19,105
i213,i,ST elevation (STEMI) myocardial infarction of unspecified site,Diseases of the circulatory system,484,616,590,0.272727273,-0.042207792,0.219008264,793,648,673,-145,25,-120
i214,i,Non-ST elevation (NSTEMI) myocardial infarction,Diseases of the circulatory system,4715,4919,4826,0.043266172,-0.018906282,0.023541888,123,114,127,-9,13,4
i219,i,"Acute myocardial infarction, unspecified",Diseases of the circulatory system,137,114,97,-0.167883212,-0.149122807,-0.291970803,1686,1809,2006,123,197,320
i21a1,i,Myocardial infarction type 2,Diseases of the circulatory system,2688,3438,3989,0.279017857,0.160267597,0.484002976,198,155,150,-43,-5,-48
i21a9,i,Other myocardial infarction type,Diseases of the circulatory system,40,62,55,0.55,-0.112903226,0.375,3238,2528,2705,-710,177,-533
i222,i,Subsequent non-ST elevation (NSTEMI) myocardial infarction,Diseases of the circulatory system,23,20,18,-0.130434783,-0.1,-0.217391304,4151,4268,4443,117,175,292
i236,i,"Thrombosis of atrium, auricular appendage, and ventricle as current complications following acute myocardial infarction",Diseases of the circulatory system,14,20,18,0.428571429,-0.1,0.285714286,4934,4268,4443,-666,175,-491
i237,i,Postinfarction angina,Diseases of the circulatory system,33,30,16,-0.090909091,-0.466666667,-0.515151515,3537,3544,4626,7,1082,1089
i240,i,Acute coronary thrombosis not resulting in myocardial infarction,Diseases of the circulatory system,44,30,46,-0.318181818,0.533333333,0.045454545,3104,3544,2962,440,-582,-142
i241,i,Dressler's syndrome,Diseases of the circulatory system,30,36,27,0.2,-0.25,-0.1,3700,3248,3773,-452,525,73
i248,i,Other forms of acute ischemic heart disease,Diseases of the circulatory system,2364,2723,3202,0.151861252,0.175908924,0.354483926,228,194,172,-34,-22,-56
i249,i,"Acute ischemic heart disease, unspecified",Diseases of the circulatory system,463,414,557,-0.105831533,0.345410628,0.203023758,816,851,704,35,-147,-112
i2510,i,Atherosclerotic heart disease of native coronary artery without angina pectoris,Diseases of the circulatory system,47685,46927,44886,-0.015895984,-0.043493085,-0.058697704,6,4,8,-2,4,2
i25110,i,Atherosclerotic heart disease of native coronary artery with unstable angina pectoris,Diseases of the circulatory system,1621,1454,1420,-0.103022825,-0.023383769,-0.123997532,312,337,348,25,11,36
i25111,i,Atherosclerotic heart disease of native coronary artery with angina pectoris with documented spasm,Diseases of the circulatory system,31,50,35,0.612903226,-0.3,0.129032258,3636,2772,3347,-864,575,-289
i25118,i,Atherosclerotic heart disease of native coronary artery with other forms of angina pectoris,Diseases of the circulatory system,501,447,489,-0.107784431,0.093959732,-0.023952096,772,813,767,41,-46,-5
i25119,i,Atherosclerotic heart disease of native coronary artery with unspecified angina pectoris,Diseases of the circulatory system,1381,1204,1064,-0.128167994,-0.11627907,-0.229543809,358,379,428,21,49,70
i252,i,Old myocardial infarction,Diseases of the circulatory system,14706,13407,13097,-0.088331293,-0.02312225,-0.109411125,26,29,33,3,4,7
i253,i,Aneurysm of heart,Diseases of the circulatory system,99,105,124,0.060606061,0.180952381,0.252525253,2026,1865,1738,-161,-127,-288
i2541,i,Coronary artery aneurysm,Diseases of the circulatory system,46,37,35,-0.195652174,-0.054054054,-0.239130435,3024,3201,3343,177,142,319
i2542,i,Coronary artery dissection,Diseases of the circulatory system,79,81,90,0.025316456,0.111111111,0.139240506,2312,2174,2091,-138,-83,-221
i255,i,Ischemic cardiomyopathy,Diseases of the circulatory system,6785,6455,6102,-0.048636699,-0.05468629,-0.100663228,73,78,87,5,9,14
i25700,i,"Atherosclerosis of coronary artery bypass graft(s), unspecified, with unstable angina pectoris",Diseases of the circulatory system,14,18,14,0.285714286,-0.222222222,0,4919,4422,4805,-497,383,-114
i25710,i,Atherosclerosis of autologous vein coronary artery bypass graft(s) with unstable angina pectoris,Diseases of the circulatory system,64,43,50,-0.328125,0.162790698,-0.21875,2592,2978,2828,386,-150,236
i25719,i,Atherosclerosis of autologous vein coronary artery bypass graft(s) with unspecified angina pectoris,Diseases of the circulatory system,14,21,20,0.5,-0.047619048,0.428571429,4918,4159,4249,-759,90,-669
i25810,i,Atherosclerosis of coronary artery bypass graft(s) without angina pectoris,Diseases of the circulatory system,525,555,529,0.057142857,-0.046846847,0.007619048,748,682,727,-66,45,-21
i25811,i,Atherosclerosis of native coronary artery of transplanted heart without angina pectoris,Diseases of the circulatory system,28,19,14,-0.321428571,-0.263157895,-0.5,3803,4330,4802,527,472,999
i2582,i,Chronic total occlusion of coronary artery,Diseases of the circulatory system,975,862,838,-0.115897436,-0.027842227,-0.140512821,459,482,500,23,18,41
i2583,i,Coronary atherosclerosis due to lipid rich plaque,Diseases of the circulatory system,61,47,47,-0.229508197,0,-0.229508197,2648,2854,2918,206,64,270
i2584,i,Coronary atherosclerosis due to calcified coronary lesion,Diseases of the circulatory system,380,385,400,0.013157895,0.038961039,0.052631579,904,872,868,-32,-4,-36
i2589,i,Other forms of chronic ischemic heart disease,Diseases of the circulatory system,16,13,19,-0.1875,0.461538462,0.1875,4722,4905,4333,183,-572,-389
i259,i,"Chronic ischemic heart disease, unspecified",Diseases of the circulatory system,114,89,80,-0.219298246,-0.101123596,-0.298245614,1877,2053,2218,176,165,341
i2602,i,Saddle embolus of pulmonary artery with acute cor pulmonale,Diseases of the circulatory system,36,63,46,0.75,-0.26984127,0.277777778,3379,2491,2946,-888,455,-433
i2609,i,Other pulmonary embolism with acute cor pulmonale,Diseases of the circulatory system,130,130,142,0,0.092307692,0.092307692,1718,1675,1592,-43,-83,-126
i2690,i,Septic pulmonary embolism without acute cor pulmonale,Diseases of the circulatory system,176,178,136,0.011363636,-0.235955056,-0.227272727,1461,1411,1640,-50,229,179
i2692,i,Saddle embolus of pulmonary artery without acute cor pulmonale,Diseases of the circulatory system,165,159,281,-0.036363636,0.767295597,0.703030303,1508,1493,1096,-15,-397,-412
i2693,i,Single subsegmental pulmonary embolism without acute cor pulmonale,Diseases of the circulatory system,57,150,278,1.631578947,0.853333333,3.877192982,2738,1542,1103,-1196,-439,-1635
i2694,i,Multiple subsegmental pulmonary emboli without acute cor pulmonale,Diseases of the circulatory system,51,121,215,1.37254902,0.776859504,3.215686275,2882,1739,1268,-1143,-471,-1614
i2699,i,Other pulmonary embolism without acute cor pulmonale,Diseases of the circulatory system,3343,3156,4198,-0.05593778,0.330164766,0.255758301,159,165,138,6,-27,-21
i270,i,Primary pulmonary hypertension,Diseases of the circulatory system,73,71,67,-0.02739726,-0.056338028,-0.082191781,2407,2324,2420,-83,96,13
i2720,i,"Pulmonary hypertension, unspecified",Diseases of the circulatory system,9122,9436,7984,0.034422276,-0.153878762,-0.124753344,50,49,59,-1,10,9
i2721,i,Secondary pulmonary arterial hypertension,Diseases of the circulatory system,647,690,580,0.066460587,-0.15942029,-0.103554869,630,584,672,-46,88,42
i2722,i,Pulmonary hypertension due to left heart disease,Diseases of the circulatory system,600,327,306,-0.455,-0.064220183,-0.49,655,973,1033,318,60,378
i2723,i,Pulmonary hypertension due to lung diseases and hypoxia,Diseases of the circulatory system,232,252,210,0.086206897,-0.166666667,-0.094827586,1244,1142,1288,-102,146,44
i2724,i,Chronic thromboembolic pulmonary hypertension,Diseases of the circulatory system,65,59,59,-0.092307692,0,-0.092307692,2556,2558,2588,2,30,32
i2729,i,Other secondary pulmonary hypertension,Diseases of the circulatory system,898,821,793,-0.085746102,-0.03410475,-0.116926503,482,503,531,21,28,49
i2781,i,Cor pulmonale (chronic),Diseases of the circulatory system,587,594,464,0.011925043,-0.218855219,-0.209540034,668,646,789,-22,143,121
i2782,i,Chronic pulmonary embolism,Diseases of the circulatory system,307,341,365,0.110749186,0.070381232,0.188925081,1049,945,919,-104,-26,-130
i288,i,Other diseases of pulmonary vessels,Diseases of the circulatory system,23,21,26,-0.086956522,0.238095238,0.130434783,4113,4138,3797,25,-341,-316
i301,i,Infective pericarditis,Diseases of the circulatory system,23,16,13,-0.304347826,-0.1875,-0.434782609,4113,4599,4887,486,288,774
i308,i,Other forms of acute pericarditis,Diseases of the circulatory system,10,12,13,0.2,0.083333333,0.3,5211,4995,4887,-216,-108,-324
i309,i,"Acute pericarditis, unspecified",Diseases of the circulatory system,108,106,152,-0.018518519,0.433962264,0.407407407,1918,1838,1530,-80,-308,-388
i310,i,Chronic adhesive pericarditis,Diseases of the circulatory system,38,32,44,-0.157894737,0.375,0.157894737,3284,3398,2997,114,-401,-287
i311,i,Chronic constrictive pericarditis,Diseases of the circulatory system,33,28,46,-0.151515152,0.642857143,0.393939394,3501,3637,2930,136,-707,-571
i312,i,"Hemopericardium, not elsewhere classified",Diseases of the circulatory system,67,42,52,-0.373134328,0.238095238,-0.223880597,2512,2992,2751,480,-241,239
i313,i,Pericardial effusion (noninflammatory),Diseases of the circulatory system,1938,1942,1919,0.002063983,-0.01184346,-0.009803922,262,251,268,-11,17,6
i314,i,Cardiac tamponade,Diseases of the circulatory system,269,260,244,-0.033457249,-0.061538462,-0.092936803,1132,1118,1183,-14,65,51
i318,i,Other specified diseases of pericardium,Diseases of the circulatory system,17,17,15,0,-0.117647059,-0.117647059,4607,4497,4680,-110,183,73
i319,i,"Disease of pericardium, unspecified",Diseases of the circulatory system,213,218,230,0.023474178,0.055045872,0.079812207,1309,1258,1220,-51,-38,-89
i32,i,Pericarditis in diseases classified elsewhere,Diseases of the circulatory system,16,16,13,0,-0.1875,-0.1875,4695,4591,4879,-104,288,184
i330,i,Acute and subacute infective endocarditis,Diseases of the circulatory system,651,640,619,-0.016897081,-0.0328125,-0.049155146,624,612,638,-12,26,14
i339,i,"Acute and subacute endocarditis, unspecified",Diseases of the circulatory system,31,24,35,-0.225806452,0.458333333,0.129032258,3599,3884,3311,285,-573,-288
i340,i,Nonrheumatic mitral (valve) insufficiency,Diseases of the circulatory system,4018,3829,3528,-0.047038328,-0.078610603,-0.12195122,137,141,156,4,15,19
i341,i,Nonrheumatic mitral (valve) prolapse,Diseases of the circulatory system,711,663,663,-0.067510549,0,-0.067510549,588,596,601,8,5,13
i342,i,Nonrheumatic mitral (valve) stenosis,Diseases of the circulatory system,97,103,72,0.06185567,-0.300970874,-0.257731959,2033,1857,2323,-176,466,290
i348,i,Other nonrheumatic mitral valve disorders,Diseases of the circulatory system,42,47,62,0.119047619,0.319148936,0.476190476,3128,2828,2511,-300,-317,-617
i350,i,Nonrheumatic aortic (valve) stenosis,Diseases of the circulatory system,4073,3980,3503,-0.022833292,-0.119849246,-0.139945986,134,136,157,2,21,23
i351,i,Nonrheumatic aortic (valve) insufficiency,Diseases of the circulatory system,1106,975,936,-0.118444846,-0.04,-0.153707052,410,442,455,32,13,45
i352,i,Nonrheumatic aortic (valve) stenosis with insufficiency,Diseases of the circulatory system,326,327,254,0.003067485,-0.22324159,-0.220858896,990,964,1153,-26,189,163
i358,i,Other nonrheumatic aortic valve disorders,Diseases of the circulatory system,399,377,340,-0.055137845,-0.098143236,-0.147869674,868,873,959,5,86,91
i359,i,"Nonrheumatic aortic valve disorder, unspecified",Diseases of the circulatory system,65,69,83,0.061538462,0.202898551,0.276923077,2540,2344,2148,-196,-196,-392
i361,i,Nonrheumatic tricuspid (valve) insufficiency,Diseases of the circulatory system,611,624,576,0.021276596,-0.076923077,-0.057283142,642,618,668,-24,50,26
i370,i,Nonrheumatic pulmonary valve stenosis,Diseases of the circulatory system,25,22,23,-0.12,0.045454545,-0.08,3951,4024,3988,73,-36,37
i371,i,Nonrheumatic pulmonary valve insufficiency,Diseases of the circulatory system,158,151,131,-0.044303797,-0.132450331,-0.170886076,1523,1519,1653,-4,134,130
i38,i,"Endocarditis, valve unspecified",Diseases of the circulatory system,190,192,153,0.010526316,-0.203125,-0.194736842,1379,1344,1510,-35,166,131
i400,i,Infective myocarditis,Diseases of the circulatory system,23,36,44,0.565217391,0.222222222,0.913043478,4091,3196,2979,-895,-217,-1112
i420,i,Dilated cardiomyopathy,Diseases of the circulatory system,2220,2181,2318,-0.017567568,0.062815222,0.044144144,232,223,220,-9,-3,-12
i421,i,Obstructive hypertrophic cardiomyopathy,Diseases of the circulatory system,195,181,184,-0.071794872,0.016574586,-0.056410256,1358,1378,1372,20,-6,14
i422,i,Other hypertrophic cardiomyopathy,Diseases of the circulatory system,218,233,250,0.068807339,0.072961373,0.146788991,1277,1185,1159,-92,-26,-118
i424,i,Endocardial fibroelastosis,Diseases of the circulatory system,18,16,13,-0.111111111,-0.1875,-0.277777778,4504,4572,4860,68,288,356
i425,i,Other restrictive cardiomyopathy,Diseases of the circulatory system,56,49,43,-0.125,-0.12244898,-0.232142857,2720,2754,3010,34,256,290
i426,i,Alcoholic cardiomyopathy,Diseases of the circulatory system,191,213,207,0.115183246,-0.028169014,0.083769634,1374,1261,1282,-113,21,-92
i427,i,Cardiomyopathy due to drug and external agent,Diseases of the circulatory system,327,324,361,-0.009174312,0.114197531,0.103975535,984,968,922,-16,-46,-62
i428,i,Other cardiomyopathies,Diseases of the circulatory system,1765,2895,2807,0.640226629,-0.030397237,0.590368272,285,176,178,-109,2,-107
i429,i,"Cardiomyopathy, unspecified",Diseases of the circulatory system,6184,5346,4961,-0.135510996,-0.072016461,-0.197768435,83,101,117,18,16,34
i43,i,Cardiomyopathy in diseases classified elsewhere,Diseases of the circulatory system,270,274,262,0.014814815,-0.04379562,-0.02962963,1117,1073,1122,-44,49,5
i440,i,"Atrioventricular block, first degree",Diseases of the circulatory system,1646,1540,1660,-0.064398542,0.077922078,0.008505468,301,308,295,7,-13,-6
i441,i,"Atrioventricular block, second degree",Diseases of the circulatory system,710,721,801,0.015492958,0.110957004,0.128169014,582,551,519,-31,-32,-63
i442,i,"Atrioventricular block, complete",Diseases of the circulatory system,1267,1287,1284,0.01578532,-0.002331002,0.013417522,370,355,360,-15,5,-10
i4430,i,Unspecified atrioventricular block,Diseases of the circulatory system,218,205,184,-0.059633028,-0.102439024,-0.155963303,1270,1285,1363,15,78,93
i4439,i,Other atrioventricular block,Diseases of the circulatory system,25,33,27,0.32,-0.181818182,0.08,3936,3313,3704,-623,391,-232
i444,i,Left anterior fascicular block,Diseases of the circulatory system,333,345,325,0.036036036,-0.057971014,-0.024024024,962,921,973,-41,52,11
i445,i,Left posterior fascicular block,Diseases of the circulatory system,18,32,22,0.777777778,-0.3125,0.222222222,4492,3365,4046,-1127,681,-446
i447,i,"Left bundle-branch block, unspecified",Diseases of the circulatory system,2967,2940,2787,-0.009100101,-0.052040816,-0.060667341,169,172,177,3,5,8
i4510,i,Unspecified right bundle-branch block,Diseases of the circulatory system,2892,2828,2926,-0.022130014,0.034653465,0.01175657,177,179,174,2,-5,-3
i4519,i,Other right bundle-branch block,Diseases of the circulatory system,74,79,92,0.067567568,0.164556962,0.243243243,2350,2148,2009,-202,-139,-341
i452,i,Bifascicular block,Diseases of the circulatory system,690,777,786,0.126086957,0.011583012,0.139130435,596,515,525,-81,10,-71
i453,i,Trifascicular block,Diseases of the circulatory system,49,44,40,-0.102040816,-0.090909091,-0.183673469,2887,2900,3097,13,197,210
i454,i,Nonspecific intraventricular block,Diseases of the circulatory system,96,92,83,-0.041666667,-0.097826087,-0.135416667,2024,1978,2128,-46,150,104
i455,i,Other specified heart block,Diseases of the circulatory system,86,92,97,0.069767442,0.054347826,0.127906977,2149,1978,1950,-171,-28,-199
i456,i,Pre-excitation syndrome,Diseases of the circulatory system,184,163,164,-0.114130435,0.006134969,-0.108695652,1385,1439,1437,54,-2,52
i4581,i,Long QT syndrome,Diseases of the circulatory system,1557,552,286,-0.645472062,-0.481884058,-0.816313423,312,664,1055,352,391,743
i4589,i,Other specified conduction disorders,Diseases of the circulatory system,114,111,138,-0.026315789,0.243243243,0.210526316,1835,1767,1580,-68,-187,-255
i459,i,"Conduction disorder, unspecified",Diseases of the circulatory system,209,188,190,-0.100478469,0.010638298,-0.090909091,1308,1339,1333,31,-6,25
i462,i,Cardiac arrest due to underlying cardiac condition,Diseases of the circulatory system,369,361,532,-0.021680217,0.473684211,0.441734417,898,886,702,-12,-184,-196
i468,i,Cardiac arrest due to other underlying condition,Diseases of the circulatory system,322,398,521,0.236024845,0.309045226,0.618012422,983,835,710,-148,-125,-273
i469,i,"Cardiac arrest, cause unspecified",Diseases of the circulatory system,1611,1995,2557,0.238361266,0.281704261,0.587212911,301,238,191,-63,-47,-110
i471,i,Supraventricular tachycardia,Diseases of the circulatory system,4036,3889,4149,-0.0364222,0.066855233,0.027998018,134,138,137,4,-1,3
i472,i,Ventricular tachycardia,Diseases of the circulatory system,4490,4487,4787,-0.000668151,0.066859817,0.066146993,122,121,124,-1,3,2
i479,i,"Paroxysmal tachycardia, unspecified",Diseases of the circulatory system,55,37,36,-0.327272727,-0.027027027,-0.345454545,2724,3129,3211,405,82,487
i480,i,Paroxysmal atrial fibrillation,Diseases of the circulatory system,18570,17896,17545,-0.0362951,-0.019613321,-0.055196554,18,18,20,0,2,2
i4811,i,Longstanding persistent atrial fibrillation,Diseases of the circulatory system,86,210,312,1.441860465,0.485714286,2.627906977,2139,1253,993,-886,-260,-1146
i4819,i,Other persistent atrial fibrillation,Diseases of the circulatory system,1154,2184,2017,0.89254766,-0.076465201,0.747833622,383,215,245,-168,30,-138
i4820,i,"Chronic atrial fibrillation, unspecified",Diseases of the circulatory system,3980,7713,6972,0.937939698,-0.096071567,0.751758794,134,58,69,-76,11,-65
i4821,i,Permanent atrial fibrillation,Diseases of the circulatory system,699,1456,1370,1.08297568,-0.059065934,0.959942775,580,317,337,-263,20,-243
i483,i,Typical atrial flutter,Diseases of the circulatory system,194,218,212,0.12371134,-0.027522936,0.092783505,1340,1227,1239,-113,12,-101
i484,i,Atypical atrial flutter,Diseases of the circulatory system,192,180,196,-0.0625,0.088888889,0.020833333,1347,1353,1300,6,-53,-47
i4891,i,Unspecified atrial fibrillation,Diseases of the circulatory system,17549,16715,16298,-0.047524075,-0.024947652,-0.071286113,18,20,24,2,4,6
i4892,i,Unspecified atrial flutter,Diseases of the circulatory system,4085,4081,4097,-0.000979192,0.003920608,0.002937576,129,129,136,0,7,7
i4901,i,Ventricular fibrillation,Diseases of the circulatory system,818,838,897,0.024449878,0.070405728,0.096577017,508,478,456,-30,-22,-52
i491,i,Atrial premature depolarization,Diseases of the circulatory system,463,457,509,-0.012958963,0.113785558,0.099352052,775,762,714,-13,-48,-61
i493,i,Ventricular premature depolarization,Diseases of the circulatory system,2681,2644,2772,-0.013800821,0.048411498,0.033942559,182,179,170,-3,-9,-12
i4949,i,Other premature depolarization,Diseases of the circulatory system,21,25,22,0.19047619,-0.12,0.047619048,4195,3753,4017,-442,264,-178
i495,i,Sick sinus syndrome,Diseases of the circulatory system,3114,3045,3062,-0.022157996,0.005582923,-0.01669878,159,161,164,2,3,5
i498,i,Other specified cardiac arrhythmias,Diseases of the circulatory system,447,468,571,0.046979866,0.22008547,0.277404922,791,745,653,-46,-92,-138
i499,i,"Cardiac arrhythmia, unspecified",Diseases of the circulatory system,445,384,415,-0.137078652,0.080729167,-0.06741573,793,836,819,43,-17,26
i501,i,"Left ventricular failure, unspecified",Diseases of the circulatory system,136,111,99,-0.183823529,-0.108108108,-0.272058824,1618,1746,1904,128,158,286
i5020,i,Unspecified systolic (congestive) heart failure,Diseases of the circulatory system,1037,1142,1093,0.101253616,-0.04290718,0.054001929,413,365,388,-48,23,-25
i5021,i,Acute systolic (congestive) heart failure,Diseases of the circulatory system,1847,2093,2034,0.133188955,-0.028189202,0.101245263,260,223,238,-37,15,-22
i5022,i,Chronic systolic (congestive) heart failure,Diseases of the circulatory system,5689,5853,5879,0.028827562,0.004442166,0.033397785,95,84,88,-11,4,-7
i5023,i,Acute on chronic systolic (congestive) heart failure,Diseases of the circulatory system,6125,6771,6331,0.105469388,-0.064983016,0.033632653,81,69,78,-12,9,-3
i5030,i,Unspecified diastolic (congestive) heart failure,Diseases of the circulatory system,1549,1638,1433,0.057456423,-0.125152625,-0.074887024,302,278,320,-24,42,18
i5031,i,Acute diastolic (congestive) heart failure,Diseases of the circulatory system,1347,1445,1258,0.072754269,-0.129411765,-0.066072754,337,310,351,-27,41,14
i5032,i,Chronic diastolic (congestive) heart failure,Diseases of the circulatory system,5629,6075,5938,0.079232546,-0.02255144,0.054894297,95,79,86,-16,7,-9
i5033,i,Acute on chronic diastolic (congestive) heart failure,Diseases of the circulatory system,5550,6091,5200,0.097477477,-0.146281399,-0.063063063,98,78,105,-20,27,7
i5040,i,Unspecified combined systolic (congestive) and diastolic (congestive) heart failure,Diseases of the circulatory system,110,137,115,0.245454545,-0.160583942,0.045454545,1842,1557,1738,-285,181,-104
i5041,i,Acute combined systolic (congestive) and diastolic (congestive) heart failure,Diseases of the circulatory system,409,393,373,-0.039119804,-0.050890585,-0.08801956,820,818,867,-2,49,47
i5042,i,Chronic combined systolic (congestive) and diastolic (congestive) heart failure,Diseases of the circulatory system,1500,1482,1503,-0.012,0.01417004,0.002,311,299,301,-12,2,-10
i5043,i,Acute on chronic combined systolic (congestive) and diastolic (congestive) heart failure,Diseases of the circulatory system,3139,3141,2699,0.000637146,-0.140719516,-0.140172029,153,151,171,-2,20,18
i50810,i,"Right heart failure, unspecified",Diseases of the circulatory system,351,344,302,-0.01994302,-0.122093023,-0.13960114,903,890,990,-13,100,87
i50811,i,Acute right heart failure,Diseases of the circulatory system,97,75,84,-0.226804124,0.12,-0.134020619,1973,2166,2076,193,-90,103
i50812,i,Chronic right heart failure,Diseases of the circulatory system,73,97,99,0.328767123,0.020618557,0.356164384,2327,1874,1891,-453,17,-436
i50813,i,Acute on chronic right heart failure,Diseases of the circulatory system,126,132,140,0.047619048,0.060606061,0.111111111,1681,1591,1526,-90,-65,-155
i50814,i,Right heart failure due to left heart failure,Diseases of the circulatory system,37,31,24,-0.162162162,-0.225806452,-0.351351351,3237,3363,3859,126,496,622
i5082,i,Biventricular heart failure,Diseases of the circulatory system,622,632,645,0.01607717,0.02056962,0.036977492,606,583,579,-23,-4,-27
i5083,i,High output heart failure,Diseases of the circulatory system,33,22,24,-0.333333333,0.090909091,-0.272727273,3419,3953,3858,534,-95,439
i5084,i,End stage heart failure,Diseases of the circulatory system,357,303,293,-0.151260504,-0.0330033,-0.179271709,889,970,1010,81,40,121
i5089,i,Other heart failure,Diseases of the circulatory system,19,15,15,-0.210526316,0,-0.210526316,4342,4587,4593,245,6,251
i509,i,"Heart failure, unspecified",Diseases of the circulatory system,10019,9430,8974,-0.058788302,-0.04835631,-0.104301827,41,47,47,6,0,6
i510,i,"Cardiac septal defect, acquired",Diseases of the circulatory system,23,14,33,-0.391304348,1.357142857,0.434782609,4022,4696,3334,674,-1362,-688
i511,i,"Rupture of chordae tendineae, not elsewhere classified",Diseases of the circulatory system,43,49,37,0.139534884,-0.244897959,-0.139534884,3021,2694,3146,-327,452,125
i513,i,"Intracardiac thrombosis, not elsewhere classified",Diseases of the circulatory system,517,568,601,0.098646035,0.058098592,0.162475822,704,626,610,-78,-16,-94
i514,i,"Myocarditis, unspecified",Diseases of the circulatory system,43,52,68,0.209302326,0.307692308,0.581395349,3020,2623,2320,-397,-303,-700
i517,i,Cardiomegaly,Diseases of the circulatory system,592,617,568,0.04222973,-0.079416532,-0.040540541,622,593,642,-29,49,20
i5181,i,Takotsubo syndrome,Diseases of the circulatory system,405,352,399,-0.130864198,0.133522727,-0.014814815,815,869,818,54,-51,3
i5189,i,Other ill-defined heart diseases,Diseases of the circulatory system,136,142,163,0.044117647,0.147887324,0.198529412,1600,1511,1402,-89,-109,-198
i519,i,"Heart disease, unspecified",Diseases of the circulatory system,147,126,119,-0.142857143,-0.055555556,-0.19047619,1536,1622,1691,86,69,155
i602,i,Nontraumatic subarachnoid hemorrhage from anterior communicating artery,Diseases of the circulatory system,21,15,14,-0.285714286,-0.066666667,-0.333333333,4162,4579,4676,417,97,514
i607,i,Nontraumatic subarachnoid hemorrhage from unspecified intracranial artery,Diseases of the circulatory system,23,16,12,-0.304347826,-0.25,-0.47826087,4015,4497,4871,482,374,856
i608,i,Other nontraumatic subarachnoid hemorrhage,Diseases of the circulatory system,35,43,61,0.228571429,0.418604651,0.742857143,3315,2868,2452,-447,-416,-863
i609,i,"Nontraumatic subarachnoid hemorrhage, unspecified",Diseases of the circulatory system,416,417,434,0.002403846,0.040767386,0.043269231,803,787,780,-16,-7,-23
i610,i,"Nontraumatic intracerebral hemorrhage in hemisphere, subcortical",Diseases of the circulatory system,173,188,163,0.086705202,-0.132978723,-0.057803468,1396,1301,1401,-95,100,5
i611,i,"Nontraumatic intracerebral hemorrhage in hemisphere, cortical",Diseases of the circulatory system,256,285,289,0.11328125,0.014035088,0.12890625,1106,1004,1012,-102,8,-94
i612,i,"Nontraumatic intracerebral hemorrhage in hemisphere, unspecified",Diseases of the circulatory system,16,13,15,-0.1875,0.153846154,-0.0625,4592,4774,4580,182,-194,-12
i613,i,Nontraumatic intracerebral hemorrhage in brain stem,Diseases of the circulatory system,37,43,59,0.162162162,0.372093023,0.594594595,3224,2865,2495,-359,-370,-729
i614,i,Nontraumatic intracerebral hemorrhage in cerebellum,Diseases of the circulatory system,82,96,123,0.170731707,0.28125,0.5,2159,1876,1650,-283,-226,-509
i615,i,"Nontraumatic intracerebral hemorrhage, intraventricular",Diseases of the circulatory system,269,290,302,0.078066914,0.04137931,0.12267658,1075,997,984,-78,-13,-91
i618,i,Other nontraumatic intracerebral hemorrhage,Diseases of the circulatory system,135,169,174,0.251851852,0.029585799,0.288888889,1602,1359,1345,-243,-14,-257
i619,i,"Nontraumatic intracerebral hemorrhage, unspecified",Diseases of the circulatory system,370,341,374,-0.078378378,0.096774194,0.010810811,863,891,858,28,-33,-5
i6200,i,"Nontraumatic subdural hemorrhage, unspecified",Diseases of the circulatory system,210,196,166,-0.066666667,-0.153061224,-0.20952381,1261,1268,1379,7,111,118
i6201,i,Nontraumatic acute subdural hemorrhage,Diseases of the circulatory system,152,162,152,0.065789474,-0.061728395,0,1497,1396,1453,-101,57,-44
i6202,i,Nontraumatic subacute subdural hemorrhage,Diseases of the circulatory system,54,55,40,0.018518519,-0.272727273,-0.259259259,2695,2542,3034,-153,492,339
i6203,i,Nontraumatic chronic subdural hemorrhage,Diseases of the circulatory system,274,250,261,-0.087591241,0.044,-0.047445255,1061,1081,1077,20,-4,16
i621,i,Nontraumatic extradural hemorrhage,Diseases of the circulatory system,15,21,12,0.4,-0.428571429,-0.2,4684,4024,4857,-660,833,173
i629,i,"Nontraumatic intracranial hemorrhage, unspecified",Diseases of the circulatory system,186,169,150,-0.091397849,-0.112426036,-0.193548387,1330,1356,1460,26,104,130
i6302,i,Cerebral infarction due to thrombosis of basilar artery,Diseases of the circulatory system,19,11,21,-0.421052632,0.909090909,0.105263158,4317,4969,4041,652,-928,-276
i6310,i,Cerebral infarction due to embolism of unspecified precerebral artery,Diseases of the circulatory system,12,11,10,-0.083333333,-0.090909091,-0.166666667,4943,4969,5043,26,74,100
i63211,i,Cerebral infarction due to unspecified occlusion or stenosis of right vertebral artery,Diseases of the circulatory system,16,13,10,-0.1875,-0.230769231,-0.375,4581,4763,5043,182,280,462
i63212,i,Cerebral infarction due to unspecified occlusion or stenosis of left vertebral artery,Diseases of the circulatory system,13,15,16,0.153846154,0.066666667,0.230769231,4863,4563,4470,-300,-93,-393
i6322,i,Cerebral infarction due to unspecified occlusion or stenosis of basilar artery,Diseases of the circulatory system,10,14,11,0.4,-0.214285714,0.1,5083,4671,4956,-412,285,-127
i63231,i,Cerebral infarction due to unspecified occlusion or stenosis of right carotid arteries,Diseases of the circulatory system,48,54,51,0.125,-0.055555556,0.0625,2852,2559,2680,-293,121,-172
i63232,i,Cerebral infarction due to unspecified occlusion or stenosis of left carotid arteries,Diseases of the circulatory system,51,59,49,0.156862745,-0.169491525,-0.039215686,2773,2460,2737,-313,277,-36
i63233,i,Cerebral infarction due to unspecified occlusion or stenosis of bilateral carotid arteries,Diseases of the circulatory system,28,28,23,0,-0.178571429,-0.178571429,3671,3527,3892,-144,365,221
i63311,i,Cerebral infarction due to thrombosis of right middle cerebral artery,Diseases of the circulatory system,53,52,72,-0.018867925,0.384615385,0.358490566,2711,2605,2236,-106,-369,-475
i63312,i,Cerebral infarction due to thrombosis of left middle cerebral artery,Diseases of the circulatory system,73,52,79,-0.287671233,0.519230769,0.082191781,2307,2605,2129,298,-476,-178
i6340,i,Cerebral infarction due to embolism of unspecified cerebral artery,Diseases of the circulatory system,382,351,380,-0.081151832,0.082621083,-0.005235602,841,869,846,28,-23,5
i63411,i,Cerebral infarction due to embolism of right middle cerebral artery,Diseases of the circulatory system,128,133,132,0.0390625,-0.007518797,0.03125,1644,1563,1573,-81,10,-71
i63412,i,Cerebral infarction due to embolism of left middle cerebral artery,Diseases of the circulatory system,147,157,171,0.068027211,0.089171975,0.163265306,1526,1419,1357,-107,-62,-169
i63413,i,Cerebral infarction due to embolism of bilateral middle cerebral arteries,Diseases of the circulatory system,13,10,18,-0.230769231,0.8,0.384615385,4855,5046,4279,191,-767,-576
i63421,i,Cerebral infarction due to embolism of right anterior cerebral artery,Diseases of the circulatory system,15,13,18,-0.133333333,0.384615385,0.2,4673,4753,4279,80,-474,-394
i63431,i,Cerebral infarction due to embolism of right posterior cerebral artery,Diseases of the circulatory system,38,47,40,0.236842105,-0.14893617,0.052631579,3175,2730,3025,-445,295,-150
i63432,i,Cerebral infarction due to embolism of left posterior cerebral artery,Diseases of the circulatory system,38,27,37,-0.289473684,0.37037037,-0.026315789,3175,3580,3118,405,-462,-57
i63441,i,Cerebral infarction due to embolism of right cerebellar artery,Diseases of the circulatory system,31,20,30,-0.35483871,0.5,-0.032258065,3489,4103,3464,614,-639,-25
i63442,i,Cerebral infarction due to embolism of left cerebellar artery,Diseases of the circulatory system,24,27,22,0.125,-0.185185185,-0.083333333,3912,3580,3959,-332,379,47
i63443,i,Cerebral infarction due to embolism of bilateral cerebellar arteries,Diseases of the circulatory system,24,24,17,0,-0.291666667,-0.291666667,3912,3769,4364,-143,595,452
i6349,i,Cerebral infarction due to embolism of other cerebral artery,Diseases of the circulatory system,82,80,77,-0.024390244,-0.0375,-0.06097561,2149,2075,2149,-74,74,0
i6350,i,Cerebral infarction due to unspecified occlusion or stenosis of unspecified cerebral artery,Diseases of the circulatory system,35,65,77,0.857142857,0.184615385,1.2,3292,2340,2149,-952,-191,-1143
i63511,i,Cerebral infarction due to unspecified occlusion or stenosis of right middle cerebral artery,Diseases of the circulatory system,237,267,279,0.126582278,0.04494382,0.17721519,1165,1038,1032,-127,-6,-133
i63512,i,Cerebral infarction due to unspecified occlusion or stenosis of left middle cerebral artery,Diseases of the circulatory system,271,348,345,0.284132841,-0.00862069,0.273062731,1068,876,897,-192,21,-171
i63513,i,Cerebral infarction due to unspecified occlusion or stenosis of bilateral middle cerebral arteries,Diseases of the circulatory system,20,22,18,0.1,-0.181818182,-0.1,4222,3914,4271,-308,357,49
i63519,i,Cerebral infarction due to unspecified occlusion or stenosis of unspecified middle cerebral artery,Diseases of the circulatory system,16,15,28,-0.0625,0.866666667,0.75,4563,4545,3564,-18,-981,-999
i63521,i,Cerebral infarction due to unspecified occlusion or stenosis of right anterior cerebral artery,Diseases of the circulatory system,25,29,24,0.16,-0.172413793,-0.04,3845,3445,3819,-400,374,-26
i63522,i,Cerebral infarction due to unspecified occlusion or stenosis of left anterior cerebral artery,Diseases of the circulatory system,21,23,30,0.095238095,0.304347826,0.428571429,4129,3839,3460,-290,-379,-669
i63531,i,Cerebral infarction due to unspecified occlusion or stenosis of right posterior cerebral artery,Diseases of the circulatory system,84,86,74,0.023809524,-0.139534884,-0.119047619,2116,1990,2190,-126,200,74
i63532,i,Cerebral infarction due to unspecified occlusion or stenosis of left posterior cerebral artery,Diseases of the circulatory system,80,76,90,-0.05,0.184210526,0.125,2182,2126,1978,-56,-148,-204
i63533,i,Cerebral infarction due to unspecified occlusion or stenosis of bilateral posterior cerebral arteries,Diseases of the circulatory system,10,14,12,0.4,-0.142857143,0.2,5058,4648,4829,-410,181,-229
i63541,i,Cerebral infarction due to unspecified occlusion or stenosis of right cerebellar artery,Diseases of the circulatory system,16,16,21,0,0.3125,0.3125,4559,4460,4020,-99,-440,-539
i63542,i,Cerebral infarction due to unspecified occlusion or stenosis of left cerebellar artery,Diseases of the circulatory system,17,15,24,-0.117647059,0.6,0.411764706,4470,4540,3816,70,-724,-654
i6359,i,Cerebral infarction due to unspecified occlusion or stenosis of other cerebral artery,Diseases of the circulatory system,13,13,25,0,0.923076923,0.923076923,4837,4735,3731,-102,-1004,-1106
i6381,i,Other cerebral infarction due to occlusion or stenosis of small artery,Diseases of the circulatory system,448,428,442,-0.044642857,0.03271028,-0.013392857,775,777,770,2,-7,-5
i6389,i,Other cerebral infarction,Diseases of the circulatory system,450,457,563,0.015555556,0.231947484,0.251111111,773,745,645,-28,-100,-128
i639,i,"Cerebral infarction, unspecified",Diseases of the circulatory system,3011,2927,2725,-0.027897708,-0.069012641,-0.094985055,154,159,168,5,9,14
i6501,i,Occlusion and stenosis of right vertebral artery,Diseases of the circulatory system,155,155,157,0,0.012903226,0.012903226,1475,1423,1414,-52,-9,-61
i6502,i,Occlusion and stenosis of left vertebral artery,Diseases of the circulatory system,165,189,191,0.145454545,0.010582011,0.157575758,1418,1289,1279,-129,-10,-139
i6503,i,Occlusion and stenosis of bilateral vertebral arteries,Diseases of the circulatory system,38,59,45,0.552631579,-0.237288136,0.184210526,3165,2446,2845,-719,399,-320
i6509,i,Occlusion and stenosis of unspecified vertebral artery,Diseases of the circulatory system,39,34,34,-0.128205128,0,-0.128205128,3130,3163,3238,33,75,108
i651,i,Occlusion and stenosis of basilar artery,Diseases of the circulatory system,74,64,66,-0.135135135,0.03125,-0.108108108,2275,2348,2323,73,-25,48
i6521,i,Occlusion and stenosis of right carotid artery,Diseases of the circulatory system,883,869,823,-0.01585504,-0.052934407,-0.06795017,460,443,475,-17,32,15
i6522,i,Occlusion and stenosis of left carotid artery,Diseases of the circulatory system,866,853,819,-0.015011547,-0.03985932,-0.054272517,469,449,478,-20,29,9
i6523,i,Occlusion and stenosis of bilateral carotid arteries,Diseases of the circulatory system,1007,998,979,-0.008937438,-0.019038076,-0.027805362,412,406,414,-6,8,2
i6529,i,Occlusion and stenosis of unspecified carotid artery,Diseases of the circulatory system,649,634,616,-0.023112481,-0.028391167,-0.050847458,584,577,598,-7,21,14
i6601,i,Occlusion and stenosis of right middle cerebral artery,Diseases of the circulatory system,49,40,22,-0.183673469,-0.45,-0.551020408,2802,2939,3936,137,997,1134
i6602,i,Occlusion and stenosis of left middle cerebral artery,Diseases of the circulatory system,44,38,46,-0.136363636,0.210526316,0.045454545,2949,3005,2808,56,-197,-141
i6621,i,Occlusion and stenosis of right posterior cerebral artery,Diseases of the circulatory system,24,22,32,-0.083333333,0.454545455,0.333333333,3891,3896,3338,5,-558,-553
i6622,i,Occlusion and stenosis of left posterior cerebral artery,Diseases of the circulatory system,15,30,33,1,0.1,1.2,4641,3371,3285,-1270,-86,-1356
i669,i,Occlusion and stenosis of unspecified cerebral artery,Diseases of the circulatory system,24,18,17,-0.25,-0.055555556,-0.291666667,3891,4243,4335,352,92,444
i671,i,"Cerebral aneurysm, nonruptured",Diseases of the circulatory system,644,621,649,-0.035714286,0.045088567,0.007763975,586,584,572,-2,-12,-14
i672,i,Cerebral atherosclerosis,Diseases of the circulatory system,414,453,466,0.094202899,0.028697572,0.125603865,797,743,733,-54,-10,-64
i674,i,Hypertensive encephalopathy,Diseases of the circulatory system,253,282,296,0.114624506,0.04964539,0.169960474,1100,994,983,-106,-11,-117
i675,i,Moyamoya disease,Diseases of the circulatory system,54,58,65,0.074074074,0.120689655,0.203703704,2671,2457,2340,-214,-117,-331
i676,i,Nonpyogenic thrombosis of intracranial venous system,Diseases of the circulatory system,47,41,63,-0.127659574,0.536585366,0.340425532,2846,2899,2377,53,-522,-469
i677,i,"Cerebral arteritis, not elsewhere classified",Diseases of the circulatory system,21,14,10,-0.333333333,-0.285714286,-0.523809524,4106,4624,4990,518,366,884
i6781,i,Acute cerebrovascular insufficiency,Diseases of the circulatory system,16,16,28,0,0.75,0.75,4536,4438,3541,-98,-897,-995
i6782,i,Cerebral ischemia,Diseases of the circulatory system,113,115,164,0.017699115,0.426086957,0.451327434,1773,1674,1375,-99,-299,-398
i6783,i,Posterior reversible encephalopathy syndrome,Diseases of the circulatory system,94,108,157,0.14893617,0.453703704,0.670212766,1968,1719,1405,-249,-314,-563
i67848,i,Other cerebrovascular vasospasm and vasoconstriction,Diseases of the circulatory system,90,77,90,-0.144444444,0.168831169,0,2024,2090,1964,66,-126,-60
i6789,i,Other cerebrovascular disease,Diseases of the circulatory system,63,84,105,0.333333333,0.25,0.666666667,2476,2002,1778,-474,-224,-698
i679,i,"Cerebrovascular disease, unspecified",Diseases of the circulatory system,69,77,82,0.115942029,0.064935065,0.188405797,2349,2089,2059,-260,-30,-290
i680,i,Cerebral amyloid angiopathy,Diseases of the circulatory system,102,123,131,0.205882353,0.06504065,0.284313725,1876,1618,1563,-258,-55,-313
i69091,i,Dysphagia following nontraumatic subarachnoid hemorrhage,Diseases of the circulatory system,22,19,19,-0.136363636,0,-0.136363636,4024,4144,4146,120,2,122
i69098,i,Other sequelae following nontraumatic subarachnoid hemorrhage,Diseases of the circulatory system,21,18,25,-0.142857143,0.388888889,0.19047619,4099,4231,3704,132,-527,-395
i69110,i,Attention and concentration deficit following nontraumatic intracerebral hemorrhage,Diseases of the circulatory system,12,16,18,0.333333333,0.125,0.5,4881,4430,4233,-451,-197,-648
i69111,i,Memory deficit following nontraumatic intracerebral hemorrhage,Diseases of the circulatory system,27,30,23,0.111111111,-0.233333333,-0.148148148,3695,3360,3845,-335,485,150
i69112,i,Visuospatial deficit and spatial neglect following nontraumatic intracerebral hemorrhage,Diseases of the circulatory system,21,30,22,0.428571429,-0.266666667,0.047619048,4098,3360,3919,-738,559,-179
i69114,i,Frontal lobe and executive function deficit following nontraumatic intracerebral hemorrhage,Diseases of the circulatory system,12,16,16,0.333333333,0,0.333333333,4879,4428,4408,-451,-20,-471
i69118,i,Other symptoms and signs involving cognitive functions following nontraumatic intracerebral hemorrhage,Diseases of the circulatory system,53,47,56,-0.113207547,0.191489362,0.056603774,2682,2703,2516,21,-187,-166
i69119,i,Unspecified symptoms and signs involving cognitive functions following nontraumatic intracerebral hemorrhage,Diseases of the circulatory system,66,66,48,0,-0.272727273,-0.272727273,2414,2302,2735,-112,433,321
i69120,i,Aphasia following nontraumatic intracerebral hemorrhage,Diseases of the circulatory system,83,91,91,0.096385542,0,0.096385542,2114,1908,1946,-206,38,-168
i69122,i,Dysarthria following nontraumatic intracerebral hemorrhage,Diseases of the circulatory system,67,75,92,0.119402985,0.226666667,0.373134328,2391,2118,1927,-273,-191,-464
i69128,i,Other speech and language deficits following nontraumatic intracerebral hemorrhage,Diseases of the circulatory system,15,12,10,-0.2,-0.166666667,-0.333333333,4619,4800,4973,181,173,354
i69151,i,Hemiplegia and hemiparesis following nontraumatic intracerebral hemorrhage affecting right dominant side,Diseases of the circulatory system,91,93,87,0.021978022,-0.064516129,-0.043956044,2008,1885,1988,-123,103,-20
i69154,i,Hemiplegia and hemiparesis following nontraumatic intracerebral hemorrhage affecting left non-dominant side,Diseases of the circulatory system,92,108,102,0.173913043,-0.055555556,0.108695652,1994,1718,1808,-276,90,-186
i69191,i,Dysphagia following nontraumatic intracerebral hemorrhage,Diseases of the circulatory system,128,140,106,0.09375,-0.242857143,-0.171875,1629,1496,1772,-133,276,143
i69192,i,Facial weakness following nontraumatic intracerebral hemorrhage,Diseases of the circulatory system,60,59,56,-0.016666667,-0.050847458,-0.066666667,2515,2426,2511,-89,85,-4
i69193,i,Ataxia following nontraumatic intracerebral hemorrhage,Diseases of the circulatory system,15,31,23,1.066666667,-0.258064516,0.533333333,4615,3292,3837,-1323,545,-778
i69198,i,Other sequelae of nontraumatic intracerebral hemorrhage,Diseases of the circulatory system,98,113,118,0.153061224,0.044247788,0.204081633,1922,1688,1670,-234,-18,-252
i69219,i,Unspecified symptoms and signs involving cognitive functions following other nontraumatic intracranial hemorrhage,Diseases of the circulatory system,17,20,14,0.176470588,-0.3,-0.176470588,4429,4053,4586,-376,533,157
i69220,i,Aphasia following other nontraumatic intracranial hemorrhage,Diseases of the circulatory system,22,31,21,0.409090909,-0.322580645,-0.045454545,4014,3291,3977,-723,686,-37
i69251,i,Hemiplegia and hemiparesis following other nontraumatic intracranial hemorrhage affecting right dominant side,Diseases of the circulatory system,37,40,32,0.081081081,-0.2,-0.135135135,3167,2919,3317,-248,398,150
i69254,i,Hemiplegia and hemiparesis following other nontraumatic intracranial hemorrhage affecting left non-dominant side,Diseases of the circulatory system,36,32,30,-0.111111111,-0.0625,-0.166666667,3209,3243,3422,34,179,213
i69291,i,Dysphagia following other nontraumatic intracranial hemorrhage,Diseases of the circulatory system,19,31,23,0.631578947,-0.258064516,0.210526316,4251,3289,3834,-962,545,-417
i69298,i,Other sequelae of other nontraumatic intracranial hemorrhage,Diseases of the circulatory system,33,44,33,0.333333333,-0.25,0,3345,2791,3265,-554,474,-80
i6930,i,Unspecified sequelae of cerebral infarction,Diseases of the circulatory system,95,126,103,0.326315789,-0.182539683,0.084210526,1958,1594,1795,-364,201,-163
i69310,i,Attention and concentration deficit following cerebral infarction,Diseases of the circulatory system,77,73,80,-0.051948052,0.095890411,0.038961039,2203,2153,2080,-50,-73,-123
i69311,i,Memory deficit following cerebral infarction,Diseases of the circulatory system,314,285,277,-0.092356688,-0.028070175,-0.117834395,964,991,1024,27,33,60
i69312,i,Visuospatial deficit and spatial neglect following cerebral infarction,Diseases of the circulatory system,123,155,140,0.260162602,-0.096774194,0.138211382,1674,1414,1490,-260,76,-184
i69314,i,Frontal lobe and executive function deficit following cerebral infarction,Diseases of the circulatory system,94,70,95,-0.255319149,0.357142857,0.010638298,1962,2201,1887,239,-314,-75
i69318,i,Other symptoms and signs involving cognitive functions following cerebral infarction,Diseases of the circulatory system,274,319,375,0.164233577,0.175548589,0.368613139,1050,919,846,-131,-73,-204
i69319,i,Unspecified symptoms and signs involving cognitive functions following cerebral infarction,Diseases of the circulatory system,463,518,376,0.118790497,-0.274131274,-0.187904968,753,663,844,-90,181,91
i69320,i,Aphasia following cerebral infarction,Diseases of the circulatory system,1212,1198,1218,-0.011551155,0.016694491,0.004950495,352,343,351,-9,8,-1
i69321,i,Dysphasia following cerebral infarction,Diseases of the circulatory system,97,110,63,0.134020619,-0.427272727,-0.350515464,1928,1695,2357,-233,662,429
i69322,i,Dysarthria following cerebral infarction,Diseases of the circulatory system,882,840,832,-0.047619048,-0.00952381,-0.056689342,458,458,462,0,4,4
i69328,i,Other speech and language deficits following cerebral infarction,Diseases of the circulatory system,211,192,191,-0.090047393,-0.005208333,-0.09478673,1233,1267,1267,34,0,34
i69331,i,Monoplegia of upper limb following cerebral infarction affecting right dominant side,Diseases of the circulatory system,61,74,63,0.213114754,-0.148648649,0.032786885,2491,2118,2355,-373,237,-136
i69334,i,Monoplegia of upper limb following cerebral infarction affecting left non-dominant side,Diseases of the circulatory system,65,58,76,-0.107692308,0.310344828,0.169230769,2413,2431,2125,18,-306,-288
i69341,i,Monoplegia of lower limb following cerebral infarction affecting right dominant side,Diseases of the circulatory system,33,36,44,0.090909091,0.222222222,0.333333333,3332,3047,2839,-285,-208,-493
i69344,i,Monoplegia of lower limb following cerebral infarction affecting left non-dominant side,Diseases of the circulatory system,48,49,49,0.020833333,0,0.020833333,2798,2621,2684,-177,63,-114
i69351,i,Hemiplegia and hemiparesis following cerebral infarction affecting right dominant side,Diseases of the circulatory system,2101,2070,1922,-0.014754879,-0.071497585,-0.085197525,223,217,240,-6,23,17
i69352,i,Hemiplegia and hemiparesis following cerebral infarction affecting left dominant side,Diseases of the circulatory system,38,34,39,-0.105263158,0.147058824,0.026315789,3122,3118,3003,-4,-115,-119
i69353,i,Hemiplegia and hemiparesis following cerebral infarction affecting right non-dominant side,Diseases of the circulatory system,45,47,44,0.044444444,-0.063829787,-0.022222222,2877,2680,2837,-197,157,-40
i69354,i,Hemiplegia and hemiparesis following cerebral infarction affecting left non-dominant side,Diseases of the circulatory system,2507,2505,2429,-0.000797766,-0.030339321,-0.031112884,186,181,183,-5,2,-3
i69359,i,Hemiplegia and hemiparesis following cerebral infarction affecting unspecified side,Diseases of the circulatory system,122,92,106,-0.245901639,0.152173913,-0.131147541,1674,1884,1762,210,-122,88
i69365,i,"Other paralytic syndrome following cerebral infarction, bilateral",Diseases of the circulatory system,14,12,19,-0.142857143,0.583333333,0.357142857,4670,4768,4108,98,-660,-562
i69390,i,Apraxia following cerebral infarction,Diseases of the circulatory system,72,68,71,-0.055555556,0.044117647,-0.013888889,2278,2235,2215,-43,-20,-63
i69391,i,Dysphagia following cerebral infarction,Diseases of the circulatory system,961,1039,972,0.081165453,-0.064485082,0.01144641,423,388,413,-35,25,-10
i69392,i,Facial weakness following cerebral infarction,Diseases of the circulatory system,629,600,595,-0.046104928,-0.008333333,-0.054054054,589,591,605,2,14,16
i69393,i,Ataxia following cerebral infarction,Diseases of the circulatory system,309,286,275,-0.074433657,-0.038461538,-0.110032362,967,981,1021,14,40,54
i69398,i,Other sequelae of cerebral infarction,Diseases of the circulatory system,1153,1231,1184,0.06764961,-0.038180341,0.026886383,364,334,349,-30,15,-15
i69851,i,Hemiplegia and hemiparesis following other cerebrovascular disease affecting right dominant side,Diseases of the circulatory system,21,19,15,-0.095238095,-0.210526316,-0.285714286,4060,4101,4464,41,363,404
i69854,i,Hemiplegia and hemiparesis following other cerebrovascular disease affecting left non-dominant side,Diseases of the circulatory system,35,28,21,-0.2,-0.25,-0.4,3228,3446,3948,218,502,720
i69898,i,Other sequelae of other cerebrovascular disease,Diseases of the circulatory system,21,13,19,-0.380952381,0.461538462,-0.095238095,4059,4656,4102,597,-554,43
i69920,i,Aphasia following unspecified cerebrovascular disease,Diseases of the circulatory system,33,39,23,0.181818182,-0.41025641,-0.303030303,3320,2925,3808,-395,883,488
i69951,i,Hemiplegia and hemiparesis following unspecified cerebrovascular disease affecting right dominant side,Diseases of the circulatory system,72,67,60,-0.069444444,-0.104477612,-0.166666667,2274,2252,2405,-22,153,131
i69954,i,Hemiplegia and hemiparesis following unspecified cerebrovascular disease affecting left non-dominant side,Diseases of the circulatory system,105,97,76,-0.076190476,-0.216494845,-0.276190476,1835,1817,2118,-18,301,283
i69998,i,Other sequelae following unspecified cerebrovascular disease,Diseases of the circulatory system,51,46,32,-0.098039216,-0.304347826,-0.37254902,2711,2697,3289,-14,592,578
i700,i,Atherosclerosis of aorta,Diseases of the circulatory system,1146,1094,895,-0.045375218,-0.18190128,-0.219022688,366,363,437,-3,74,71
i701,i,Atherosclerosis of renal artery,Diseases of the circulatory system,510,435,445,-0.147058824,0.022988506,-0.12745098,695,754,748,59,-6,53
i70201,i,"Unspecified atherosclerosis of native arteries of extremities, right leg",Diseases of the circulatory system,346,346,307,0,-0.112716763,-0.112716763,883,858,947,-25,89,64
i70202,i,"Unspecified atherosclerosis of native arteries of extremities, left leg",Diseases of the circulatory system,320,294,293,-0.08125,-0.003401361,-0.084375,933,959,979,26,20,46
i70203,i,"Unspecified atherosclerosis of native arteries of extremities, bilateral legs",Diseases of the circulatory system,160,207,164,0.29375,-0.207729469,0.025,1416,1201,1359,-215,158,-57
i70208,i,"Unspecified atherosclerosis of native arteries of extremities, other extremity",Diseases of the circulatory system,43,38,54,-0.11627907,0.421052632,0.255813953,2929,2951,2536,22,-415,-393
i70209,i,"Unspecified atherosclerosis of native arteries of extremities, unspecified extremity",Diseases of the circulatory system,183,198,161,0.081967213,-0.186868687,-0.120218579,1315,1230,1370,-85,140,55
i70211,i,"Atherosclerosis of native arteries of extremities with intermittent claudication, right leg",Diseases of the circulatory system,100,99,87,-0.01,-0.121212121,-0.13,1875,1782,1963,-93,181,88
i70212,i,"Atherosclerosis of native arteries of extremities with intermittent claudication, left leg",Diseases of the circulatory system,138,100,85,-0.275362319,-0.15,-0.384057971,1547,1767,1992,220,225,445
i70213,i,"Atherosclerosis of native arteries of extremities with intermittent claudication, bilateral legs",Diseases of the circulatory system,152,120,128,-0.210526316,0.066666667,-0.157894737,1462,1617,1566,155,-51,104
i70219,i,"Atherosclerosis of native arteries of extremities with intermittent claudication, unspecified extremity",Diseases of the circulatory system,58,57,56,-0.017241379,-0.01754386,-0.034482759,2542,2432,2478,-110,46,-64
i70221,i,"Atherosclerosis of native arteries of extremities with rest pain, right leg",Diseases of the circulatory system,65,80,102,0.230769231,0.275,0.569230769,2394,2025,1784,-369,-241,-610
i70222,i,"Atherosclerosis of native arteries of extremities with rest pain, left leg",Diseases of the circulatory system,67,70,130,0.044776119,0.857142857,0.940298507,2357,2176,1551,-181,-625,-806
i70223,i,"Atherosclerosis of native arteries of extremities with rest pain, bilateral legs",Diseases of the circulatory system,33,47,43,0.424242424,-0.085106383,0.303030303,3304,2659,2847,-645,188,-457
i70234,i,Atherosclerosis of native arteries of right leg with ulceration of heel and midfoot,Diseases of the circulatory system,25,40,34,0.6,-0.15,0.36,3761,2879,3171,-882,292,-590
i70235,i,Atherosclerosis of native arteries of right leg with ulceration of other part of foot,Diseases of the circulatory system,63,79,53,0.253968254,-0.329113924,-0.158730159,2434,2031,2547,-403,516,113
i70239,i,Atherosclerosis of native arteries of right leg with ulceration of unspecified site,Diseases of the circulatory system,17,16,10,-0.058823529,-0.375,-0.411764706,4376,4365,4912,-11,547,536
i70243,i,Atherosclerosis of native arteries of left leg with ulceration of ankle,Diseases of the circulatory system,14,10,14,-0.285714286,0.4,0,4641,4923,4532,282,-391,-109
i70244,i,Atherosclerosis of native arteries of left leg with ulceration of heel and midfoot,Diseases of the circulatory system,27,25,22,-0.074074074,-0.12,-0.185185185,3638,3601,3860,-37,259,222
i70245,i,Atherosclerosis of native arteries of left leg with ulceration of other part of foot,Diseases of the circulatory system,64,74,74,0.15625,0,0.15625,2412,2099,2135,-313,36,-277
i70248,i,Atherosclerosis of native arteries of left leg with ulceration of other part of lower leg,Diseases of the circulatory system,32,24,25,-0.25,0.041666667,-0.21875,3352,3671,3647,319,-24,295
i7025,i,Atherosclerosis of native arteries of other extremities with ulceration,Diseases of the circulatory system,24,16,17,-0.333333333,0.0625,-0.291666667,3818,4362,4252,544,-110,434
i70261,i,"Atherosclerosis of native arteries of extremities with gangrene, right leg",Diseases of the circulatory system,184,195,181,0.059782609,-0.071794872,-0.016304348,1310,1242,1289,-68,47,-21
i70262,i,"Atherosclerosis of native arteries of extremities with gangrene, left leg",Diseases of the circulatory system,162,195,166,0.203703704,-0.148717949,0.024691358,1406,1242,1346,-164,104,-60
i70263,i,"Atherosclerosis of native arteries of extremities with gangrene, bilateral legs",Diseases of the circulatory system,27,45,36,0.666666667,-0.2,0.333333333,3634,2710,3063,-924,353,-571
i70268,i,"Atherosclerosis of native arteries of extremities with gangrene, other extremity",Diseases of the circulatory system,24,22,36,-0.083333333,0.636363636,0.5,3815,3815,3063,0,-752,-752
i70269,i,"Atherosclerosis of native arteries of extremities with gangrene, unspecified extremity",Diseases of the circulatory system,13,24,17,0.846153846,-0.291666667,0.307692308,4727,3668,4248,-1059,580,-479
i70291,i,"Other atherosclerosis of native arteries of extremities, right leg",Diseases of the circulatory system,18,23,14,0.277777778,-0.391304348,-0.222222222,4287,3741,4523,-546,782,236
i70292,i,"Other atherosclerosis of native arteries of extremities, left leg",Diseases of the circulatory system,25,15,13,-0.4,-0.133333333,-0.48,3754,4431,4626,677,195,872
i708,i,Atherosclerosis of other arteries,Diseases of the circulatory system,377,353,338,-0.063660477,-0.042492918,-0.103448276,831,847,893,16,46,62
i7090,i,Unspecified atherosclerosis,Diseases of the circulatory system,127,96,90,-0.244094488,-0.0625,-0.291338583,1612,1818,1929,206,111,317
i7092,i,Chronic total occlusion of artery of the extremities,Diseases of the circulatory system,231,219,179,-0.051948052,-0.182648402,-0.225108225,1151,1162,1292,11,130,141
i7100,i,Dissection of unspecified site of aorta,Diseases of the circulatory system,58,57,46,-0.017241379,-0.192982456,-0.206896552,2533,2423,2744,-110,321,211
i7101,i,Dissection of thoracic aorta,Diseases of the circulatory system,178,159,134,-0.106741573,-0.157232704,-0.247191011,1335,1370,1517,35,147,182
i7102,i,Dissection of abdominal aorta,Diseases of the circulatory system,87,66,74,-0.24137931,0.121212121,-0.149425287,2020,2255,2129,235,-126,109
i7103,i,Dissection of thoracoabdominal aorta,Diseases of the circulatory system,40,37,33,-0.075,-0.108108108,-0.175,3009,2971,3211,-38,240,202
i711,i,"Thoracic aortic aneurysm, ruptured",Diseases of the circulatory system,21,10,12,-0.523809524,0.2,-0.428571429,4023,4905,4707,882,-198,684
i712,i,"Thoracic aortic aneurysm, without rupture",Diseases of the circulatory system,1076,1082,1146,0.005576208,0.059149723,0.065055762,382,370,359,-12,-11,-23
i713,i,"Abdominal aortic aneurysm, ruptured",Diseases of the circulatory system,40,41,33,0.025,-0.195121951,-0.175,3008,2832,3210,-176,378,202
i714,i,"Abdominal aortic aneurysm, without rupture",Diseases of the circulatory system,2462,2299,2165,-0.066206336,-0.058286211,-0.120633631,190,191,215,1,24,25
i716,i,"Thoracoabdominal aortic aneurysm, without rupture",Diseases of the circulatory system,45,52,39,0.155555556,-0.25,-0.133333333,2843,2520,2967,-323,447,124
i719,i,"Aortic aneurysm of unspecified site, without rupture",Diseases of the circulatory system,168,186,152,0.107142857,-0.182795699,-0.095238095,1375,1265,1410,-110,145,35
i720,i,Aneurysm of carotid artery,Diseases of the circulatory system,38,41,46,0.078947368,0.12195122,0.210526316,3082,2829,2739,-253,-90,-343
i721,i,Aneurysm of artery of upper extremity,Diseases of the circulatory system,39,30,53,-0.230769231,0.766666667,0.358974359,3048,3283,2536,235,-747,-512
i722,i,Aneurysm of renal artery,Diseases of the circulatory system,56,33,34,-0.410714286,0.03030303,-0.392857143,2560,3127,3153,567,26,593
i723,i,Aneurysm of iliac artery,Diseases of the circulatory system,221,224,228,0.013574661,0.017857143,0.031674208,1183,1144,1132,-39,-12,-51
i724,i,Aneurysm of artery of lower extremity,Diseases of the circulatory system,268,232,256,-0.134328358,0.103448276,-0.044776119,1045,1111,1061,66,-50,16
i725,i,Aneurysm of other precerebral arteries,Diseases of the circulatory system,25,21,19,-0.16,-0.095238095,-0.24,3737,3886,4058,149,172,321
i726,i,Aneurysm of vertebral artery,Diseases of the circulatory system,14,25,16,0.785714286,-0.36,0.142857143,4612,3580,4318,-1032,738,-294
i728,i,Aneurysm of other specified arteries,Diseases of the circulatory system,176,147,176,-0.164772727,0.197278912,0,1340,1423,1294,83,-129,-46
i729,i,Aneurysm of unspecified site,Diseases of the circulatory system,25,20,25,-0.2,0.25,0,3736,3973,3625,237,-348,-111
i7300,i,Raynaud's syndrome without gangrene,Diseases of the circulatory system,477,439,396,-0.07966457,-0.097949886,-0.169811321,723,746,800,23,54,77
i7301,i,Raynaud's syndrome with gangrene,Diseases of the circulatory system,16,19,13,0.1875,-0.315789474,-0.1875,4430,4049,4604,-381,555,174
i731,i,Thromboangiitis obliterans [Buerger's disease],Diseases of the circulatory system,44,39,33,-0.113636364,-0.153846154,-0.25,2872,2887,3200,15,313,328
i7389,i,Other specified peripheral vascular diseases,Diseases of the circulatory system,57,57,85,0,0.49122807,0.49122807,2544,2414,1976,-130,-438,-568
i739,i,"Peripheral vascular disease, unspecified",Diseases of the circulatory system,5863,5403,5094,-0.078458127,-0.05719045,-0.131161521,86,89,105,3,16,19
i7409,i,Other arterial embolism and thrombosis of abdominal aorta,Diseases of the circulatory system,99,76,96,-0.232323232,0.263157895,-0.03030303,1866,2061,1839,195,-222,-27
i7410,i,Embolism and thrombosis of unspecified parts of aorta,Diseases of the circulatory system,32,30,27,-0.0625,-0.1,-0.15625,3327,3274,3500,-53,226,173
i7411,i,Embolism and thrombosis of thoracic aorta,Diseases of the circulatory system,20,24,35,0.2,0.458333333,0.75,4089,3643,3098,-446,-545,-991
i742,i,Embolism and thrombosis of arteries of the upper extremities,Diseases of the circulatory system,73,74,95,0.01369863,0.283783784,0.301369863,2233,2084,1852,-149,-232,-381
i743,i,Embolism and thrombosis of arteries of the lower extremities,Diseases of the circulatory system,314,299,326,-0.047770701,0.090301003,0.038216561,947,942,907,-5,-35,-40
i745,i,Embolism and thrombosis of iliac artery,Diseases of the circulatory system,187,198,224,0.058823529,0.131313131,0.197860963,1290,1221,1138,-69,-83,-152
i748,i,Embolism and thrombosis of other arteries,Diseases of the circulatory system,82,62,90,-0.243902439,0.451612903,0.097560976,2080,2315,1915,235,-400,-165
i749,i,Embolism and thrombosis of unspecified artery,Diseases of the circulatory system,16,17,19,0.0625,0.117647059,0.1875,4420,4228,4045,-192,-183,-375
i76,i,Septic arterial embolism,Diseases of the circulatory system,211,191,227,-0.09478673,0.188481675,0.075829384,1214,1247,1130,33,-117,-84
i770,i,"Arteriovenous fistula, acquired",Diseases of the circulatory system,43,35,50,-0.186046512,0.428571429,0.162790698,2894,3025,2607,131,-418,-287
i771,i,Stricture of artery,Diseases of the circulatory system,330,316,342,-0.042424242,0.082278481,0.036363636,903,909,879,6,-30,-24
i772,i,Rupture of artery,Diseases of the circulatory system,21,17,25,-0.19047619,0.470588235,0.19047619,3997,4225,3611,228,-614,-386
i773,i,Arterial fibromuscular dysplasia,Diseases of the circulatory system,17,22,17,0.294117647,-0.227272727,0,4330,3780,4212,-550,432,-118
i774,i,Celiac artery compression syndrome,Diseases of the circulatory system,92,103,113,0.119565217,0.097087379,0.22826087,1946,1715,1673,-231,-42,-273
i776,i,"Arteritis, unspecified",Diseases of the circulatory system,260,238,240,-0.084615385,0.008403361,-0.076923077,1055,1080,1093,25,13,38
i7771,i,Dissection of carotid artery,Diseases of the circulatory system,111,146,116,0.315315315,-0.205479452,0.045045045,1750,1422,1646,-328,224,-104
i7772,i,Dissection of iliac artery,Diseases of the circulatory system,55,41,40,-0.254545455,-0.024390244,-0.272727273,2572,2813,2915,241,102,343
i7774,i,Dissection of vertebral artery,Diseases of the circulatory system,136,135,141,-0.007352941,0.044444444,0.036764706,1536,1491,1449,-45,-42,-87
i7777,i,Dissection of artery of lower extremity,Diseases of the circulatory system,29,28,32,-0.034482759,0.142857143,0.103448276,3478,3386,3232,-92,-154,-246
i7779,i,Dissection of other specified artery,Diseases of the circulatory system,32,37,38,0.15625,0.027027027,0.1875,3315,2946,2976,-369,30,-339
i77810,i,Thoracic aortic ectasia,Diseases of the circulatory system,281,298,279,0.060498221,-0.063758389,-0.007117438,1015,944,1001,-71,57,-14
i77811,i,Abdominal aortic ectasia,Diseases of the circulatory system,35,22,31,-0.371428571,0.409090909,-0.114285714,3172,3772,3282,600,-490,110
i77819,i,"Aortic ectasia, unspecified site",Diseases of the circulatory system,121,90,88,-0.256198347,-0.022222222,-0.272727273,1649,1861,1925,212,64,276
i7789,i,Other specified disorders of arteries and arterioles,Diseases of the circulatory system,64,41,53,-0.359375,0.292682927,-0.171875,2384,2810,2517,426,-293,133
i779,i,"Disorder of arteries and arterioles, unspecified",Diseases of the circulatory system,140,138,127,-0.014285714,-0.079710145,-0.092857143,1509,1473,1552,-36,79,43
i780,i,Hereditary hemorrhagic telangiectasia,Diseases of the circulatory system,86,63,47,-0.26744186,-0.253968254,-0.453488372,2013,2284,2686,271,402,673
i781,i,"Nevus, non-neoplastic",Diseases of the circulatory system,22,25,20,0.136363636,-0.2,-0.090909091,3910,3554,3940,-356,386,30
i788,i,Other diseases of capillaries,Diseases of the circulatory system,12,17,17,0.416666667,0,0.416666667,4746,4210,4198,-536,-12,-548
i8001,i,Phlebitis and thrombophlebitis of superficial vessels of right lower extremity,Diseases of the circulatory system,19,22,25,0.157894737,0.136363636,0.315789474,4143,3767,3598,-376,-169,-545
i8002,i,Phlebitis and thrombophlebitis of superficial vessels of left lower extremity,Diseases of the circulatory system,15,21,20,0.4,-0.047619048,0.333333333,4495,3854,3939,-641,85,-556
i803,i,"Phlebitis and thrombophlebitis of lower extremities, unspecified",Diseases of the circulatory system,18,17,11,-0.055555556,-0.352941176,-0.388888889,4235,4208,4758,-27,550,523
i808,i,Phlebitis and thrombophlebitis of other sites,Diseases of the circulatory system,594,494,470,-0.168350168,-0.048582996,-0.208754209,603,680,716,77,36,113
i809,i,Phlebitis and thrombophlebitis of unspecified site,Diseases of the circulatory system,102,67,81,-0.343137255,0.208955224,-0.205882353,1827,2210,2007,383,-203,180
i81,i,Portal vein thrombosis,Diseases of the circulatory system,696,572,629,-0.17816092,0.09965035,-0.096264368,553,606,581,53,-25,28
i820,i,Budd-Chiari syndrome,Diseases of the circulatory system,47,34,39,-0.276595745,0.147058824,-0.170212766,2754,3044,2937,290,-107,183
i82210,i,Acute embolism and thrombosis of superior vena cava,Diseases of the circulatory system,57,48,49,-0.157894737,0.020833333,-0.140350877,2524,2593,2623,69,30,99
i82220,i,Acute embolism and thrombosis of inferior vena cava,Diseases of the circulatory system,154,183,151,0.188311688,-0.174863388,-0.019480519,1431,1260,1401,-171,141,-30
i82221,i,Chronic embolism and thrombosis of inferior vena cava,Diseases of the circulatory system,30,35,24,0.166666667,-0.314285714,-0.2,3405,3008,3671,-397,663,266
i82290,i,Acute embolism and thrombosis of other thoracic veins,Diseases of the circulatory system,43,39,40,-0.093023256,0.025641026,-0.069767442,2877,2863,2904,-14,41,27
i823,i,Embolism and thrombosis of renal vein,Diseases of the circulatory system,54,56,44,0.037037037,-0.214285714,-0.185185185,2580,2410,2772,-170,362,192
i82401,i,Acute embolism and thrombosis of unspecified deep veins of right lower extremity,Diseases of the circulatory system,303,258,285,-0.148514851,0.104651163,-0.059405941,971,1026,984,55,-42,13
i82402,i,Acute embolism and thrombosis of unspecified deep veins of left lower extremity,Diseases of the circulatory system,323,286,318,-0.114551084,0.111888112,-0.015479876,917,966,919,49,-47,2
i82403,i,"Acute embolism and thrombosis of unspecified deep veins of lower extremity, bilateral",Diseases of the circulatory system,226,187,211,-0.172566372,0.128342246,-0.066371681,1157,1248,1169,91,-79,12
i82409,i,Acute embolism and thrombosis of unspecified deep veins of unspecified lower extremity,Diseases of the circulatory system,218,186,217,-0.146788991,0.166666667,-0.004587156,1180,1250,1145,70,-105,-35
i82411,i,Acute embolism and thrombosis of right femoral vein,Diseases of the circulatory system,699,599,760,-0.143061516,0.268781302,0.087267525,550,586,503,36,-83,-47
i82412,i,Acute embolism and thrombosis of left femoral vein,Diseases of the circulatory system,796,699,812,-0.121859296,0.161659514,0.020100503,495,529,470,34,-59,-25
i82413,i,"Acute embolism and thrombosis of femoral vein, bilateral",Diseases of the circulatory system,197,169,219,-0.14213198,0.295857988,0.111675127,1246,1298,1138,52,-160,-108
i82419,i,Acute embolism and thrombosis of unspecified femoral vein,Diseases of the circulatory system,24,21,15,-0.125,-0.285714286,-0.375,3752,3838,4362,86,524,610
i82421,i,Acute embolism and thrombosis of right iliac vein,Diseases of the circulatory system,76,70,92,-0.078947368,0.314285714,0.210526316,2148,2137,1864,-11,-273,-284
i82422,i,Acute embolism and thrombosis of left iliac vein,Diseases of the circulatory system,148,128,137,-0.135135135,0.0703125,-0.074324324,1461,1520,1474,59,-46,13
i82423,i,"Acute embolism and thrombosis of iliac vein, bilateral",Diseases of the circulatory system,40,31,48,-0.225,0.548387097,0.2,2962,3181,2642,219,-539,-320
i82431,i,Acute embolism and thrombosis of right popliteal vein,Diseases of the circulatory system,603,513,641,-0.149253731,0.249512671,0.063018242,591,657,567,66,-90,-24
i82432,i,Acute embolism and thrombosis of left popliteal vein,Diseases of the circulatory system,708,576,785,-0.186440678,0.362847222,0.108757062,541,598,487,57,-111,-54
i82433,i,"Acute embolism and thrombosis of popliteal vein, bilateral",Diseases of the circulatory system,126,114,188,-0.095238095,0.649122807,0.492063492,1590,1624,1242,34,-382,-348
i82439,i,Acute embolism and thrombosis of unspecified popliteal vein,Diseases of the circulatory system,32,34,31,0.0625,-0.088235294,-0.03125,3288,3027,3257,-261,230,-31
i82441,i,Acute embolism and thrombosis of right tibial vein,Diseases of the circulatory system,277,258,342,-0.068592058,0.325581395,0.23465704,1011,1021,873,10,-148,-138
i82442,i,Acute embolism and thrombosis of left tibial vein,Diseases of the circulatory system,261,247,337,-0.053639847,0.36437247,0.291187739,1043,1044,882,1,-162,-161
i82443,i,"Acute embolism and thrombosis of tibial vein, bilateral",Diseases of the circulatory system,56,59,77,0.053571429,0.305084746,0.375,2519,2342,2047,-177,-295,-472
i82449,i,Acute embolism and thrombosis of unspecified tibial vein,Diseases of the circulatory system,20,21,13,0.05,-0.380952381,-0.35,4040,3828,4544,-212,716,504
i82451,i,Acute embolism and thrombosis of right peroneal vein,Diseases of the circulatory system,104,210,290,1.019230769,0.380952381,1.788461538,1792,1168,967,-624,-201,-825
i82452,i,Acute embolism and thrombosis of left peroneal vein,Diseases of the circulatory system,139,219,341,0.575539568,0.557077626,1.45323741,1501,1142,875,-359,-267,-626
i82453,i,"Acute embolism and thrombosis of peroneal vein, bilateral",Diseases of the circulatory system,31,65,83,1.096774194,0.276923077,1.677419355,3327,2228,1963,-1099,-265,-1364
i82461,i,Acute embolism and thrombosis of right calf muscular vein,Diseases of the circulatory system,27,72,98,1.666666667,0.361111111,2.62962963,3561,2099,1792,-1462,-307,-1769
i82462,i,Acute embolism and thrombosis of left calf muscular vein,Diseases of the circulatory system,33,77,126,1.333333333,0.636363636,2.818181818,3233,2012,1542,-1221,-470,-1691
i82491,i,Acute embolism and thrombosis of other specified deep vein of right lower extremity,Diseases of the circulatory system,80,29,26,-0.6375,-0.103448276,-0.675,2086,3278,3505,1192,227,1419
i82492,i,Acute embolism and thrombosis of other specified deep vein of left lower extremity,Diseases of the circulatory system,106,34,38,-0.679245283,0.117647059,-0.641509434,1772,3019,2942,1247,-77,1170
i824y1,i,Acute embolism and thrombosis of unspecified deep veins of right proximal lower extremity,Diseases of the circulatory system,12,12,14,0,0.166666667,0.166666667,4708,4636,4434,-72,-202,-274
i824y2,i,Acute embolism and thrombosis of unspecified deep veins of left proximal lower extremity,Diseases of the circulatory system,18,13,13,-0.277777778,0,-0.277777778,4200,4532,4536,332,4,336
i824z1,i,Acute embolism and thrombosis of unspecified deep veins of right distal lower extremity,Diseases of the circulatory system,135,83,102,-0.385185185,0.228915663,-0.244444444,1524,1949,1741,425,-208,217
i824z2,i,Acute embolism and thrombosis of unspecified deep veins of left distal lower extremity,Diseases of the circulatory system,146,86,124,-0.410958904,0.441860465,-0.150684932,1461,1901,1556,440,-345,95
i824z3,i,"Acute embolism and thrombosis of unspecified deep veins of distal lower extremity, bilateral",Diseases of the circulatory system,52,32,45,-0.384615385,0.40625,-0.134615385,2602,3120,2716,518,-404,114
i82501,i,Chronic embolism and thrombosis of unspecified deep veins of right lower extremity,Diseases of the circulatory system,78,52,55,-0.333333333,0.057692308,-0.294871795,2107,2471,2445,364,-26,338
i82502,i,Chronic embolism and thrombosis of unspecified deep veins of left lower extremity,Diseases of the circulatory system,110,83,62,-0.245454545,-0.253012048,-0.436363636,1735,1948,2295,213,347,560
i82503,i,"Chronic embolism and thrombosis of unspecified deep veins of lower extremity, bilateral",Diseases of the circulatory system,45,27,27,-0.4,0,-0.4,2787,3399,3443,612,44,656
i82509,i,Chronic embolism and thrombosis of unspecified deep veins of unspecified lower extremity,Diseases of the circulatory system,88,72,92,-0.181818182,0.277777778,0.045454545,1963,2095,1852,132,-243,-111
i82511,i,Chronic embolism and thrombosis of right femoral vein,Diseases of the circulatory system,98,102,91,0.040816327,-0.107843137,-0.071428571,1850,1698,1868,-152,170,18
i82512,i,Chronic embolism and thrombosis of left femoral vein,Diseases of the circulatory system,133,122,137,-0.082706767,0.12295082,0.030075188,1531,1563,1467,32,-96,-64
i82513,i,"Chronic embolism and thrombosis of femoral vein, bilateral",Diseases of the circulatory system,52,23,36,-0.557692308,0.565217391,-0.307692308,2597,3653,2988,1056,-665,391
i82522,i,Chronic embolism and thrombosis of left iliac vein,Diseases of the circulatory system,21,16,18,-0.238095238,0.125,-0.142857143,3939,4254,4066,315,-188,127
i82531,i,Chronic embolism and thrombosis of right popliteal vein,Diseases of the circulatory system,77,59,59,-0.233766234,0,-0.233766234,2120,2331,2354,211,23,234
i82532,i,Chronic embolism and thrombosis of left popliteal vein,Diseases of the circulatory system,81,85,92,0.049382716,0.082352941,0.135802469,2062,1907,1851,-155,-56,-211
i82533,i,"Chronic embolism and thrombosis of popliteal vein, bilateral",Diseases of the circulatory system,31,14,18,-0.548387097,0.285714286,-0.419354839,3312,4431,4064,1119,-367,752
i82541,i,Chronic embolism and thrombosis of right tibial vein,Diseases of the circulatory system,17,12,17,-0.294117647,0.416666667,0,4264,4621,4149,357,-472,-115
i82542,i,Chronic embolism and thrombosis of left tibial vein,Diseases of the circulatory system,14,13,12,-0.071428571,-0.076923077,-0.142857143,4524,4518,4606,-6,88,82
i825z1,i,Chronic embolism and thrombosis of unspecified deep veins of right distal lower extremity,Diseases of the circulatory system,17,10,11,-0.411764706,0.1,-0.352941176,4264,4802,4705,538,-97,441
i825z2,i,Chronic embolism and thrombosis of unspecified deep veins of left distal lower extremity,Diseases of the circulatory system,24,16,15,-0.333333333,-0.0625,-0.375,3722,4252,4330,530,78,608
i82611,i,Acute embolism and thrombosis of superficial veins of right upper extremity,Diseases of the circulatory system,354,356,385,0.005649718,0.081460674,0.087570621,858,829,810,-29,-19,-48
i82612,i,Acute embolism and thrombosis of superficial veins of left upper extremity,Diseases of the circulatory system,310,317,342,0.022580645,0.078864353,0.103225806,946,900,872,-46,-28,-74
i82613,i,"Acute embolism and thrombosis of superficial veins of upper extremity, bilateral",Diseases of the circulatory system,53,56,53,0.056603774,-0.053571429,0,2566,2380,2481,-186,101,-85
i82619,i,Acute embolism and thrombosis of superficial veins of unspecified upper extremity,Diseases of the circulatory system,57,48,48,-0.157894737,0,-0.157894737,2494,2559,2619,65,60,125
i82621,i,Acute embolism and thrombosis of deep veins of right upper extremity,Diseases of the circulatory system,331,371,348,0.120845921,-0.061994609,0.051359517,893,809,862,-84,53,-31
i82622,i,Acute embolism and thrombosis of deep veins of left upper extremity,Diseases of the circulatory system,303,262,265,-0.135313531,0.011450382,-0.125412541,963,1002,1019,39,17,56
i82623,i,"Acute embolism and thrombosis of deep veins of upper extremity, bilateral",Diseases of the circulatory system,60,46,38,-0.233333333,-0.173913043,-0.366666667,2412,2608,2926,196,318,514
i82629,i,Acute embolism and thrombosis of deep veins of unspecified upper extremity,Diseases of the circulatory system,35,29,17,-0.171428571,-0.413793103,-0.514285714,3121,3260,4142,139,882,1021
i82711,i,Chronic embolism and thrombosis of superficial veins of right upper extremity,Diseases of the circulatory system,12,10,13,-0.166666667,0.3,0.083333333,4681,4793,4512,112,-281,-169
i82721,i,Chronic embolism and thrombosis of deep veins of right upper extremity,Diseases of the circulatory system,34,22,14,-0.352941176,-0.363636364,-0.588235294,3162,3714,4410,552,696,1248
i82722,i,Chronic embolism and thrombosis of deep veins of left upper extremity,Diseases of the circulatory system,22,18,20,-0.181818182,0.111111111,-0.090909091,3853,4048,3887,195,-161,34
i82a11,i,Acute embolism and thrombosis of right axillary vein,Diseases of the circulatory system,101,100,129,-0.00990099,0.29,0.277227723,1812,1719,1514,-93,-205,-298
i82a12,i,Acute embolism and thrombosis of left axillary vein,Diseases of the circulatory system,96,88,94,-0.083333333,0.068181818,-0.020833333,1866,1861,1823,-5,-38,-43
i82b11,i,Acute embolism and thrombosis of right subclavian vein,Diseases of the circulatory system,120,120,141,0,0.175,0.175,1632,1573,1427,-59,-146,-205
i82b12,i,Acute embolism and thrombosis of left subclavian vein,Diseases of the circulatory system,136,149,150,0.095588235,0.006711409,0.102941176,1513,1384,1385,-129,1,-128
i82b21,i,Chronic embolism and thrombosis of right subclavian vein,Diseases of the circulatory system,14,16,21,0.142857143,0.3125,0.5,4508,4238,3817,-270,-421,-691
i82b22,i,Chronic embolism and thrombosis of left subclavian vein,Diseases of the circulatory system,14,12,20,-0.142857143,0.666666667,0.428571429,4508,4604,3882,96,-722,-626
i82c11,i,Acute embolism and thrombosis of right internal jugular vein,Diseases of the circulatory system,247,238,225,-0.036437247,-0.054621849,-0.089068826,1081,1065,1114,-16,49,33
i82c12,i,Acute embolism and thrombosis of left internal jugular vein,Diseases of the circulatory system,109,101,122,-0.073394495,0.207920792,0.119266055,1734,1702,1556,-32,-146,-178
i82c13,i,"Acute embolism and thrombosis of internal jugular vein, bilateral",Diseases of the circulatory system,15,21,19,0.4,-0.095238095,0.266666667,4425,3794,3964,-631,170,-461
i82c19,i,Acute embolism and thrombosis of unspecified internal jugular vein,Diseases of the circulatory system,35,32,18,-0.085714286,-0.4375,-0.485714286,3115,3100,4047,-15,947,932
i82c21,i,Chronic embolism and thrombosis of right internal jugular vein,Diseases of the circulatory system,33,32,34,-0.03030303,0.0625,0.03030303,3203,3100,3073,-103,-27,-130
i82c22,i,Chronic embolism and thrombosis of left internal jugular vein,Diseases of the circulatory system,14,21,21,0.5,0,0.5,4503,3792,3814,-711,22,-689
i82811,i,Embolism and thrombosis of superficial veins of right lower extremity,Diseases of the circulatory system,111,100,105,-0.099099099,0.05,-0.054054054,1719,1715,1700,-4,-15,-19
i82812,i,Embolism and thrombosis of superficial veins of left lower extremity,Diseases of the circulatory system,117,100,88,-0.145299145,-0.12,-0.247863248,1665,1715,1886,50,171,221
i82813,i,"Embolism and thrombosis of superficial veins of lower extremities, bilateral",Diseases of the circulatory system,22,16,25,-0.272727273,0.5625,0.136363636,3843,4230,3538,387,-692,-305
i82819,i,Embolism and thrombosis of superficial veins of unspecified lower extremity,Diseases of the circulatory system,36,21,21,-0.416666667,0,-0.416666667,3070,3790,3811,720,21,741
i82890,i,Acute embolism and thrombosis of other specified veins,Diseases of the circulatory system,150,134,154,-0.106666667,0.149253731,0.026666667,1437,1472,1366,35,-106,-71
i82891,i,Chronic embolism and thrombosis of other specified veins,Diseases of the circulatory system,30,26,36,-0.133333333,0.384615385,0.2,3346,3436,2970,90,-466,-376
i8290,i,Acute embolism and thrombosis of unspecified vein,Diseases of the circulatory system,24,26,32,0.083333333,0.230769231,0.333333333,3700,3436,3167,-264,-269,-533
i8291,i,Chronic embolism and thrombosis of unspecified vein,Diseases of the circulatory system,21,24,19,0.142857143,-0.208333333,-0.095238095,3910,3558,3955,-352,397,45
i83009,i,Varicose veins of unspecified lower extremity with ulcer of unspecified site,Diseases of the circulatory system,70,62,47,-0.114285714,-0.241935484,-0.328571429,2222,2262,2636,40,374,414
i83013,i,Varicose veins of right lower extremity with ulcer of ankle,Diseases of the circulatory system,17,11,15,-0.352941176,0.363636364,-0.117647059,4236,4682,4300,446,-382,64
i83018,i,Varicose veins of right lower extremity with ulcer other part of lower leg,Diseases of the circulatory system,67,62,75,-0.074626866,0.209677419,0.119402985,2282,2262,2046,-20,-216,-236
i83019,i,Varicose veins of right lower extremity with ulcer of unspecified site,Diseases of the circulatory system,43,37,34,-0.139534884,-0.081081081,-0.209302326,2827,2887,3067,60,180,240
i83028,i,Varicose veins of left lower extremity with ulcer other part of lower leg,Diseases of the circulatory system,67,67,83,0,0.23880597,0.23880597,2282,2170,1942,-112,-228,-340
i83029,i,Varicose veins of left lower extremity with ulcer of unspecified site,Diseases of the circulatory system,41,38,32,-0.073170732,-0.157894737,-0.219512195,2887,2846,3163,-41,317,276
i8310,i,Varicose veins of unspecified lower extremity with inflammation,Diseases of the circulatory system,15,13,11,-0.133333333,-0.153846154,-0.266666667,4409,4483,4667,74,184,258
i8311,i,Varicose veins of right lower extremity with inflammation,Diseases of the circulatory system,34,25,32,-0.264705882,0.28,-0.058823529,3146,3484,3163,338,-321,17
i8312,i,Varicose veins of left lower extremity with inflammation,Diseases of the circulatory system,33,29,32,-0.121212121,0.103448276,-0.03030303,3193,3244,3163,51,-81,-30
i83218,i,Varicose veins of right lower extremity with both ulcer of other part of lower extremity and inflammation,Diseases of the circulatory system,36,29,27,-0.194444444,-0.068965517,-0.25,3064,3244,3411,180,167,347
i83228,i,Varicose veins of left lower extremity with both ulcer of other part of lower extremity and inflammation,Diseases of the circulatory system,37,33,34,-0.108108108,0.03030303,-0.081081081,3022,3040,3066,18,26,44
i83891,i,Varicose veins of right lower extremity with other complications,Diseases of the circulatory system,12,12,10,0,-0.166666667,-0.166666667,4648,4580,4745,-68,165,97
i83893,i,Varicose veins of bilateral lower extremities with other complications,Diseases of the circulatory system,15,19,13,0.266666667,-0.315789474,-0.133333333,4405,3937,4480,-468,543,75
i8390,i,Asymptomatic varicose veins of unspecified lower extremity,Diseases of the circulatory system,250,180,160,-0.28,-0.111111111,-0.36,1072,1251,1333,179,82,261
i8391,i,Asymptomatic varicose veins of right lower extremity,Diseases of the circulatory system,18,11,20,-0.388888889,0.818181818,0.111111111,4149,4670,3861,521,-809,-288
i8392,i,Asymptomatic varicose veins of left lower extremity,Diseases of the circulatory system,28,15,17,-0.464285714,0.133333333,-0.392857143,3450,4285,4110,835,-175,660
i8393,i,Asymptomatic varicose veins of bilateral lower extremities,Diseases of the circulatory system,99,71,60,-0.282828283,-0.154929577,-0.393939394,1819,2092,2315,273,223,496
i8500,i,Esophageal varices without bleeding,Diseases of the circulatory system,656,466,417,-0.289634146,-0.105150215,-0.364329268,567,708,773,141,65,206
i8501,i,Esophageal varices with bleeding,Diseases of the circulatory system,96,90,100,-0.0625,0.111111111,0.041666667,1856,1826,1750,-30,-76,-106
i8510,i,Secondary esophageal varices without bleeding,Diseases of the circulatory system,1047,1029,1314,-0.017191977,0.27696793,0.255014327,389,384,326,-5,-58,-63
i8511,i,Secondary esophageal varices with bleeding,Diseases of the circulatory system,467,505,604,0.08137045,0.196039604,0.293361884,726,664,585,-62,-79,-141
i861,i,Scrotal varices,Diseases of the circulatory system,68,45,35,-0.338235294,-0.222222222,-0.485294118,2246,2619,3013,373,394,767
i862,i,Pelvic varices,Diseases of the circulatory system,18,13,11,-0.277777778,-0.153846154,-0.388888889,4142,4470,4653,328,183,511
i864,i,Gastric varices,Diseases of the circulatory system,249,257,294,0.032128514,0.143968872,0.180722892,1070,1015,951,-55,-64,-119
i868,i,Varicose veins of other specified sites,Diseases of the circulatory system,93,84,120,-0.096774194,0.428571429,0.290322581,1882,1904,1567,22,-337,-315
i871,i,Compression of vein,Diseases of the circulatory system,355,355,388,0,0.092957746,0.092957746,854,825,801,-29,-24,-53
i872,i,Venous insufficiency (chronic) (peripheral),Diseases of the circulatory system,2399,2087,1970,-0.130054189,-0.056061332,-0.17882451,195,213,234,18,21,39
i87309,i,Chronic venous hypertension (idiopathic) without complications of unspecified lower extremity,Diseases of the circulatory system,12,21,13,0.75,-0.380952381,0.083333333,4633,3766,4467,-867,701,-166
i878,i,Other specified disorders of veins,Diseases of the circulatory system,1413,1273,1259,-0.099079972,-0.010997643,-0.108987969,317,326,338,9,12,21
i880,i,Nonspecific mesenteric lymphadenitis,Diseases of the circulatory system,50,34,40,-0.32,0.176470588,-0.2,2620,2977,2843,357,-134,223
i889,i,"Nonspecific lymphadenitis, unspecified",Diseases of the circulatory system,83,62,51,-0.253012048,-0.177419355,-0.385542169,2005,2250,2510,245,260,505
i890,i,"Lymphedema, not elsewhere classified",Diseases of the circulatory system,1670,1531,1494,-0.083233533,-0.024167211,-0.105389222,274,282,294,8,12,20
i891,i,Lymphangitis,Diseases of the circulatory system,47,38,29,-0.191489362,-0.236842105,-0.382978723,2687,2832,3281,145,449,594
i898,i,Other specified noninfective disorders of lymphatic vessels and lymph nodes,Diseases of the circulatory system,83,71,77,-0.144578313,0.084507042,-0.072289157,2004,2082,2011,78,-71,7
i950,i,Idiopathic hypotension,Diseases of the circulatory system,14,19,23,0.357142857,0.210526316,0.642857143,4463,3919,3644,-544,-275,-819
i951,i,Orthostatic hypotension,Diseases of the circulatory system,3303,3194,3272,-0.033000303,0.024420789,-0.009385407,143,147,149,4,2,6
i952,i,Hypotension due to drugs,Diseases of the circulatory system,701,786,775,0.12125535,-0.013994911,0.105563481,542,466,487,-76,21,-55
i953,i,Hypotension of hemodialysis,Diseases of the circulatory system,332,321,351,-0.03313253,0.093457944,0.057228916,882,883,851,1,-32,-31
i9581,i,Postprocedural hypotension,Diseases of the circulatory system,979,790,672,-0.193054137,-0.149367089,-0.313585291,407,465,543,58,78,136
i9589,i,Other hypotension,Diseases of the circulatory system,1517,1373,1310,-0.094924192,-0.045884924,-0.136453527,295,310,324,15,14,29
i959,i,"Hypotension, unspecified",Diseases of the circulatory system,11398,11019,11494,-0.033251448,0.04310736,0.00842253,33,37,35,4,-2,2
i96,i,"Gangrene, not elsewhere classified",Diseases of the circulatory system,1155,1069,1251,-0.074458874,0.170252572,0.083116883,355,364,334,9,-30,-21
i970,i,Postcardiotomy syndrome,Diseases of the circulatory system,24,16,14,-0.333333333,-0.125,-0.416666667,3666,4189,4352,523,163,686
i97120,i,Postprocedural cardiac arrest following cardiac surgery,Diseases of the circulatory system,13,14,12,0.076923077,-0.142857143,-0.076923077,4543,4363,4534,-180,171,-9
i97121,i,Postprocedural cardiac arrest following other surgery,Diseases of the circulatory system,23,38,23,0.652173913,-0.394736842,0,3734,2824,3637,-910,813,-97
i97130,i,Postprocedural heart failure following cardiac surgery,Diseases of the circulatory system,13,13,21,0,0.615384615,0.615384615,4542,4448,3773,-94,-675,-769
i97190,i,Other postprocedural cardiac functional disturbances following cardiac surgery,Diseases of the circulatory system,164,138,131,-0.158536585,-0.050724638,-0.201219512,1346,1435,1481,89,46,135
i97191,i,Other postprocedural cardiac functional disturbances following other surgery,Diseases of the circulatory system,82,66,53,-0.195121951,-0.196969697,-0.353658537,2009,2170,2447,161,277,438
i972,i,Postmastectomy lymphedema syndrome,Diseases of the circulatory system,45,36,39,-0.2,0.083333333,-0.133333333,2736,2892,2860,156,-32,124
i973,i,Postprocedural hypertension,Diseases of the circulatory system,77,58,62,-0.246753247,0.068965517,-0.194805195,2083,2307,2256,224,-51,173
i97418,i,Intraoperative hemorrhage and hematoma of a circulatory system organ or structure complicating other circulatory system procedure,Diseases of the circulatory system,28,20,25,-0.285714286,0.25,-0.107142857,3423,3830,3498,407,-332,75
i9742,i,Intraoperative hemorrhage and hematoma of a circulatory system organ or structure complicating other procedure,Diseases of the circulatory system,14,15,12,0.071428571,-0.2,-0.142857143,4449,4253,4527,-196,274,78
i9751,i,Accidental puncture and laceration of a circulatory system organ or structure during a circulatory system procedure,Diseases of the circulatory system,113,89,88,-0.212389381,-0.011235955,-0.221238938,1681,1822,1866,141,44,185
i9752,i,Accidental puncture and laceration of a circulatory system organ or structure during other procedure,Diseases of the circulatory system,55,43,41,-0.218181818,-0.046511628,-0.254545455,2489,2656,2799,167,143,310
i97610,i,Postprocedural hemorrhage of a circulatory system organ or structure following a cardiac catheterization,Diseases of the circulatory system,21,17,18,-0.19047619,0.058823529,-0.142857143,3867,4090,3993,223,-97,126
i97611,i,Postprocedural hemorrhage of a circulatory system organ or structure following cardiac bypass,Diseases of the circulatory system,21,13,13,-0.380952381,0,-0.380952381,3867,4439,4442,572,3,575
i97618,i,Postprocedural hemorrhage of a circulatory system organ or structure following other circulatory system procedure,Diseases of the circulatory system,63,51,60,-0.19047619,0.176470588,-0.047619048,2329,2442,2294,113,-148,-35
i97620,i,Postprocedural hemorrhage of a circulatory system organ or structure following other procedure,Diseases of the circulatory system,31,18,36,-0.419354839,1,0.161290323,3251,3986,2938,735,-1048,-313
i97621,i,Postprocedural hematoma of a circulatory system organ or structure following other procedure,Diseases of the circulatory system,23,17,12,-0.260869565,-0.294117647,-0.47826087,3725,4088,4521,363,433,796
i97630,i,Postprocedural hematoma of a circulatory system organ or structure following a cardiac catheterization,Diseases of the circulatory system,88,101,82,0.147727273,-0.188118812,-0.068181818,1927,1684,1934,-243,250,7
i97638,i,Postprocedural hematoma of a circulatory system organ or structure following other circulatory system procedure,Diseases of the circulatory system,132,99,108,-0.25,0.090909091,-0.181818182,1512,1707,1661,195,-46,149
i97710,i,Intraoperative cardiac arrest during cardiac surgery,Diseases of the circulatory system,34,36,28,0.058823529,-0.222222222,-0.176470588,3111,2886,3327,-225,441,216
i97711,i,Intraoperative cardiac arrest during other surgery,Diseases of the circulatory system,55,59,56,0.072727273,-0.050847458,0.018181818,2486,2288,2372,-198,84,-114
i97790,i,Other intraoperative cardiac functional disturbances during cardiac surgery,Diseases of the circulatory system,28,31,36,0.107142857,0.161290323,0.285714286,3415,3098,2935,-317,-163,-480
i97791,i,Other intraoperative cardiac functional disturbances during other surgery,Diseases of the circulatory system,18,10,20,-0.444444444,1,0.111111111,4106,4707,3821,601,-886,-285
i97820,i,Postprocedural cerebrovascular infarction following cardiac surgery,Diseases of the circulatory system,28,29,26,0.035714286,-0.103448276,-0.071428571,3415,3206,3427,-209,221,12
i97821,i,Postprocedural cerebrovascular infarction following other surgery,Diseases of the circulatory system,50,41,43,-0.18,0.048780488,-0.14,2601,2723,2725,122,2,124
i9788,i,"Other intraoperative complications of the circulatory system, not elsewhere classified",Diseases of the circulatory system,78,57,61,-0.269230769,0.070175439,-0.217948718,2063,2322,2269,259,-53,206
i9789,i,"Other postprocedural complications and disorders of the circulatory system, not elsewhere classified",Diseases of the circulatory system,107,78,89,-0.271028037,0.141025641,-0.168224299,1729,1955,1858,226,-97,129
i998,i,Other disorder of circulatory system,Diseases of the circulatory system,538,568,473,0.055762082,-0.167253521,-0.120817844,650,594,695,-56,101,45
j00,j,Acute nasopharyngitis [common cold],Diseases of the respiratory system,79,110,51,0.392405063,-0.536363636,-0.35443038,2050,1613,2490,-437,877,440
j0100,j,"Acute maxillary sinusitis, unspecified",Diseases of the respiratory system,90,88,43,-0.022222222,-0.511363636,-0.522222222,1904,1831,2721,-73,890,817
j0110,j,"Acute frontal sinusitis, unspecified",Diseases of the respiratory system,14,10,10,-0.285714286,0,-0.285714286,4429,4700,4685,271,-15,256
j0130,j,"Acute sphenoidal sinusitis, unspecified",Diseases of the respiratory system,32,14,20,-0.5625,0.428571429,-0.375,3197,4338,3814,1141,-524,617
j0140,j,"Acute pansinusitis, unspecified",Diseases of the respiratory system,25,23,10,-0.08,-0.565217391,-0.6,3586,3576,4684,-10,1108,1098
j0190,j,"Acute sinusitis, unspecified",Diseases of the respiratory system,223,227,141,0.01793722,-0.378854626,-0.367713004,1134,1088,1407,-46,319,273
j020,j,Streptococcal pharyngitis,Diseases of the respiratory system,279,272,222,-0.025089606,-0.183823529,-0.204301075,990,969,1104,-21,135,114
j028,j,Acute pharyngitis due to other specified organisms,Diseases of the respiratory system,44,42,20,-0.045454545,-0.523809524,-0.545454545,2754,2678,3812,-76,1134,1058
j029,j,"Acute pharyngitis, unspecified",Diseases of the respiratory system,833,890,742,0.068427371,-0.166292135,-0.109243697,463,417,498,-46,81,35
j0390,j,"Acute tonsillitis, unspecified",Diseases of the respiratory system,88,73,67,-0.170454545,-0.082191781,-0.238636364,1920,2030,2147,110,117,227
j040,j,Acute laryngitis,Diseases of the respiratory system,51,68,31,0.333333333,-0.544117647,-0.392156863,2567,2117,3165,-450,1048,598
j0410,j,Acute tracheitis without obstruction,Diseases of the respiratory system,188,215,156,0.143617021,-0.274418605,-0.170212766,1245,1127,1335,-118,208,90
j050,j,Acute obstructive laryngitis [croup],Diseases of the respiratory system,180,80,25,-0.555555556,-0.6875,-0.861111111,1273,1934,3476,661,1542,2203
j0510,j,Acute epiglottitis without obstruction,Diseases of the respiratory system,48,30,50,-0.375,0.666666667,0.041666667,2638,3139,2511,501,-628,-127
j069,j,"Acute upper respiratory infection, unspecified",Diseases of the respiratory system,1798,2313,551,0.286429366,-0.761781236,-0.693548387,255,187,623,-68,436,368
j1000,j,Influenza due to other identified influenza virus with unspecified type of pneumonia,Diseases of the respiratory system,137,966,27,6.051094891,-0.972049689,-0.802919708,1482,394,3359,-1088,2965,1877
j1008,j,Influenza due to other identified influenza virus with other specified pneumonia,Diseases of the respiratory system,117,666,61,4.692307692,-0.908408408,-0.478632479,1638,531,2261,-1107,1730,623
j101,j,Influenza due to other identified influenza virus with other respiratory manifestations,Diseases of the respiratory system,412,1913,61,3.643203883,-0.968112912,-0.851941748,763,224,2261,-539,2037,1498
j111,j,Influenza due to unidentified influenza virus with other respiratory manifestations,Diseases of the respiratory system,110,363,18,2.3,-0.950413223,-0.836363636,1695,802,3964,-893,3162,2269
j1289,j,Other viral pneumonia,Diseases of the respiratory system,118,6736,28037,56.08474576,3.16226247,236.6016949,1626,68,12,-1558,-56,-1614
j129,j,"Viral pneumonia, unspecified",Diseases of the respiratory system,142,561,370,2.950704225,-0.340463458,1.605633803,1449,592,810,-857,218,-639
j13,j,Pneumonia due to Streptococcus pneumoniae,Diseases of the respiratory system,275,508,264,0.847272727,-0.480314961,-0.04,993,644,1000,-349,356,7
j14,j,Pneumonia due to Hemophilus influenzae,Diseases of the respiratory system,97,151,63,0.556701031,-0.582781457,-0.350515464,1812,1348,2224,-464,876,412
j150,j,Pneumonia due to Klebsiella pneumoniae,Diseases of the respiratory system,347,428,546,0.233429395,0.275700935,0.573487032,852,728,627,-124,-101,-225
j151,j,Pneumonia due to Pseudomonas,Diseases of the respiratory system,545,553,623,0.014678899,0.126582278,0.143119266,641,597,567,-44,-30,-74
j1520,j,"Pneumonia due to staphylococcus, unspecified",Diseases of the respiratory system,40,49,22,0.225,-0.551020408,-0.45,2859,2461,3667,-398,1206,808
j15211,j,Pneumonia due to Methicillin susceptible Staphylococcus aureus,Diseases of the respiratory system,363,508,587,0.399449036,0.155511811,0.61707989,824,643,587,-181,-56,-237
j15212,j,Pneumonia due to Methicillin resistant Staphylococcus aureus,Diseases of the respiratory system,480,645,556,0.34375,-0.137984496,0.158333333,696,541,614,-155,73,-82
j1529,j,Pneumonia due to other staphylococcus,Diseases of the respiratory system,13,19,20,0.461538462,0.052631579,0.538461538,4490,3867,3793,-623,-74,-697
j154,j,Pneumonia due to other streptococci,Diseases of the respiratory system,130,234,133,0.8,-0.431623932,0.023076923,1510,1043,1453,-467,410,-57
j155,j,Pneumonia due to Escherichia coli,Diseases of the respiratory system,106,147,147,0.386792453,0,0.386792453,1718,1358,1365,-360,7,-353
j156,j,Pneumonia due to other Gram-negative bacteria,Diseases of the respiratory system,821,1027,936,0.25091352,-0.088607595,0.140073082,467,375,407,-92,32,-60
j157,j,Pneumonia due to Mycoplasma pneumoniae,Diseases of the respiratory system,80,124,42,0.55,-0.661290323,-0.475,2014,1503,2732,-511,1229,718
j158,j,Pneumonia due to other specified bacteria,Diseases of the respiratory system,107,169,155,0.579439252,-0.082840237,0.448598131,1709,1252,1330,-457,78,-379
j159,j,Unspecified bacterial pneumonia,Diseases of the respiratory system,1185,2298,2255,0.939240506,-0.018711923,0.902953586,346,186,203,-160,17,-143
j168,j,Pneumonia due to other specified infectious organisms,Diseases of the respiratory system,74,75,87,0.013513514,0.16,0.175675676,2101,1972,1852,-129,-120,-249
j180,j,"Bronchopneumonia, unspecified organism",Diseases of the respiratory system,207,249,114,0.202898551,-0.542168675,-0.449275362,1183,1002,1593,-181,591,410
j181,j,"Lobar pneumonia, unspecified organism",Diseases of the respiratory system,2754,850,286,-0.691358025,-0.663529412,-0.896151053,166,424,943,258,519,777
j188,j,"Other pneumonia, unspecified organism",Diseases of the respiratory system,155,146,162,-0.058064516,0.109589041,0.04516129,1378,1358,1297,-20,-61,-81
j189,j,"Pneumonia, unspecified organism",Diseases of the respiratory system,14249,20429,16609,0.433714647,-0.186989084,0.165625658,24,16,20,-8,4,-4
j206,j,Acute bronchitis due to rhinovirus,Diseases of the respiratory system,211,211,25,0,-0.881516588,-0.881516588,1163,1121,3452,-42,2331,2289
j208,j,Acute bronchitis due to other specified organisms,Diseases of the respiratory system,195,403,156,1.066666667,-0.612903226,-0.2,1209,745,1322,-464,577,113
j209,j,"Acute bronchitis, unspecified",Diseases of the respiratory system,2151,2596,819,0.206880521,-0.684514638,-0.619246862,208,169,455,-39,286,247
j218,j,Acute bronchiolitis due to other specified organisms,Diseases of the respiratory system,266,364,75,0.368421053,-0.793956044,-0.718045113,1002,788,1996,-214,1208,994
j219,j,"Acute bronchiolitis, unspecified",Diseases of the respiratory system,541,705,174,0.303142329,-0.753191489,-0.678373383,639,504,1245,-135,741,606
j22,j,Unspecified acute lower respiratory infection,Diseases of the respiratory system,31,66,32,1.129032258,-0.515151515,0.032258065,3201,2127,3089,-1074,962,-112
j301,j,Allergic rhinitis due to pollen,Diseases of the respiratory system,47,62,44,0.319148936,-0.290322581,-0.063829787,2627,2195,2659,-432,464,32
j302,j,Other seasonal allergic rhinitis,Diseases of the respiratory system,1294,1422,1330,0.098918083,-0.064697609,0.027820711,325,294,314,-31,20,-11
j3089,j,Other allergic rhinitis,Diseases of the respiratory system,84,61,14,-0.273809524,-0.770491803,-0.833333333,1942,2209,4283,267,2074,2341
j309,j,"Allergic rhinitis, unspecified",Diseases of the respiratory system,1112,1089,888,-0.020683453,-0.184573003,-0.201438849,358,350,424,-8,74,66
j310,j,Chronic rhinitis,Diseases of the respiratory system,166,148,120,-0.108433735,-0.189189189,-0.277108434,1313,1336,1529,23,193,216
j320,j,Chronic maxillary sinusitis,Diseases of the respiratory system,260,254,182,-0.023076923,-0.283464567,-0.3,1007,982,1220,-25,238,213
j321,j,Chronic frontal sinusitis,Diseases of the respiratory system,30,26,22,-0.133333333,-0.153846154,-0.266666667,3248,3338,3643,90,305,395
j322,j,Chronic ethmoidal sinusitis,Diseases of the respiratory system,60,43,41,-0.283333333,-0.046511628,-0.316666667,2326,2603,2752,277,149,426
j323,j,Chronic sphenoidal sinusitis,Diseases of the respiratory system,74,47,49,-0.364864865,0.042553191,-0.337837838,2087,2493,2509,406,16,422
j324,j,Chronic pansinusitis,Diseases of the respiratory system,85,98,63,0.152941176,-0.357142857,-0.258823529,1927,1680,2202,-247,522,275
j328,j,Other chronic sinusitis,Diseases of the respiratory system,49,30,27,-0.387755102,-0.1,-0.448979592,2573,3099,3325,526,226,752
j329,j,"Chronic sinusitis, unspecified",Diseases of the respiratory system,600,577,365,-0.038333333,-0.367417678,-0.391666667,571,572,808,1,236,237
j338,j,Other polyp of sinus,Diseases of the respiratory system,19,37,22,0.947368421,-0.405405405,0.157894737,3953,2797,3638,-1156,841,-315
j339,j,"Nasal polyp, unspecified",Diseases of the respiratory system,37,45,25,0.216216216,-0.444444444,-0.324324324,2932,2544,3437,-388,893,505
j340,j,"Abscess, furuncle and carbuncle of nose",Diseases of the respiratory system,32,33,32,0.03125,-0.03030303,0,3146,2947,3080,-199,133,-66
j341,j,Cyst and mucocele of nose and nasal sinus,Diseases of the respiratory system,32,30,23,-0.0625,-0.233333333,-0.28125,3146,3095,3567,-51,472,421
j342,j,Deviated nasal septum,Diseases of the respiratory system,214,161,161,-0.247663551,0,-0.247663551,1147,1277,1295,130,18,148
j343,j,Hypertrophy of nasal turbinates,Diseases of the respiratory system,52,20,29,-0.615384615,0.45,-0.442307692,2495,3757,3210,1262,-547,715
j3489,j,Other specified disorders of nose and nasal sinuses,Diseases of the respiratory system,119,128,125,0.075630252,-0.0234375,0.050420168,1591,1452,1490,-139,38,-101
j351,j,Hypertrophy of tonsils,Diseases of the respiratory system,62,42,38,-0.322580645,-0.095238095,-0.387096774,2292,2629,2833,337,204,541
j352,j,Hypertrophy of adenoids,Diseases of the respiratory system,16,12,12,-0.25,0,-0.25,4194,4459,4446,265,-13,252
j353,j,Hypertrophy of tonsils with hypertrophy of adenoids,Diseases of the respiratory system,42,36,37,-0.142857143,0.027777778,-0.119047619,2760,2825,2857,65,32,97
j36,j,Peritonsillar abscess,Diseases of the respiratory system,181,172,155,-0.049723757,-0.098837209,-0.143646409,1248,1228,1318,-20,90,70
j3800,j,"Paralysis of vocal cords and larynx, unspecified",Diseases of the respiratory system,112,85,85,-0.241071429,0,-0.241071429,1654,1829,1865,175,36,211
j3801,j,"Paralysis of vocal cords and larynx, unilateral",Diseases of the respiratory system,139,95,109,-0.316546763,0.147368421,-0.215827338,1445,1715,1620,270,-95,175
j3802,j,"Paralysis of vocal cords and larynx, bilateral",Diseases of the respiratory system,40,32,37,-0.2,0.15625,-0.075,2822,2990,2854,168,-136,32
j383,j,Other diseases of vocal cords,Diseases of the respiratory system,120,133,115,0.108333333,-0.135338346,-0.041666667,1576,1427,1569,-149,142,-7
j384,j,Edema of larynx,Diseases of the respiratory system,113,78,76,-0.309734513,-0.025641026,-0.327433628,1641,1907,1973,266,66,332
j385,j,Laryngeal spasm,Diseases of the respiratory system,46,40,43,-0.130434783,0.075,-0.065217391,2632,2690,2675,58,-15,43
j386,j,Stenosis of larynx,Diseases of the respiratory system,92,87,90,-0.054347826,0.034482759,-0.02173913,1834,1804,1813,-30,9,-21
j387,j,Other diseases of larynx,Diseases of the respiratory system,44,32,19,-0.272727273,-0.40625,-0.568181818,2697,2986,3827,289,841,1130
j390,j,Retropharyngeal and parapharyngeal abscess,Diseases of the respiratory system,97,89,81,-0.082474227,-0.08988764,-0.164948454,1782,1775,1905,-7,130,123
j391,j,Other abscess of pharynx,Diseases of the respiratory system,22,23,24,0.045454545,0.043478261,0.090909091,3709,3506,3496,-203,-10,-213
j392,j,Other diseases of pharynx,Diseases of the respiratory system,80,57,51,-0.2875,-0.105263158,-0.3625,1987,2264,2445,277,181,458
j398,j,Other specified diseases of upper respiratory tract,Diseases of the respiratory system,316,326,255,0.03164557,-0.217791411,-0.193037975,899,844,1009,-55,165,110
j40,j,"Bronchitis, not specified as acute or chronic",Diseases of the respiratory system,772,1017,429,0.317357513,-0.578171091,-0.444300518,485,373,734,-112,361,249
j410,j,Simple chronic bronchitis,Diseases of the respiratory system,29,97,105,2.344827586,0.082474227,2.620689655,3279,1688,1643,-1591,-45,-1636
j42,j,Unspecified chronic bronchitis,Diseases of the respiratory system,270,303,276,0.122222222,-0.089108911,0.022222222,989,885,957,-104,72,-32
j431,j,Panlobular emphysema,Diseases of the respiratory system,75,79,60,0.053333333,-0.240506329,-0.2,2045,1893,2240,-152,347,195
j432,j,Centrilobular emphysema,Diseases of the respiratory system,469,516,478,0.10021322,-0.073643411,0.019189765,700,621,676,-79,55,-24
j438,j,Other emphysema,Diseases of the respiratory system,81,96,82,0.185185185,-0.145833333,0.012345679,1967,1698,1889,-269,191,-78
j439,j,"Emphysema, unspecified",Diseases of the respiratory system,4244,4122,3998,-0.028746466,-0.030082484,-0.057964185,118,117,128,-1,11,10
j440,j,Chronic obstructive pulmonary disease with (acute) lower respiratory infection,Diseases of the respiratory system,6380,8940,7056,0.401253918,-0.210738255,0.105956113,73,45,62,-28,17,-11
j441,j,Chronic obstructive pulmonary disease with (acute) exacerbation,Diseases of the respiratory system,9901,11824,7968,0.194222806,-0.326116373,-0.195232805,39,31,53,-8,22,14
j449,j,"Chronic obstructive pulmonary disease, unspecified",Diseases of the respiratory system,21560,19397,18857,-0.100324675,-0.027839357,-0.125371058,16,16,18,0,2,2
j4520,j,"Mild intermittent asthma, uncomplicated",Diseases of the respiratory system,1911,1780,2088,-0.068550497,0.173033708,0.092621664,231,235,215,4,-20,-16
j4521,j,Mild intermittent asthma with (acute) exacerbation,Diseases of the respiratory system,226,312,199,0.380530973,-0.362179487,-0.119469027,1100,859,1155,-241,296,55
j4522,j,Mild intermittent asthma with status asthmaticus,Diseases of the respiratory system,47,36,14,-0.234042553,-0.611111111,-0.70212766,2593,2803,4240,210,1437,1647
j4530,j,"Mild persistent asthma, uncomplicated",Diseases of the respiratory system,319,336,350,0.053291536,0.041666667,0.097178683,882,820,824,-62,4,-58
j4531,j,Mild persistent asthma with (acute) exacerbation,Diseases of the respiratory system,125,122,49,-0.024,-0.598360656,-0.608,1521,1486,2483,-35,997,962
j4540,j,"Moderate persistent asthma, uncomplicated",Diseases of the respiratory system,425,425,472,0,0.110588235,0.110588235,733,709,677,-24,-32,-56
j4541,j,Moderate persistent asthma with (acute) exacerbation,Diseases of the respiratory system,295,362,193,0.227118644,-0.466850829,-0.345762712,935,777,1169,-158,392,234
j4542,j,Moderate persistent asthma with status asthmaticus,Diseases of the respiratory system,98,66,36,-0.326530612,-0.454545455,-0.632653061,1758,2095,2857,337,762,1099
j4550,j,"Severe persistent asthma, uncomplicated",Diseases of the respiratory system,96,81,87,-0.15625,0.074074074,-0.09375,1777,1862,1820,85,-42,43
j4551,j,Severe persistent asthma with (acute) exacerbation,Diseases of the respiratory system,194,184,113,-0.051546392,-0.385869565,-0.417525773,1193,1180,1572,-13,392,379
j4552,j,Severe persistent asthma with status asthmaticus,Diseases of the respiratory system,62,51,31,-0.177419355,-0.392156863,-0.5,2265,2359,3092,94,733,827
j45901,j,Unspecified asthma with (acute) exacerbation,Diseases of the respiratory system,2120,2634,1738,0.24245283,-0.340167046,-0.180188679,209,164,247,-45,83,38
j45902,j,Unspecified asthma with status asthmaticus,Diseases of the respiratory system,243,183,86,-0.24691358,-0.530054645,-0.646090535,1043,1181,1829,138,648,786
j45909,j,"Unspecified asthma, uncomplicated",Diseases of the respiratory system,19359,17821,19349,-0.079446252,0.085741541,-0.000516556,16,16,17,0,1,1
j45990,j,Exercise induced bronchospasm,Diseases of the respiratory system,113,116,143,0.026548673,0.232758621,0.265486726,1623,1518,1355,-105,-163,-268
j45991,j,Cough variant asthma,Diseases of the respiratory system,18,23,22,0.277777778,-0.043478261,0.222222222,3998,3479,3594,-519,115,-404
j45998,j,Other asthma,Diseases of the respiratory system,186,157,92,-0.155913978,-0.414012739,-0.505376344,1209,1281,1766,72,485,557
j470,j,Bronchiectasis with acute lower respiratory infection,Diseases of the respiratory system,474,542,396,0.143459916,-0.269372694,-0.164556962,688,585,757,-103,172,69
j471,j,Bronchiectasis with (acute) exacerbation,Diseases of the respiratory system,171,164,102,-0.040935673,-0.37804878,-0.403508772,1272,1244,1655,-28,411,383
j479,j,"Bronchiectasis, uncomplicated",Diseases of the respiratory system,515,440,400,-0.145631068,-0.090909091,-0.223300971,650,693,752,43,59,102
j61,j,Pneumoconiosis due to asbestos and other mineral fibers,Diseases of the respiratory system,86,60,41,-0.302325581,-0.316666667,-0.523255814,1876,2182,2711,306,529,835
j679,j,Hypersensitivity pneumonitis due to unspecified organic dust,Diseases of the respiratory system,45,46,38,0.022222222,-0.173913043,-0.155555556,2632,2475,2796,-157,321,164
j680,j,"Bronchitis and pneumonitis due to chemicals, gases, fumes and vapors",Diseases of the respiratory system,54,24,23,-0.555555556,-0.041666667,-0.574074074,2414,3402,3520,988,118,1106
j690,j,Pneumonitis due to inhalation of food and vomit,Diseases of the respiratory system,7662,7674,7760,0.001566171,0.011206672,0.012790394,53,51,54,-2,3,1
j700,j,Acute pulmonary manifestations due to radiation,Diseases of the respiratory system,68,50,45,-0.264705882,-0.1,-0.338235294,2138,2366,2582,228,216,444
j701,j,Chronic and other pulmonary manifestations due to radiation,Diseases of the respiratory system,39,26,21,-0.333333333,-0.192307692,-0.461538462,2821,3280,3648,459,368,827
j702,j,Acute drug-induced interstitial lung disorders,Diseases of the respiratory system,16,12,13,-0.25,0.083333333,-0.1875,4144,4409,4315,265,-94,171
j704,j,"Drug-induced interstitial lung disorders, unspecified",Diseases of the respiratory system,41,35,42,-0.146341463,0.2,0.024390244,2749,2817,2673,68,-144,-76
j705,j,Respiratory conditions due to smoke inhalation,Diseases of the respiratory system,38,35,23,-0.078947368,-0.342857143,-0.394736842,2852,2817,3517,-35,700,665
j80,j,Acute respiratory distress syndrome,Diseases of the respiratory system,210,1028,3279,3.895238095,2.189688716,14.61428571,1142,361,139,-781,-222,-1003
j810,j,Acute pulmonary edema,Diseases of the respiratory system,971,819,766,-0.15653965,-0.064713065,-0.211122554,392,426,471,34,45,79
j811,j,Chronic pulmonary edema,Diseases of the respiratory system,1554,1578,1553,0.015444015,-0.015842839,-0.000643501,275,262,276,-13,14,1
j8410,j,"Pulmonary fibrosis, unspecified",Diseases of the respiratory system,1751,1695,1654,-0.031981725,-0.024188791,-0.055396916,247,242,258,-5,16,11
j84112,j,Idiopathic pulmonary fibrosis,Diseases of the respiratory system,381,374,297,-0.018372703,-0.205882353,-0.220472441,771,752,901,-19,149,130
j84114,j,Acute interstitial pneumonitis,Diseases of the respiratory system,16,15,12,-0.0625,-0.2,-0.25,4137,4116,4388,-21,272,251
j84116,j,Cryptogenic organizing pneumonia,Diseases of the respiratory system,29,24,18,-0.172413793,-0.25,-0.379310345,3239,3392,3862,153,470,623
j8489,j,Other specified interstitial pulmonary diseases,Diseases of the respiratory system,189,180,198,-0.047619048,0.1,0.047619048,1195,1179,1146,-16,-33,-49
j849,j,"Interstitial pulmonary disease, unspecified",Diseases of the respiratory system,663,641,545,-0.033182504,-0.149765991,-0.177978884,533,521,606,-12,85,73
j850,j,Gangrene and necrosis of lung,Diseases of the respiratory system,106,144,101,0.358490566,-0.298611111,-0.047169811,1663,1326,1657,-337,331,-6
j851,j,Abscess of lung with pneumonia,Diseases of the respiratory system,125,144,140,0.152,-0.027777778,0.12,1503,1326,1358,-177,32,-145
j852,j,Abscess of lung without pneumonia,Diseases of the respiratory system,60,40,47,-0.333333333,0.175,-0.216666667,2272,2645,2516,373,-129,244
j853,j,Abscess of mediastinum,Diseases of the respiratory system,26,33,22,0.269230769,-0.333333333,-0.153846154,3403,2888,3573,-515,685,170
j860,j,Pyothorax with fistula,Diseases of the respiratory system,94,99,113,0.053191489,0.141414141,0.20212766,1773,1631,1558,-142,-73,-215
j869,j,Pyothorax without fistula,Diseases of the respiratory system,465,551,455,0.184946237,-0.174228675,-0.021505376,689,574,686,-115,112,-3
j90,j,"Pleural effusion, not elsewhere classified",Diseases of the respiratory system,7774,7525,7321,-0.032029843,-0.027109635,-0.05827116,51,52,56,1,4,5
j910,j,Malignant pleural effusion,Diseases of the respiratory system,1026,909,868,-0.114035088,-0.04510451,-0.153996101,373,389,417,16,28,44
j918,j,Pleural effusion in other conditions classified elsewhere,Diseases of the respiratory system,1831,2104,2017,0.149098853,-0.04134981,0.101583834,236,194,215,-42,21,-21
j920,j,Pleural plaque with presence of asbestos,Diseases of the respiratory system,32,25,26,-0.21875,0.04,-0.1875,3078,3313,3311,235,-2,233
j929,j,Pleural plaque without asbestos,Diseases of the respiratory system,68,54,39,-0.205882353,-0.277777778,-0.426470588,2124,2269,2749,145,480,625
j930,j,Spontaneous tension pneumothorax,Diseases of the respiratory system,87,126,228,0.448275862,0.80952381,1.620689655,1848,1436,1050,-412,-386,-798
j9311,j,Primary spontaneous pneumothorax,Diseases of the respiratory system,56,54,46,-0.035714286,-0.148148148,-0.178571429,2351,2268,2537,-83,269,186
j9312,j,Secondary spontaneous pneumothorax,Diseases of the respiratory system,36,36,45,0,0.25,0.25,2901,2765,2565,-136,-200,-336
j9382,j,Other air leak,Diseases of the respiratory system,225,233,319,0.035555556,0.369098712,0.417777778,1084,1009,854,-75,-155,-230
j9383,j,Other pneumothorax,Diseases of the respiratory system,353,349,435,-0.011331445,0.246418338,0.232294618,809,778,708,-31,-70,-101
j939,j,"Pneumothorax, unspecified",Diseases of the respiratory system,577,623,869,0.079722704,0.394863563,0.506065858,573,528,415,-45,-113,-158
j940,j,Chylous effusion,Diseases of the respiratory system,16,21,29,0.3125,0.380952381,0.8125,4117,3596,3141,-521,-455,-976
j941,j,Fibrothorax,Diseases of the respiratory system,12,18,23,0.5,0.277777778,0.916666667,4444,3834,3493,-610,-341,-951
j942,j,Hemothorax,Diseases of the respiratory system,261,221,254,-0.153256705,0.149321267,-0.026819923,977,1056,982,79,-74,5
j948,j,Other specified pleural conditions,Diseases of the respiratory system,395,411,444,0.040506329,0.080291971,0.124050633,750,708,694,-42,-14,-56
j9501,j,Hemorrhage from tracheostomy stoma,Diseases of the respiratory system,52,67,58,0.288461538,-0.134328358,0.115384615,2430,2043,2232,-387,189,-198
j9502,j,Infection of tracheostomy stoma,Diseases of the respiratory system,28,27,20,-0.035714286,-0.259259259,-0.285714286,3272,3191,3678,-81,487,406
j9503,j,Malfunction of tracheostomy stoma,Diseases of the respiratory system,60,63,70,0.05,0.111111111,0.166666667,2260,2109,2031,-151,-78,-229
j9509,j,Other tracheostomy complication,Diseases of the respiratory system,43,36,35,-0.162790698,-0.027777778,-0.186046512,2664,2758,2865,94,107,201
j951,j,Acute pulmonary insufficiency following thoracic surgery,Diseases of the respiratory system,26,25,43,-0.038461538,0.72,0.653846154,3384,3300,2618,-84,-682,-766
j95811,j,Postprocedural pneumothorax,Diseases of the respiratory system,494,536,559,0.085020243,0.042910448,0.131578947,657,579,587,-78,8,-70
j95812,j,Postprocedural air leak,Diseases of the respiratory system,75,83,59,0.106666667,-0.289156627,-0.213333333,1999,1814,2215,-185,401,216
j95821,j,Acute postprocedural respiratory failure,Diseases of the respiratory system,584,470,455,-0.195205479,-0.031914894,-0.220890411,566,647,681,81,34,115
j95822,j,Acute and chronic postprocedural respiratory failure,Diseases of the respiratory system,19,12,17,-0.368421053,0.416666667,-0.105263158,3860,4369,3912,509,-457,52
j95830,j,Postprocedural hemorrhage of a respiratory system organ or structure following a respiratory system procedure,Diseases of the respiratory system,34,18,23,-0.470588235,0.277777778,-0.323529412,2970,3824,3484,854,-340,514
j9584,j,Transfusion-related acute lung injury (TRALI),Diseases of the respiratory system,26,34,24,0.307692308,-0.294117647,-0.076923077,3380,2818,3428,-562,610,48
j95851,j,Ventilator associated pneumonia,Diseases of the respiratory system,245,353,635,0.440816327,0.798866856,1.591836735,1017,769,540,-248,-229,-477
j9588,j,"Other intraoperative complications of respiratory system, not elsewhere classified",Diseases of the respiratory system,16,19,11,0.1875,-0.421052632,-0.3125,4103,3740,4446,-363,706,343
j9589,j,"Other postprocedural complications and disorders of respiratory system, not elsewhere classified",Diseases of the respiratory system,127,67,79,-0.472440945,0.179104478,-0.377952756,1474,2039,1888,565,-151,414
j9600,j,"Acute respiratory failure, unspecified whether with hypoxia or hypercapnia",Diseases of the respiratory system,2515,2525,2422,0.003976143,-0.040792079,-0.036978131,173,165,170,-8,5,-3
j9601,j,Acute respiratory failure with hypoxia,Diseases of the respiratory system,24494,33592,43266,0.371437903,0.287985235,0.766391769,12,8,8,-4,0,-4
j9602,j,Acute respiratory failure with hypercapnia,Diseases of the respiratory system,2451,2817,2407,0.149326805,-0.145544906,-0.017951856,177,152,171,-25,19,-6
j9610,j,"Chronic respiratory failure, unspecified whether with hypoxia or hypercapnia",Diseases of the respiratory system,1042,917,867,-0.119961612,-0.054525627,-0.167946257,361,382,412,21,30,51
j9611,j,Chronic respiratory failure with hypoxia,Diseases of the respiratory system,3236,3096,3084,-0.043263288,-0.003875969,-0.04697157,135,139,143,4,4,8
j9612,j,Chronic respiratory failure with hypercapnia,Diseases of the respiratory system,294,303,284,0.030612245,-0.062706271,-0.034013605,914,849,906,-65,57,-8
j9620,j,"Acute and chronic respiratory failure, unspecified whether with hypoxia or hypercapnia",Diseases of the respiratory system,473,476,360,0.006342495,-0.243697479,-0.238900634,672,632,788,-40,156,116
j9621,j,Acute and chronic respiratory failure with hypoxia,Diseases of the respiratory system,9129,10443,8905,0.143936904,-0.147275687,-0.024537189,40,34,42,-6,8,2
j9622,j,Acute and chronic respiratory failure with hypercapnia,Diseases of the respiratory system,2727,3012,2300,0.104510451,-0.236387782,-0.156582325,157,141,183,-16,42,26
j9690,j,"Respiratory failure, unspecified, unspecified whether with hypoxia or hypercapnia",Diseases of the respiratory system,620,636,645,0.025806452,0.014150943,0.040322581,541,516,519,-25,3,-22
j9691,j,"Respiratory failure, unspecified with hypoxia",Diseases of the respiratory system,769,1000,1102,0.300390117,0.102,0.433029909,467,359,337,-108,-22,-130
j9692,j,"Respiratory failure, unspecified with hypercapnia",Diseases of the respiratory system,100,81,104,-0.19,0.283950617,0.04,1692,1817,1601,125,-216,-91
j9801,j,Acute bronchospasm,Diseases of the respiratory system,211,236,139,0.118483412,-0.411016949,-0.341232227,1108,982,1343,-126,361,235
j9809,j,"Other diseases of bronchus, not elsewhere classified",Diseases of the respiratory system,573,318,293,-0.445026178,-0.078616352,-0.488656195,567,815,887,248,72,320
j9811,j,Atelectasis,Diseases of the respiratory system,7507,8302,6868,0.105901159,-0.172729463,-0.085120554,53,46,57,-7,11,4
j9819,j,Other pulmonary collapse,Diseases of the respiratory system,204,213,229,0.044117647,0.075117371,0.12254902,1131,1056,1025,-75,-31,-106
j982,j,Interstitial emphysema,Diseases of the respiratory system,249,336,658,0.34939759,0.958333333,1.642570281,993,786,510,-207,-276,-483
j984,j,Other disorders of lung,Diseases of the respiratory system,1084,1048,985,-0.033210332,-0.060114504,-0.091328413,345,344,372,-1,28,27
j9851,j,Mediastinitis,Diseases of the respiratory system,45,71,63,0.577777778,-0.112676056,0.4,2581,1947,2123,-634,176,-458
j9859,j,"Other diseases of mediastinum, not elsewhere classified",Diseases of the respiratory system,92,113,119,0.22826087,0.053097345,0.293478261,1766,1496,1480,-270,-16,-286
j986,j,Disorders of diaphragm,Diseases of the respiratory system,183,208,167,0.136612022,-0.197115385,-0.087431694,1182,1067,1215,-115,148,33
j988,j,Other specified respiratory disorders,Diseases of the respiratory system,108,140,121,0.296296296,-0.135714286,0.12037037,1612,1319,1458,-293,139,-154
k006,k,Disturbances in tooth eruption,Diseases of the digestive system,45,45,47,0,0.044444444,0.044444444,2578,2450,2476,-128,26,-102
k007,k,Teething syndrome,Diseases of the digestive system,34,28,23,-0.176470588,-0.178571429,-0.323529412,2945,3103,3458,158,355,513
k011,k,Impacted teeth,Diseases of the digestive system,29,23,29,-0.206896552,0.260869565,0,3186,3405,3107,219,-298,-79
k029,k,"Dental caries, unspecified",Diseases of the digestive system,630,576,453,-0.085714286,-0.213541667,-0.280952381,533,543,672,10,129,139
k0381,k,Cracked tooth,Diseases of the digestive system,26,31,27,0.192307692,-0.129032258,0.038461538,3352,2931,3215,-421,284,-137
k041,k,Necrosis of pulp,Diseases of the digestive system,91,68,52,-0.252747253,-0.235294118,-0.428571429,1773,1996,2341,223,345,568
k047,k,Periapical abscess without sinus,Diseases of the digestive system,743,690,639,-0.071332436,-0.073913043,-0.139973082,474,483,521,9,38,47
k0510,k,"Chronic gingivitis, plaque induced",Diseases of the digestive system,80,72,83,-0.1,0.152777778,0.0375,1911,1928,1811,17,-117,-100
k05219,k,"Aggressive periodontitis, localized, unspecified severity",Diseases of the digestive system,13,14,16,0.076923077,0.142857143,0.230769231,4326,4151,3960,-175,-191,-366
k0530,k,"Chronic periodontitis, unspecified",Diseases of the digestive system,33,32,23,-0.03030303,-0.28125,-0.303030303,2985,2887,3452,-98,565,467
k056,k,"Periodontal disease, unspecified",Diseases of the digestive system,77,73,55,-0.051948052,-0.246575342,-0.285714286,1947,1909,2270,-38,361,323
k068,k,Other specified disorders of gingiva and edentulous alveolar ridge,Diseases of the digestive system,82,64,70,-0.219512195,0.09375,-0.146341463,1879,2058,2003,179,-55,124
k08109,k,"Complete loss of teeth, unspecified cause, unspecified class",Diseases of the digestive system,30,24,29,-0.2,0.208333333,-0.033333333,3122,3328,3101,206,-227,-21
k0889,k,Other specified disorders of teeth and supporting structures,Diseases of the digestive system,458,481,432,0.050218341,-0.101871102,-0.056768559,676,618,692,-58,74,16
k089,k,"Disorder of teeth and supporting structures, unspecified",Diseases of the digestive system,64,73,69,0.140625,-0.054794521,0.078125,2165,1908,2012,-257,104,-153
k1120,k,"Sialoadenitis, unspecified",Diseases of the digestive system,125,103,81,-0.176,-0.213592233,-0.352,1469,1554,1831,85,277,362
k1121,k,Acute sialoadenitis,Diseases of the digestive system,58,59,61,0.017241379,0.033898305,0.051724138,2281,2142,2144,-139,2,-137
k117,k,Disturbances of salivary secretion,Diseases of the digestive system,101,106,102,0.04950495,-0.037735849,0.00990099,1672,1529,1607,-143,78,-65
k118,k,Other diseases of salivary glands,Diseases of the digestive system,17,17,18,0,0.058823529,0.058823529,3981,3881,3788,-100,-93,-193
k120,k,Recurrent oral aphthae,Diseases of the digestive system,99,87,84,-0.121212121,-0.034482759,-0.151515152,1685,1729,1797,44,68,112
k121,k,Other forms of stomatitis,Diseases of the digestive system,183,159,142,-0.131147541,-0.106918239,-0.224043716,1179,1224,1319,45,95,140
k122,k,Cellulitis and abscess of mouth,Diseases of the digestive system,246,213,217,-0.134146341,0.018779343,-0.117886179,995,1051,1043,56,-8,48
k1230,k,"Oral mucositis (ulcerative), unspecified",Diseases of the digestive system,264,226,198,-0.143939394,-0.123893805,-0.25,953,1014,1112,61,98,159
k1231,k,Oral mucositis (ulcerative) due to antineoplastic therapy,Diseases of the digestive system,175,151,123,-0.137142857,-0.185430464,-0.297142857,1208,1261,1439,53,178,231
k1233,k,Oral mucositis (ulcerative) due to radiation,Diseases of the digestive system,21,13,16,-0.380952381,0.230769231,-0.238095238,3657,4220,3945,563,-275,288
k130,k,Diseases of lips,Diseases of the digestive system,85,81,72,-0.047058824,-0.111111111,-0.152941176,1834,1798,1949,-36,151,115
k1370,k,Unspecified lesions of oral mucosa,Diseases of the digestive system,23,22,17,-0.043478261,-0.227272727,-0.260869565,3518,3452,3862,-66,410,344
k1379,k,Other lesions of oral mucosa,Diseases of the digestive system,112,87,95,-0.223214286,0.091954023,-0.151785714,1580,1725,1679,145,-46,99
k140,k,Glossitis,Diseases of the digestive system,41,74,65,0.804878049,-0.121621622,0.585365854,2677,1875,2068,-802,193,-609
k146,k,Glossodynia,Diseases of the digestive system,17,29,31,0.705882353,0.068965517,0.823529412,3971,3016,3004,-955,-12,-967
k148,k,Other diseases of tongue,Diseases of the digestive system,52,38,57,-0.269230769,0.5,0.096153846,2385,2642,2208,257,-434,-177
k149,k,"Disease of tongue, unspecified",Diseases of the digestive system,30,30,15,0,-0.5,-0.5,3108,2965,4033,-143,1068,925
k200,k,Eosinophilic esophagitis,Diseases of the digestive system,93,96,84,0.032258065,-0.125,-0.096774194,1741,1626,1792,-115,166,51
k219,k,Gastro-esophageal reflux disease without esophagitis,Diseases of the digestive system,52420,45832,46833,-0.125677222,0.021840635,-0.106581457,4,4,7,0,3,3
k220,k,Achalasia of cardia,Diseases of the digestive system,211,167,158,-0.208530806,-0.053892216,-0.251184834,1098,1182,1240,84,58,142
k2210,k,Ulcer of esophagus without bleeding,Diseases of the digestive system,516,498,484,-0.034883721,-0.02811245,-0.062015504,623,604,637,-19,33,14
k2211,k,Ulcer of esophagus with bleeding,Diseases of the digestive system,260,313,328,0.203846154,0.047923323,0.261538462,954,815,815,-139,0,-139
k222,k,Esophageal obstruction,Diseases of the digestive system,897,914,896,0.018952062,-0.019693654,-0.001114827,398,375,397,-23,22,-1
k223,k,Perforation of esophagus,Diseases of the digestive system,69,95,79,0.376811594,-0.168421053,0.144927536,2056,1630,1849,-426,219,-207
k224,k,Dyskinesia of esophagus,Diseases of the digestive system,341,262,265,-0.231671554,0.011450382,-0.2228739,801,906,933,105,27,132
k225,k,"Diverticulum of esophagus, acquired",Diseases of the digestive system,92,87,72,-0.054347826,-0.172413793,-0.217391304,1746,1717,1940,-29,223,194
k226,k,Gastro-esophageal laceration-hemorrhage syndrome,Diseases of the digestive system,190,183,186,-0.036842105,0.016393443,-0.021052632,1150,1131,1142,-19,11,-8
k2270,k,Barrett's esophagus without dysplasia,Diseases of the digestive system,1179,1096,1019,-0.070398643,-0.070255474,-0.135708227,322,327,358,5,31,36
k228,k,Other specified diseases of esophagus,Diseases of the digestive system,466,452,439,-0.030042918,-0.028761062,-0.057939914,662,650,679,-12,29,17
k229,k,"Disease of esophagus, unspecified",Diseases of the digestive system,56,53,63,-0.053571429,0.188679245,0.125,2289,2226,2092,-63,-134,-197
k250,k,Acute gastric ulcer with hemorrhage,Diseases of the digestive system,60,61,87,0.016666667,0.426229508,0.45,2205,2087,1749,-118,-338,-456
k251,k,Acute gastric ulcer with perforation,Diseases of the digestive system,19,20,30,0.052631579,0.5,0.578947368,3791,3599,3035,-192,-564,-756
k253,k,Acute gastric ulcer without hemorrhage or perforation,Diseases of the digestive system,36,38,29,0.055555556,-0.236842105,-0.194444444,2831,2628,3071,-203,443,240
k254,k,Chronic or unspecified gastric ulcer with hemorrhage,Diseases of the digestive system,603,609,741,0.009950249,0.216748768,0.228855721,538,523,462,-15,-61,-76
k255,k,Chronic or unspecified gastric ulcer with perforation,Diseases of the digestive system,90,101,94,0.122222222,-0.069306931,0.044444444,1764,1556,1677,-208,121,-87
k256,k,Chronic or unspecified gastric ulcer with both hemorrhage and perforation,Diseases of the digestive system,13,22,17,0.692307692,-0.227272727,0.307692308,4285,3430,3840,-855,410,-445
k257,k,Chronic gastric ulcer without hemorrhage or perforation,Diseases of the digestive system,71,53,55,-0.253521127,0.037735849,-0.225352113,2017,2223,2239,206,16,222
k259,k,"Gastric ulcer, unspecified as acute or chronic, without hemorrhage or perforation",Diseases of the digestive system,815,781,707,-0.041717791,-0.09475032,-0.132515337,439,424,488,-15,64,49
k260,k,Acute duodenal ulcer with hemorrhage,Diseases of the digestive system,55,68,70,0.236363636,0.029411765,0.272727273,2309,1966,1977,-343,11,-332
k261,k,Acute duodenal ulcer with perforation,Diseases of the digestive system,16,17,12,0.0625,-0.294117647,-0.25,4028,3847,4275,-181,428,247
k263,k,Acute duodenal ulcer without hemorrhage or perforation,Diseases of the digestive system,35,25,26,-0.285714286,0.04,-0.257142857,2865,3226,3224,361,-2,359
k264,k,Chronic or unspecified duodenal ulcer with hemorrhage,Diseases of the digestive system,485,537,635,0.107216495,0.182495345,0.309278351,643,560,522,-83,-38,-121
k265,k,Chronic or unspecified duodenal ulcer with perforation,Diseases of the digestive system,72,81,81,0.125,0,0.125,1999,1781,1809,-218,28,-190
k266,k,Chronic or unspecified duodenal ulcer with both hemorrhage and perforation,Diseases of the digestive system,11,17,19,0.545454545,0.117647059,0.727272727,4412,3844,3673,-568,-171,-739
k267,k,Chronic duodenal ulcer without hemorrhage or perforation,Diseases of the digestive system,45,22,31,-0.511111111,0.409090909,-0.311111111,2538,3424,2982,886,-442,444
k269,k,"Duodenal ulcer, unspecified as acute or chronic, without hemorrhage or perforation",Diseases of the digestive system,541,516,479,-0.046210721,-0.071705426,-0.114602588,599,582,636,-17,54,37
k274,k,"Chronic or unspecified peptic ulcer, site unspecified, with hemorrhage",Diseases of the digestive system,50,38,54,-0.24,0.421052632,0.08,2415,2620,2258,205,-362,-157
k277,k,"Chronic peptic ulcer, site unspecified, without hemorrhage or perforation",Diseases of the digestive system,19,15,22,-0.210526316,0.466666667,0.157894737,3779,3997,3469,218,-528,-310
k279,k,"Peptic ulcer, site unspecified, unspecified as acute or chronic, without hemorrhage or perforation",Diseases of the digestive system,565,519,482,-0.081415929,-0.071290944,-0.146902655,563,578,634,15,56,71
k284,k,Chronic or unspecified gastrojejunal ulcer with hemorrhage,Diseases of the digestive system,40,65,58,0.625,-0.107692308,0.45,2681,2010,2165,-671,155,-516
k285,k,Chronic or unspecified gastrojejunal ulcer with perforation,Diseases of the digestive system,13,25,17,0.923076923,-0.32,0.307692308,4272,3220,3827,-1052,607,-445
k289,k,"Gastrojejunal ulcer, unspecified as acute or chronic, without hemorrhage or perforation",Diseases of the digestive system,59,54,47,-0.084745763,-0.12962963,-0.203389831,2224,2193,2431,-31,238,207
k2900,k,Acute gastritis without bleeding,Diseases of the digestive system,305,262,306,-0.140983607,0.167938931,0.003278689,869,899,845,30,-54,-24
k2901,k,Acute gastritis with bleeding,Diseases of the digestive system,78,87,93,0.115384615,0.068965517,0.192307692,1902,1707,1681,-195,-26,-221
k2920,k,Alcoholic gastritis without bleeding,Diseases of the digestive system,360,407,411,0.130555556,0.00982801,0.141666667,767,684,704,-83,20,-63
k2921,k,Alcoholic gastritis with bleeding,Diseases of the digestive system,64,72,57,0.125,-0.208333333,-0.109375,2133,1893,2182,-240,289,49
k2930,k,Chronic superficial gastritis without bleeding,Diseases of the digestive system,17,16,16,-0.058823529,0,-0.058823529,3934,3919,3901,-15,-18,-33
k2940,k,Chronic atrophic gastritis without bleeding,Diseases of the digestive system,40,22,22,-0.45,0,-0.45,2676,3414,3462,738,48,786
k2950,k,Unspecified chronic gastritis without bleeding,Diseases of the digestive system,553,487,488,-0.119349005,0.002053388,-0.117540687,579,604,630,25,26,51
k2951,k,Unspecified chronic gastritis with bleeding,Diseases of the digestive system,69,56,71,-0.188405797,0.267857143,0.028985507,2039,2153,1950,114,-203,-89
k2960,k,Other gastritis without bleeding,Diseases of the digestive system,233,233,193,0,-0.17167382,-0.17167382,1017,969,1108,-48,139,91
k2961,k,Other gastritis with bleeding,Diseases of the digestive system,52,54,49,0.038461538,-0.092592593,-0.057692308,2354,2186,2369,-168,183,15
k2970,k,"Gastritis, unspecified, without bleeding",Diseases of the digestive system,3134,2857,2758,-0.08838545,-0.034651733,-0.119974474,136,144,147,8,3,11
k2971,k,"Gastritis, unspecified, with bleeding",Diseases of the digestive system,395,403,489,0.020253165,0.213399504,0.237974684,720,686,626,-34,-60,-94
k2980,k,Duodenitis without bleeding,Diseases of the digestive system,818,721,684,-0.118581907,-0.051317614,-0.163814181,436,457,494,21,37,58
k2981,k,Duodenitis with bleeding,Diseases of the digestive system,126,128,155,0.015873016,0.2109375,0.23015873,1436,1360,1237,-76,-123,-199
k2990,k,"Gastroduodenitis, unspecified, without bleeding",Diseases of the digestive system,39,33,29,-0.153846154,-0.121212121,-0.256410256,2706,2783,3046,77,263,340
k30,k,Functional dyspepsia,Diseases of the digestive system,379,279,1679,-0.263852243,5.017921147,3.430079156,737,862,240,125,-622,-497
k311,k,Adult hypertrophic pyloric stenosis,Diseases of the digestive system,327,341,356,0.042813456,0.04398827,0.088685015,812,758,765,-54,7,-47
k314,k,Gastric diverticulum,Diseases of the digestive system,16,11,11,-0.3125,0,-0.3125,4001,4347,4339,346,-8,338
k315,k,Obstruction of duodenum,Diseases of the digestive system,227,208,262,-0.083700441,0.259615385,0.154185022,1030,1041,919,11,-122,-111
k316,k,Fistula of stomach and duodenum,Diseases of the digestive system,116,88,88,-0.24137931,0,-0.24137931,1520,1681,1725,161,44,205
k317,k,Polyp of stomach and duodenum,Diseases of the digestive system,373,355,383,-0.048257373,0.078873239,0.026809651,745,733,728,-12,-5,-17
k31811,k,Angiodysplasia of stomach and duodenum with bleeding,Diseases of the digestive system,133,148,155,0.112781955,0.047297297,0.165413534,1382,1241,1233,-141,-8,-149
k31819,k,Angiodysplasia of stomach and duodenum without bleeding,Diseases of the digestive system,129,126,138,-0.023255814,0.095238095,0.069767442,1405,1375,1312,-30,-63,-93
k3182,k,Dieulafoy lesion (hemorrhagic) of stomach and duodenum,Diseases of the digestive system,34,34,42,0,0.235294118,0.235294118,2875,2727,2554,-148,-173,-321
k3184,k,Gastroparesis,Diseases of the digestive system,2597,2393,2302,-0.078552176,-0.03802758,-0.113592607,159,161,178,2,17,19
k3189,k,Other diseases of stomach and duodenum,Diseases of the digestive system,1688,1563,1920,-0.074052133,0.22840691,0.137440758,245,251,212,6,-39,-33
k319,k,"Disease of stomach and duodenum, unspecified",Diseases of the digestive system,330,296,246,-0.103030303,-0.168918919,-0.254545455,801,826,953,25,127,152
k3520,k,"Acute appendicitis with generalized peritonitis, without abscess",Diseases of the digestive system,83,107,91,0.289156627,-0.14953271,0.096385542,1821,1489,1690,-332,201,-131
k3521,k,"Acute appendicitis with generalized peritonitis, with abscess",Diseases of the digestive system,60,60,42,0,-0.3,-0.3,2175,2071,2550,-104,479,375
k3530,k,"Acute appendicitis with localized peritonitis, without perforation or gangrene",Diseases of the digestive system,60,45,66,-0.25,0.466666667,0.1,2175,2382,2002,207,-380,-173
k3532,k,"Acute appendicitis with perforation and localized peritonitis, without abscess",Diseases of the digestive system,433,418,455,-0.034642032,0.088516746,0.050808314,676,668,651,-8,-17,-25
k3533,k,"Acute appendicitis with perforation and localized peritonitis, with abscess",Diseases of the digestive system,313,340,320,0.086261981,-0.058823529,0.022364217,841,755,807,-86,52,-34
k3580,k,Unspecified acute appendicitis,Diseases of the digestive system,526,446,473,-0.152091255,0.060538117,-0.100760456,606,646,633,40,-13,27
k35891,k,"Other acute appendicitis without perforation, with gangrene",Diseases of the digestive system,42,43,35,0.023809524,-0.186046512,-0.166666667,2589,2432,2761,-157,329,172
k36,k,Other appendicitis,Diseases of the digestive system,21,24,26,0.142857143,0.083333333,0.238095238,3590,3252,3185,-338,-67,-405
k37,k,Unspecified appendicitis,Diseases of the digestive system,102,86,90,-0.156862745,0.046511628,-0.117647059,1621,1696,1700,75,4,79
k381,k,Appendicular concretions,Diseases of the digestive system,163,187,145,0.147239264,-0.22459893,-0.110429448,1222,1100,1269,-122,169,47
k388,k,Other specified diseases of appendix,Diseases of the digestive system,17,26,30,0.529411765,0.153846154,0.764705882,3903,3135,2990,-768,-145,-913
k4020,k,"Bilateral inguinal hernia, without obstruction or gangrene, not specified as recurrent",Diseases of the digestive system,228,245,192,0.074561404,-0.216326531,-0.157894737,1015,923,1098,-92,175,83
k4030,k,"Unilateral inguinal hernia, with obstruction, without gangrene, not specified as recurrent",Diseases of the digestive system,201,165,172,-0.179104478,0.042424242,-0.144278607,1097,1164,1160,67,-4,63
k4031,k,"Unilateral inguinal hernia, with obstruction, without gangrene, recurrent",Diseases of the digestive system,16,20,22,0.25,0.1,0.375,3979,3544,3429,-435,-115,-550
k4090,k,"Unilateral inguinal hernia, without obstruction or gangrene, not specified as recurrent",Diseases of the digestive system,733,685,689,-0.065484311,0.005839416,-0.060027285,474,478,485,4,7,11
k4091,k,"Unilateral inguinal hernia, without obstruction or gangrene, recurrent",Diseases of the digestive system,26,18,19,-0.307692308,0.055555556,-0.269230769,3264,3697,3626,433,-71,362
k4130,k,"Unilateral femoral hernia, with obstruction, without gangrene, not specified as recurrent",Diseases of the digestive system,22,26,25,0.181818182,-0.038461538,0.136363636,3514,3132,3237,-382,105,-277
k420,k,"Umbilical hernia with obstruction, without gangrene",Diseases of the digestive system,194,201,171,0.036082474,-0.149253731,-0.118556701,1114,1051,1163,-63,112,49
k429,k,Umbilical hernia without obstruction or gangrene,Diseases of the digestive system,1107,1044,1007,-0.056910569,-0.035440613,-0.090334237,334,340,357,6,17,23
k430,k,"Incisional hernia with obstruction, without gangrene",Diseases of the digestive system,238,206,208,-0.134453782,0.009708738,-0.12605042,989,1036,1041,47,5,52
k432,k,Incisional hernia without obstruction or gangrene,Diseases of the digestive system,552,431,429,-0.219202899,-0.004640371,-0.222826087,574,657,673,83,16,99
k433,k,"Parastomal hernia with obstruction, without gangrene",Diseases of the digestive system,54,56,43,0.037037037,-0.232142857,-0.203703704,2284,2124,2508,-160,384,224
k435,k,Parastomal hernia without obstruction or gangrene,Diseases of the digestive system,253,242,251,-0.043478261,0.037190083,-0.007905138,946,927,936,-19,9,-10
k436,k,"Other and unspecified ventral hernia with obstruction, without gangrene",Diseases of the digestive system,218,199,248,-0.087155963,0.246231156,0.137614679,1040,1053,941,13,-112,-99
k439,k,Ventral hernia without obstruction or gangrene,Diseases of the digestive system,871,763,712,-0.123995408,-0.066841415,-0.182548794,409,429,480,20,51,71
k440,k,"Diaphragmatic hernia with obstruction, without gangrene",Diseases of the digestive system,75,62,44,-0.173333333,-0.290322581,-0.413333333,1907,2027,2475,120,448,568
k449,k,Diaphragmatic hernia without obstruction or gangrene,Diseases of the digestive system,6880,6337,6610,-0.078924419,0.043080322,-0.039244186,57,60,60,3,0,3
k450,k,"Other specified abdominal hernia with obstruction, without gangrene",Diseases of the digestive system,19,24,18,0.263157895,-0.25,-0.052631579,3726,3235,3694,-491,459,-32
k458,k,Other specified abdominal hernia without obstruction or gangrene,Diseases of the digestive system,34,33,42,-0.029411765,0.272727273,0.235294118,2850,2750,2531,-100,-219,-319
k460,k,"Unspecified abdominal hernia with obstruction, without gangrene",Diseases of the digestive system,70,100,72,0.428571429,-0.28,0.028571429,1990,1530,1893,-460,363,-97
k469,k,Unspecified abdominal hernia without obstruction or gangrene,Diseases of the digestive system,206,135,167,-0.344660194,0.237037037,-0.189320388,1079,1298,1169,219,-129,90
k5000,k,Crohn's disease of small intestine without complications,Diseases of the digestive system,94,88,103,-0.063829787,0.170454545,0.095744681,1680,1657,1546,-23,-111,-134
k50012,k,Crohn's disease of small intestine with intestinal obstruction,Diseases of the digestive system,58,50,71,-0.137931034,0.42,0.224137931,2207,2226,1915,19,-311,-292
k50013,k,Crohn's disease of small intestine with fistula,Diseases of the digestive system,13,12,21,-0.076923077,0.75,0.615384615,4211,4216,3471,5,-745,-740
k5010,k,Crohn's disease of large intestine without complications,Diseases of the digestive system,94,89,82,-0.053191489,-0.078651685,-0.127659574,1680,1645,1759,-35,114,79
k50111,k,Crohn's disease of large intestine with rectal bleeding,Diseases of the digestive system,19,18,14,-0.052631579,-0.222222222,-0.263157895,3720,3679,4024,-41,345,304
k50112,k,Crohn's disease of large intestine with intestinal obstruction,Diseases of the digestive system,19,17,14,-0.105263158,-0.176470588,-0.263157895,3720,3777,4024,57,247,304
k50113,k,Crohn's disease of large intestine with fistula,Diseases of the digestive system,15,19,12,0.266666667,-0.368421053,-0.2,4044,3598,4200,-446,602,156
k50114,k,Crohn's disease of large intestine with abscess,Diseases of the digestive system,11,18,11,0.636363636,-0.388888889,0,4339,3678,4292,-661,614,-47
k5080,k,Crohn's disease of both small and large intestine without complications,Diseases of the digestive system,45,33,37,-0.266666667,0.121212121,-0.177777778,2486,2745,2665,259,-80,179
k50812,k,Crohn's disease of both small and large intestine with intestinal obstruction,Diseases of the digestive system,20,15,14,-0.25,-0.066666667,-0.3,3644,3928,4023,284,95,379
k50813,k,Crohn's disease of both small and large intestine with fistula,Diseases of the digestive system,12,11,17,-0.083333333,0.545454545,0.416666667,4273,4297,3765,24,-532,-508
k5090,k,"Crohn's disease, unspecified, without complications",Diseases of the digestive system,1171,1105,1085,-0.056362084,-0.018099548,-0.073441503,320,316,335,-4,19,15
k50911,k,"Crohn's disease, unspecified, with rectal bleeding",Diseases of the digestive system,24,48,36,1,-0.25,0.5,3361,2280,2689,-1081,409,-672
k50912,k,"Crohn's disease, unspecified, with intestinal obstruction",Diseases of the digestive system,16,22,22,0.375,0,0.375,3953,3359,3408,-594,49,-545
k50913,k,"Crohn's disease, unspecified, with fistula",Diseases of the digestive system,30,26,22,-0.133333333,-0.153846154,-0.266666667,3024,3113,3408,89,295,384
k50914,k,"Crohn's disease, unspecified, with abscess",Diseases of the digestive system,13,13,15,0,0.153846154,0.153846154,4201,4108,3932,-93,-176,-269
k50918,k,"Crohn's disease, unspecified, with other complication",Diseases of the digestive system,14,17,14,0.214285714,-0.176470588,0,4115,3770,4017,-345,247,-98
k5100,k,Ulcerative (chronic) pancolitis without complications,Diseases of the digestive system,179,133,184,-0.25698324,0.383458647,0.027932961,1145,1312,1117,167,-195,-28
k51011,k,Ulcerative (chronic) pancolitis with rectal bleeding,Diseases of the digestive system,29,24,35,-0.172413793,0.458333333,0.206896552,3077,3224,2736,147,-488,-341
k5120,k,Ulcerative (chronic) proctitis without complications,Diseases of the digestive system,17,16,17,-0.058823529,0.0625,0,3872,3852,3759,-20,-93,-113
k5130,k,Ulcerative (chronic) rectosigmoiditis without complications,Diseases of the digestive system,24,19,24,-0.208333333,0.263157895,0,3358,3591,3289,233,-302,-69
k5150,k,Left sided colitis without complications,Diseases of the digestive system,37,52,51,0.405405405,-0.019230769,0.378378378,2724,2187,2278,-537,91,-446
k51511,k,Left sided colitis with rectal bleeding,Diseases of the digestive system,11,16,18,0.454545455,0.125,0.636363636,4325,3850,3678,-475,-172,-647
k5190,k,"Ulcerative colitis, unspecified, without complications",Diseases of the digestive system,840,764,823,-0.09047619,0.077225131,-0.020238095,419,426,415,7,-11,-4
k51911,k,"Ulcerative colitis, unspecified with rectal bleeding",Diseases of the digestive system,71,69,57,-0.028169014,-0.173913043,-0.197183099,1969,1898,2139,-71,241,170
k520,k,Gastroenteritis and colitis due to radiation,Diseases of the digestive system,62,46,34,-0.258064516,-0.260869565,-0.451612903,2123,2325,2776,202,451,653
k521,k,Toxic gastroenteritis and colitis,Diseases of the digestive system,706,611,596,-0.134560907,-0.024549918,-0.155807365,486,510,526,24,16,40
k5229,k,Other allergic and dietetic gastroenteritis and colitis,Diseases of the digestive system,10,11,10,0.1,-0.090909091,0,4388,4281,4351,-107,70,-37
k523,k,Indeterminate colitis,Diseases of the digestive system,30,31,20,0.033333333,-0.35483871,-0.333333333,3018,2823,3517,-195,694,499
k52831,k,Collagenous colitis,Diseases of the digestive system,43,48,44,0.11627907,-0.083333333,0.023255814,2536,2275,2463,-261,188,-73
k52832,k,Lymphocytic colitis,Diseases of the digestive system,49,51,52,0.040816327,0.019607843,0.06122449,2379,2202,2249,-177,47,-130
k52839,k,"Microscopic colitis, unspecified",Diseases of the digestive system,45,40,58,-0.111111111,0.45,0.288888889,2479,2499,2118,20,-381,-361
k5289,k,Other specified noninfective gastroenteritis and colitis,Diseases of the digestive system,212,196,215,-0.075471698,0.096938776,0.014150943,1055,1059,1008,4,-51,-47
k529,k,"Noninfective gastroenteritis and colitis, unspecified",Diseases of the digestive system,4322,3969,4075,-0.08167515,0.026706979,-0.057149468,105,109,116,4,7,11
k55011,k,Focal (segmental) acute (reversible) ischemia of small intestine,Diseases of the digestive system,19,14,13,-0.263157895,-0.071428571,-0.315789474,3701,4007,4095,306,88,394
k55019,k,"Acute (reversible) ischemia of small intestine, extent unspecified",Diseases of the digestive system,54,46,44,-0.148148148,-0.043478261,-0.185185185,2266,2320,2459,54,139,193
k55021,k,Focal (segmental) acute infarction of small intestine,Diseases of the digestive system,21,33,24,0.571428571,-0.272727273,0.142857143,3548,2731,3278,-817,547,-270
k55029,k,"Acute infarction of small intestine, extent unspecified",Diseases of the digestive system,76,94,84,0.236842105,-0.106382979,0.105263158,1882,1591,1732,-291,141,-150
k55039,k,"Acute (reversible) ischemia of large intestine, extent unspecified",Diseases of the digestive system,74,85,74,0.148648649,-0.129411765,0,1920,1680,1848,-240,168,-72
k55049,k,"Acute infarction of large intestine, extent unspecified",Diseases of the digestive system,35,42,55,0.2,0.30952381,0.571428571,2790,2428,2178,-362,-250,-612
k55059,k,"Acute (reversible) ischemia of intestine, part and extent unspecified",Diseases of the digestive system,40,74,108,0.85,0.459459459,1.7,2616,1808,1504,-808,-304,-1112
k55069,k,"Acute infarction of intestine, part and extent unspecified",Diseases of the digestive system,118,141,122,0.194915254,-0.134751773,0.033898305,1475,1260,1389,-215,129,-86
k551,k,Chronic vascular disorders of intestine,Diseases of the digestive system,206,174,214,-0.155339806,0.229885057,0.038834951,1074,1111,1013,37,-98,-61
k5520,k,Angiodysplasia of colon without hemorrhage,Diseases of the digestive system,89,96,91,0.078651685,-0.052083333,0.02247191,1722,1568,1664,-154,96,-58
k5521,k,Angiodysplasia of colon with hemorrhage,Diseases of the digestive system,99,95,98,-0.04040404,0.031578947,-0.01010101,1623,1576,1591,-47,15,-32
k558,k,Other vascular disorders of intestine,Diseases of the digestive system,29,43,41,0.482758621,-0.046511628,0.413793103,3057,2392,2538,-665,146,-519
k559,k,"Vascular disorder of intestine, unspecified",Diseases of the digestive system,600,556,564,-0.073333333,0.014388489,-0.06,525,536,552,11,16,27
k560,k,Paralytic ileus,Diseases of the digestive system,284,257,250,-0.095070423,-0.027237354,-0.11971831,881,889,930,8,41,49
k561,k,Intussusception,Diseases of the digestive system,125,99,113,-0.208,0.141414141,-0.096,1409,1529,1461,120,-68,52
k562,k,Volvulus,Diseases of the digestive system,265,233,236,-0.120754717,0.012875536,-0.109433962,915,944,962,29,18,47
k5641,k,Fecal impaction,Diseases of the digestive system,593,503,531,-0.151770658,0.055666004,-0.10455312,530,580,576,50,-4,46
k5649,k,Other impaction of intestine,Diseases of the digestive system,21,21,16,0,-0.238095238,-0.238095238,3534,3410,3807,-124,397,273
k5650,k,"Intestinal adhesions [bands], unspecified as to partial versus complete obstruction",Diseases of the digestive system,354,365,312,0.031073446,-0.145205479,-0.118644068,755,711,811,-44,100,56
k5651,k,"Intestinal adhesions [bands], with partial obstruction",Diseases of the digestive system,218,203,206,-0.068807339,0.014778325,-0.055045872,1029,1032,1034,3,2,5
k5652,k,Intestinal adhesions [bands] with complete obstruction,Diseases of the digestive system,39,32,22,-0.179487179,-0.3125,-0.435897436,2642,2760,3377,118,617,735
k56600,k,"Partial intestinal obstruction, unspecified as to cause",Diseases of the digestive system,938,818,830,-0.12793177,0.014669927,-0.115138593,376,402,406,26,4,30
k56601,k,"Complete intestinal obstruction, unspecified as to cause",Diseases of the digestive system,31,16,32,-0.483870968,1,0.032258065,2942,3819,2847,877,-972,-95
k56609,k,"Unspecified intestinal obstruction, unspecified as to partial versus complete obstruction",Diseases of the digestive system,1933,1892,1804,-0.021210554,-0.046511628,-0.066735644,211,203,223,-8,20,12
k56690,k,Other partial intestinal obstruction,Diseases of the digestive system,150,127,134,-0.153333333,0.05511811,-0.106666667,1264,1328,1304,64,-24,40
k56691,k,Other complete intestinal obstruction,Diseases of the digestive system,20,12,15,-0.4,0.25,-0.25,3603,4162,3892,559,-270,289
k56699,k,Other intestinal obstruction unspecified as to partial versus complete obstruction,Diseases of the digestive system,217,199,246,-0.082949309,0.236180905,0.133640553,1033,1039,933,6,-106,-100
k567,k,"Ileus, unspecified",Diseases of the digestive system,3715,3295,3439,-0.113055182,0.04370258,-0.074293405,117,127,128,10,1,11
k5700,k,Diverticulitis of small intestine with perforation and abscess without bleeding,Diseases of the digestive system,30,21,31,-0.3,0.476190476,0.033333333,2990,3402,2888,412,-514,-102
k5710,k,Diverticulosis of small intestine without perforation or abscess without bleeding,Diseases of the digestive system,196,142,159,-0.275510204,0.11971831,-0.18877551,1084,1241,1179,157,-62,95
k5712,k,Diverticulitis of small intestine without perforation or abscess without bleeding,Diseases of the digestive system,26,19,16,-0.269230769,-0.157894737,-0.384615385,3206,3553,3796,347,243,590
k5720,k,Diverticulitis of large intestine with perforation and abscess without bleeding,Diseases of the digestive system,959,934,992,-0.026068822,0.062098501,0.034410845,369,359,356,-10,-3,-13
k5721,k,Diverticulitis of large intestine with perforation and abscess with bleeding,Diseases of the digestive system,27,18,31,-0.333333333,0.722222222,0.148148148,3149,3630,2886,481,-744,-263
k5730,k,Diverticulosis of large intestine without perforation or abscess without bleeding,Diseases of the digestive system,2830,2637,2448,-0.06819788,-0.071672355,-0.134982332,145,149,159,4,10,14
k5731,k,Diverticulosis of large intestine without perforation or abscess with bleeding,Diseases of the digestive system,264,290,307,0.098484848,0.05862069,0.162878788,908,823,810,-85,-13,-98
k5732,k,Diverticulitis of large intestine without perforation or abscess without bleeding,Diseases of the digestive system,1327,1017,1092,-0.233609646,0.073746313,-0.177091183,291,340,327,49,-13,36
k5733,k,Diverticulitis of large intestine without perforation or abscess with bleeding,Diseases of the digestive system,79,72,74,-0.088607595,0.027777778,-0.063291139,1828,1826,1826,-2,0,-2
k5750,k,Diverticulosis of both small and large intestine without perforation or abscess without bleeding,Diseases of the digestive system,37,36,28,-0.027027027,-0.222222222,-0.243243243,2688,2593,3018,-95,425,330
k5780,k,"Diverticulitis of intestine, part unspecified, with perforation and abscess without bleeding",Diseases of the digestive system,106,101,129,-0.047169811,0.277227723,0.216981132,1548,1494,1329,-54,-165,-219
k5790,k,"Diverticulosis of intestine, part unspecified, without perforation or abscess without bleeding",Diseases of the digestive system,1338,1167,1072,-0.127802691,-0.081405313,-0.198804185,289,301,334,12,33,45
k5791,k,"Diverticulosis of intestine, part unspecified, without perforation or abscess with bleeding",Diseases of the digestive system,75,81,62,0.08,-0.234567901,-0.173333333,1872,1708,2021,-164,313,149
k5792,k,"Diverticulitis of intestine, part unspecified, without perforation or abscess without bleeding",Diseases of the digestive system,628,535,512,-0.148089172,-0.042990654,-0.184713376,509,540,584,31,44,75
k5793,k,"Diverticulitis of intestine, part unspecified, without perforation or abscess with bleeding",Diseases of the digestive system,17,11,11,-0.352941176,0,-0.352941176,3818,4233,4225,415,-8,407
k580,k,Irritable bowel syndrome with diarrhea,Diseases of the digestive system,380,349,376,-0.081578947,0.077363897,-0.010526316,712,718,714,6,-4,2
k581,k,Irritable bowel syndrome with constipation,Diseases of the digestive system,201,212,244,0.054726368,0.150943396,0.213930348,1065,999,928,-66,-71,-137
k582,k,Mixed irritable bowel syndrome,Diseases of the digestive system,86,66,66,-0.23255814,0,-0.23255814,1732,1920,1945,188,25,213
k588,k,Other irritable bowel syndrome,Diseases of the digestive system,17,15,13,-0.117647059,-0.133333333,-0.235294118,3815,3864,4051,49,187,236
k589,k,Irritable bowel syndrome without diarrhea,Diseases of the digestive system,2574,2126,2086,-0.174048174,-0.018814675,-0.18958819,157,178,197,21,19,40
k5900,k,"Constipation, unspecified",Diseases of the digestive system,15894,14542,16356,-0.085063546,0.124742126,0.029067573,17,18,17,1,-1,0
k5901,k,Slow transit constipation,Diseases of the digestive system,210,204,202,-0.028571429,-0.009803922,-0.038095238,1041,1016,1035,-25,19,-6
k5903,k,Drug induced constipation,Diseases of the digestive system,1652,1438,1475,-0.129539952,0.025730181,-0.107142857,240,261,260,21,-1,20
k5904,k,Chronic idiopathic constipation,Diseases of the digestive system,129,116,105,-0.100775194,-0.094827586,-0.186046512,1355,1386,1494,31,108,139
k5909,k,Other constipation,Diseases of the digestive system,2053,1722,1836,-0.161227472,0.066202091,-0.105698977,195,218,215,23,-3,20
k592,k,"Neurogenic bowel, not elsewhere classified",Diseases of the digestive system,485,455,458,-0.06185567,0.006593407,-0.055670103,612,616,624,4,8,12
k5931,k,Toxic megacolon,Diseases of the digestive system,14,12,16,-0.142857143,0.333333333,0.142857143,4046,4135,3775,89,-360,-271
k5939,k,Other megacolon,Diseases of the digestive system,72,74,88,0.027777778,0.189189189,0.222222222,1913,1774,1660,-139,-114,-253
k602,k,"Anal fissure, unspecified",Diseases of the digestive system,82,74,97,-0.097560976,0.310810811,0.182926829,1774,1774,1570,0,-204,-204
k603,k,Anal fistula,Diseases of the digestive system,38,28,46,-0.263157895,0.642857143,0.210526316,2645,2938,2359,293,-579,-286
k604,k,Rectal fistula,Diseases of the digestive system,13,26,18,1,-0.307692308,0.384615385,4127,3053,3617,-1074,564,-510
k605,k,Anorectal fistula,Diseases of the digestive system,10,10,13,0,0.3,0.3,4323,4299,4039,-24,-260,-284
k610,k,Anal abscess,Diseases of the digestive system,124,123,116,-0.008064516,-0.056910569,-0.064516129,1391,1341,1413,-50,72,22
k611,k,Rectal abscess,Diseases of the digestive system,326,237,324,-0.273006135,0.367088608,-0.006134969,781,915,772,134,-143,-9
k612,k,Anorectal abscess,Diseases of the digestive system,102,92,81,-0.098039216,-0.119565217,-0.205882353,1569,1578,1723,9,145,154
k6131,k,Horseshoe abscess,Diseases of the digestive system,14,12,10,-0.142857143,-0.166666667,-0.285714286,4040,4128,4282,88,154,242
k6139,k,Other ischiorectal abscess,Diseases of the digestive system,27,23,25,-0.148148148,0.086956522,-0.074074074,3124,3226,3154,102,-72,30
k621,k,Rectal polyp,Diseases of the digestive system,149,161,156,0.080536913,-0.031055901,0.046979866,1251,1139,1179,-112,40,-72
k623,k,Rectal prolapse,Diseases of the digestive system,226,210,169,-0.07079646,-0.195238095,-0.252212389,993,996,1130,3,134,137
k624,k,Stenosis of anus and rectum,Diseases of the digestive system,68,47,50,-0.308823529,0.063829787,-0.264705882,1962,2250,2248,288,-2,286
k625,k,Hemorrhage of anus and rectum,Diseases of the digestive system,1073,973,1068,-0.093196645,0.097636177,-0.004659832,331,344,332,13,-12,1
k626,k,Ulcer of anus and rectum,Diseases of the digestive system,150,139,175,-0.073333333,0.258992806,0.166666667,1244,1238,1103,-6,-135,-141
k627,k,Radiation proctitis,Diseases of the digestive system,59,67,55,0.13559322,-0.179104478,-0.06779661,2123,1885,2132,-238,247,9
k6289,k,Other specified diseases of anus and rectum,Diseases of the digestive system,403,370,438,-0.081885856,0.183783784,0.086848635,680,690,641,10,-49,-39
k629,k,"Disease of anus and rectum, unspecified",Diseases of the digestive system,34,19,16,-0.441176471,-0.157894737,-0.529411765,2776,3518,3760,742,242,984
k630,k,Abscess of intestine,Diseases of the digestive system,45,56,65,0.244444444,0.160714286,0.444444444,2426,2058,1950,-368,-108,-476
k631,k,Perforation of intestine (nontraumatic),Diseases of the digestive system,516,476,539,-0.07751938,0.132352941,0.044573643,587,586,557,-1,-29,-30
k632,k,Fistula of intestine,Diseases of the digestive system,428,452,385,0.056074766,-0.148230088,-0.10046729,653,615,693,-38,78,40
k633,k,Ulcer of intestine,Diseases of the digestive system,228,199,218,-0.127192982,0.095477387,-0.043859649,979,1018,975,39,-43,-4
k635,k,Polyp of colon,Diseases of the digestive system,805,792,812,-0.016149068,0.025252525,0.008695652,422,401,406,-21,5,-16
k6389,k,Other specified diseases of intestine,Diseases of the digestive system,333,367,352,0.102102102,-0.040871935,0.057057057,763,689,733,-74,44,-30
k639,k,"Disease of intestine, unspecified",Diseases of the digestive system,155,91,107,-0.412903226,0.175824176,-0.309677419,1214,1575,1467,361,-108,253
k640,k,First degree hemorrhoids,Diseases of the digestive system,166,159,179,-0.042168675,0.125786164,0.078313253,1159,1139,1087,-20,-52,-72
k641,k,Second degree hemorrhoids,Diseases of the digestive system,152,126,165,-0.171052632,0.30952381,0.085526316,1223,1310,1135,87,-175,-88
k642,k,Third degree hemorrhoids,Diseases of the digestive system,46,38,33,-0.173913043,-0.131578947,-0.282608696,2385,2492,2753,107,261,368
k643,k,Fourth degree hemorrhoids,Diseases of the digestive system,13,19,11,0.461538462,-0.421052632,-0.153846154,4104,3508,4186,-596,678,82
k644,k,Residual hemorrhoidal skin tags,Diseases of the digestive system,696,653,675,-0.061781609,0.033690658,-0.030172414,476,474,475,-2,1,-1
k645,k,Perianal venous thrombosis,Diseases of the digestive system,42,32,26,-0.238095238,-0.1875,-0.380952381,2495,2711,3078,216,367,583
k648,k,Other hemorrhoids,Diseases of the digestive system,1572,1310,1378,-0.166666667,0.051908397,-0.123409669,249,277,275,28,-2,26
k649,k,Unspecified hemorrhoids,Diseases of the digestive system,961,900,931,-0.063475546,0.034444444,-0.031217482,359,357,361,-2,4,2
k650,k,Generalized (acute) peritonitis,Diseases of the digestive system,307,241,288,-0.214983713,0.195020747,-0.061889251,813,893,824,80,-69,11
k651,k,Peritoneal abscess,Diseases of the digestive system,1178,1157,1231,-0.017826825,0.063958513,0.044991511,307,296,298,-11,2,-9
k652,k,Spontaneous bacterial peritonitis,Diseases of the digestive system,523,506,571,-0.03250478,0.128458498,0.091778203,579,559,531,-20,-28,-48
k653,k,Choleperitonitis,Diseases of the digestive system,38,31,28,-0.184210526,-0.096774194,-0.263157895,2618,2744,2975,126,231,357
k654,k,Sclerosing mesenteritis,Diseases of the digestive system,59,39,47,-0.338983051,0.205128205,-0.203389831,2108,2454,2309,346,-145,201
k658,k,Other peritonitis,Diseases of the digestive system,160,155,175,-0.03125,0.129032258,0.09375,1173,1152,1090,-21,-62,-83
k659,k,"Peritonitis, unspecified",Diseases of the digestive system,539,464,528,-0.139146568,0.137931034,-0.020408163,564,598,559,34,-39,-5
k660,k,Peritoneal adhesions (postprocedural) (postinfection),Diseases of the digestive system,2329,1966,2095,-0.155860884,0.065615463,-0.100472306,173,186,195,13,9,22
k661,k,Hemoperitoneum,Diseases of the digestive system,600,605,637,0.008333333,0.052892562,0.061666667,506,492,489,-14,-3,-17
k668,k,Other specified disorders of peritoneum,Diseases of the digestive system,242,184,164,-0.239669421,-0.108695652,-0.32231405,934,1047,1130,113,83,196
k669,k,"Disorder of peritoneum, unspecified",Diseases of the digestive system,12,10,15,-0.166666667,0.5,0.25,4155,4261,3825,106,-436,-330
k6811,k,Postprocedural retroperitoneal abscess,Diseases of the digestive system,41,38,46,-0.073170732,0.210526316,0.12195122,2515,2480,2328,-35,-152,-187
k6812,k,Psoas muscle abscess,Diseases of the digestive system,159,230,192,0.446540881,-0.165217391,0.20754717,1174,923,1043,-251,120,-131
k6819,k,Other retroperitoneal abscess,Diseases of the digestive system,59,92,109,0.559322034,0.184782609,0.847457627,2102,1554,1441,-548,-113,-661
k700,k,Alcoholic fatty liver,Diseases of the digestive system,267,249,322,-0.06741573,0.293172691,0.205992509,877,871,760,-6,-111,-117
k7010,k,Alcoholic hepatitis without ascites,Diseases of the digestive system,1269,1254,1442,-0.011820331,0.149920255,0.136327817,294,282,265,-12,-17,-29
k7011,k,Alcoholic hepatitis with ascites,Diseases of the digestive system,394,389,657,-0.012690355,0.688946015,0.66751269,677,653,473,-24,-180,-204
k7030,k,Alcoholic cirrhosis of liver without ascites,Diseases of the digestive system,2193,2149,2301,-0.020063839,0.070730572,0.049247606,182,174,173,-8,-1,-9
k7031,k,Alcoholic cirrhosis of liver with ascites,Diseases of the digestive system,1900,1873,2288,-0.014210526,0.221569674,0.204210526,210,199,173,-11,-26,-37
k7040,k,Alcoholic hepatic failure without coma,Diseases of the digestive system,562,532,652,-0.053380783,0.22556391,0.160142349,531,529,472,-2,-57,-59
k709,k,"Alcoholic liver disease, unspecified",Diseases of the digestive system,483,440,484,-0.089026915,0.1,0.002070393,597,610,587,13,-23,-10
k7110,k,"Toxic liver disease with hepatic necrosis, without coma",Diseases of the digestive system,32,33,38,0.03125,0.151515152,0.1875,2829,2645,2545,-184,-100,-284
k712,k,Toxic liver disease with acute hepatitis,Diseases of the digestive system,24,20,20,-0.166666667,0,-0.166666667,3249,3410,3415,161,5,166
k716,k,"Toxic liver disease with hepatitis, not elsewhere classified",Diseases of the digestive system,21,22,16,0.047619048,-0.272727273,-0.238095238,3450,3250,3724,-200,474,274
k717,k,Toxic liver disease with fibrosis and cirrhosis of liver,Diseases of the digestive system,16,14,13,-0.125,-0.071428571,-0.1875,3831,3902,3989,71,87,158
k719,k,"Toxic liver disease, unspecified",Diseases of the digestive system,49,31,45,-0.367346939,0.451612903,-0.081632653,2297,2727,2345,430,-382,48
k7200,k,Acute and subacute hepatic failure without coma,Diseases of the digestive system,2068,2124,2391,0.027079304,0.125706215,0.156189555,191,176,163,-15,-13,-28
k7201,k,Acute and subacute hepatic failure with coma,Diseases of the digestive system,50,36,36,-0.28,0,-0.28,2276,2534,2590,258,56,314
k7210,k,Chronic hepatic failure without coma,Diseases of the digestive system,157,172,168,0.095541401,-0.023255814,0.070063694,1180,1067,1106,-113,39,-74
k7290,k,"Hepatic failure, unspecified without coma",Diseases of the digestive system,2315,2269,2392,-0.01987041,0.054208903,0.033261339,173,162,162,-11,0,-11
k7291,k,"Hepatic failure, unspecified with coma",Diseases of the digestive system,14,13,14,-0.071428571,0.076923077,0,3988,3979,3890,-9,-89,-98
k739,k,"Chronic hepatitis, unspecified",Diseases of the digestive system,32,33,34,0.03125,0.03030303,0.0625,2824,2641,2678,-183,37,-146
k743,k,Primary biliary cirrhosis,Diseases of the digestive system,140,137,124,-0.021428571,-0.094890511,-0.114285714,1259,1222,1318,-37,96,59
k745,k,"Biliary cirrhosis, unspecified",Diseases of the digestive system,26,21,17,-0.192307692,-0.19047619,-0.346153846,3128,3323,3640,195,317,512
k7460,k,Unspecified cirrhosis of liver,Diseases of the digestive system,4574,4435,4600,-0.030389156,0.037204059,0.005684303,99,98,103,-1,5,4
k7469,k,Other cirrhosis of liver,Diseases of the digestive system,821,726,647,-0.115712546,-0.108815427,-0.211936663,404,424,471,20,47,67
k750,k,Abscess of liver,Diseases of the digestive system,343,346,389,0.008746356,0.124277457,0.134110787,732,692,668,-40,-24,-64
k754,k,Autoimmune hepatitis,Diseases of the digestive system,266,244,257,-0.082706767,0.053278689,-0.033834586,869,871,872,2,1,3
k7581,k,Nonalcoholic steatohepatitis (NASH),Diseases of the digestive system,1531,1374,1565,-0.102547355,0.139010189,0.022207707,250,263,244,13,-19,-6
k7589,k,Other specified inflammatory liver diseases,Diseases of the digestive system,122,108,147,-0.114754098,0.361111111,0.204918033,1365,1388,1173,23,-215,-192
k759,k,"Inflammatory liver disease, unspecified",Diseases of the digestive system,335,324,323,-0.032835821,-0.00308642,-0.035820896,739,727,747,-12,20,8
k760,k,"Fatty (change of) liver, not elsewhere classified",Diseases of the digestive system,5439,5353,6224,-0.01581173,0.162712498,0.144328001,82,76,64,-6,-12,-18
k761,k,Chronic passive congestion of liver,Diseases of the digestive system,588,622,595,0.057823129,-0.04340836,0.011904762,503,474,496,-29,22,-7
k763,k,Infarction of liver,Diseases of the digestive system,24,15,12,-0.375,-0.2,-0.5,3232,3786,4047,554,261,815
k766,k,Portal hypertension,Diseases of the digestive system,3905,3544,4173,-0.092445583,0.17748307,0.068629962,111,116,109,5,-7,-2
k767,k,Hepatorenal syndrome,Diseases of the digestive system,607,682,883,0.123558484,0.294721408,0.454695222,494,447,368,-47,-79,-126
k7681,k,Hepatopulmonary syndrome,Diseases of the digestive system,37,35,25,-0.054054054,-0.285714286,-0.324324324,2610,2550,3094,-60,544,484
k7689,k,Other specified diseases of liver,Diseases of the digestive system,972,849,914,-0.12654321,0.07656066,-0.059670782,346,363,357,17,-6,11
k769,k,"Liver disease, unspecified",Diseases of the digestive system,856,742,785,-0.13317757,0.057951482,-0.082943925,387,406,407,19,1,20
k8000,k,Calculus of gallbladder with acute cholecystitis without obstruction,Diseases of the digestive system,1072,922,931,-0.139925373,0.009761388,-0.131529851,319,343,350,24,7,31
k8001,k,Calculus of gallbladder with acute cholecystitis with obstruction,Diseases of the digestive system,81,83,89,0.024691358,0.072289157,0.098765432,1736,1628,1600,-108,-28,-136
k8010,k,Calculus of gallbladder with chronic cholecystitis without obstruction,Diseases of the digestive system,427,363,384,-0.149882904,0.05785124,-0.100702576,628,666,666,38,0,38
k8011,k,Calculus of gallbladder with chronic cholecystitis with obstruction,Diseases of the digestive system,16,28,11,0.75,-0.607142857,-0.3125,3805,2869,4130,-936,1261,325
k8012,k,Calculus of gallbladder with acute and chronic cholecystitis without obstruction,Diseases of the digestive system,210,178,205,-0.152380952,0.151685393,-0.023809524,996,1036,979,40,-57,-17
k8013,k,Calculus of gallbladder with acute and chronic cholecystitis with obstruction,Diseases of the digestive system,19,22,27,0.157894737,0.227272727,0.421052632,3571,3224,2980,-347,-244,-591
k8020,k,Calculus of gallbladder without cholecystitis without obstruction,Diseases of the digestive system,2816,2560,2661,-0.090909091,0.039453125,-0.055042614,141,146,144,5,-2,3
k8021,k,Calculus of gallbladder without cholecystitis with obstruction,Diseases of the digestive system,73,68,60,-0.068493151,-0.117647059,-0.178082192,1841,1816,1983,-25,167,142
k8030,k,"Calculus of bile duct with cholangitis, unspecified, without obstruction",Diseases of the digestive system,59,59,74,0,0.254237288,0.254237288,2072,1960,1754,-112,-206,-318
k8031,k,"Calculus of bile duct with cholangitis, unspecified, with obstruction",Diseases of the digestive system,71,68,62,-0.042253521,-0.088235294,-0.126760563,1868,1816,1948,-52,132,80
k8032,k,Calculus of bile duct with acute cholangitis without obstruction,Diseases of the digestive system,30,18,18,-0.4,0,-0.4,2891,3525,3540,634,15,649
k8033,k,Calculus of bile duct with acute cholangitis with obstruction,Diseases of the digestive system,35,16,24,-0.542857143,0.5,-0.314285714,2676,3704,3154,1028,-550,478
k8040,k,"Calculus of bile duct with cholecystitis, unspecified, without obstruction",Diseases of the digestive system,22,16,29,-0.272727273,0.8125,0.318181818,3348,3704,2872,356,-832,-476
k8042,k,Calculus of bile duct with acute cholecystitis without obstruction,Diseases of the digestive system,82,77,78,-0.06097561,0.012987013,-0.048780488,1718,1675,1708,-43,33,-10
k8043,k,Calculus of bile duct with acute cholecystitis with obstruction,Diseases of the digestive system,35,28,26,-0.2,-0.071428571,-0.257142857,2675,2863,3024,188,161,349
k8050,k,Calculus of bile duct without cholangitis or cholecystitis without obstruction,Diseases of the digestive system,322,301,308,-0.065217391,0.023255814,-0.043478261,751,753,761,2,8,10
k8051,k,Calculus of bile duct without cholangitis or cholecystitis with obstruction,Diseases of the digestive system,125,111,122,-0.112,0.099099099,-0.024,1330,1355,1307,25,-48,-23
k8060,k,"Calculus of gallbladder and bile duct with cholecystitis, unspecified, without obstruction",Diseases of the digestive system,32,18,23,-0.4375,0.277777778,-0.28125,2796,3521,3201,725,-320,405
k8061,k,"Calculus of gallbladder and bile duct with cholecystitis, unspecified, with obstruction",Diseases of the digestive system,11,33,30,2,-0.090909091,1.727272727,4161,2615,2834,-1546,219,-1327
k8062,k,Calculus of gallbladder and bile duct with acute cholecystitis without obstruction,Diseases of the digestive system,220,230,236,0.045454545,0.026086957,0.072727273,964,898,902,-66,4,-62
k8063,k,Calculus of gallbladder and bile duct with acute cholecystitis with obstruction,Diseases of the digestive system,112,101,100,-0.098214286,-0.00990099,-0.107142857,1438,1426,1479,-12,53,41
k8064,k,Calculus of gallbladder and bile duct with chronic cholecystitis without obstruction,Diseases of the digestive system,71,56,71,-0.211267606,0.267857143,0,1863,2000,1805,137,-195,-58
k8065,k,Calculus of gallbladder and bile duct with chronic cholecystitis with obstruction,Diseases of the digestive system,33,24,33,-0.272727273,0.375,0,2747,3081,2696,334,-385,-51
k8066,k,Calculus of gallbladder and bile duct with acute and chronic cholecystitis without obstruction,Diseases of the digestive system,84,81,73,-0.035714286,-0.098765432,-0.130952381,1689,1636,1765,-53,129,76
k8067,k,Calculus of gallbladder and bile duct with acute and chronic cholecystitis with obstruction,Diseases of the digestive system,73,49,50,-0.328767123,0.020408163,-0.315068493,1835,2130,2183,295,53,348
k8070,k,Calculus of gallbladder and bile duct without cholecystitis without obstruction,Diseases of the digestive system,190,165,158,-0.131578947,-0.042424242,-0.168421053,1037,1077,1115,40,38,78
k8071,k,Calculus of gallbladder and bile duct without cholecystitis with obstruction,Diseases of the digestive system,31,33,33,0.064516129,0,0.064516129,2826,2609,2693,-217,84,-133
k8080,k,Other cholelithiasis without obstruction,Diseases of the digestive system,80,73,73,-0.0875,0,-0.0875,1740,1729,1764,-11,35,24
k810,k,Acute cholecystitis,Diseases of the digestive system,749,743,743,-0.008010681,0,-0.008010681,427,403,421,-24,18,-6
k811,k,Chronic cholecystitis,Diseases of the digestive system,190,174,175,-0.084210526,0.005747126,-0.078947368,1036,1039,1058,3,19,22
k812,k,Acute cholecystitis with chronic cholecystitis,Diseases of the digestive system,53,70,53,0.320754717,-0.242857143,0,2163,1765,2105,-398,340,-58
k819,k,"Cholecystitis, unspecified",Diseases of the digestive system,245,260,272,0.06122449,0.046153846,0.110204082,898,827,823,-71,-4,-75
k820,k,Obstruction of gallbladder,Diseases of the digestive system,24,29,37,0.208333333,0.275862069,0.541666667,3199,2783,2527,-416,-256,-672
k821,k,Hydrops of gallbladder,Diseases of the digestive system,218,193,213,-0.114678899,0.103626943,-0.02293578,967,995,949,28,-46,-18
k823,k,Fistula of gallbladder,Diseases of the digestive system,18,12,24,-0.333333333,1,0.333333333,3627,4022,3133,395,-889,-494
k824,k,Cholesterolosis of gallbladder,Diseases of the digestive system,90,64,74,-0.288888889,0.15625,-0.177777778,1620,1862,1744,242,-118,124
k828,k,Other specified diseases of gallbladder,Diseases of the digestive system,1026,906,1006,-0.116959064,0.110375276,-0.019493177,330,343,331,13,-12,1
k829,k,"Disease of gallbladder, unspecified",Diseases of the digestive system,63,70,71,0.111111111,0.014285714,0.126984127,1989,1762,1796,-227,34,-193
k82a1,k,Gangrene of gallbladder in cholecystitis,Diseases of the digestive system,408,375,363,-0.080882353,-0.032,-0.110294118,643,650,688,7,38,45
k82a2,k,Perforation of gallbladder in cholecystitis,Diseases of the digestive system,59,84,85,0.423728814,0.011904762,0.440677966,2053,1593,1620,-460,27,-433
k8301,k,Primary sclerosing cholangitis,Diseases of the digestive system,60,75,66,0.25,-0.12,0.1,2028,1690,1859,-338,169,-169
k8309,k,Other cholangitis,Diseases of the digestive system,559,479,472,-0.143112701,-0.014613779,-0.155635063,519,557,579,38,22,60
k831,k,Obstruction of bile duct,Diseases of the digestive system,1481,1441,1497,-0.027008778,0.038861901,0.010803511,253,250,245,-3,-5,-8
k833,k,Fistula of bile duct,Diseases of the digestive system,18,16,20,-0.111111111,0.25,0.111111111,3619,3675,3353,56,-322,-266
k838,k,Other specified diseases of biliary tract,Diseases of the digestive system,681,624,716,-0.083700441,0.147435897,0.051395007,459,464,437,5,-27,-22
k839,k,"Disease of biliary tract, unspecified",Diseases of the digestive system,26,22,26,-0.153846154,0.181818182,0,3076,3191,2997,115,-194,-79
k8500,k,Idiopathic acute pancreatitis without necrosis or infection,Diseases of the digestive system,73,47,55,-0.356164384,0.170212766,-0.246575342,1823,2168,2055,345,-113,232
k8510,k,Biliary acute pancreatitis without necrosis or infection,Diseases of the digestive system,860,774,824,-0.1,0.064599483,-0.041860465,379,389,381,10,-8,2
k8511,k,Biliary acute pancreatitis with uninfected necrosis,Diseases of the digestive system,19,24,20,0.263157895,-0.166666667,0.052631579,3532,3059,3349,-473,290,-183
k8520,k,Alcohol induced acute pancreatitis without necrosis or infection,Diseases of the digestive system,728,684,793,-0.06043956,0.159356725,0.089285714,435,437,396,2,-41,-39
k8521,k,Alcohol induced acute pancreatitis with uninfected necrosis,Diseases of the digestive system,34,37,35,0.088235294,-0.054054054,0.029411765,2685,2451,2585,-234,134,-100
k8530,k,Drug induced acute pancreatitis without necrosis or infection,Diseases of the digestive system,28,20,22,-0.285714286,0.1,-0.214285714,2960,3342,3231,382,-111,271
k8580,k,Other acute pancreatitis without necrosis or infection,Diseases of the digestive system,143,163,153,0.13986014,-0.061349693,0.06993007,1212,1074,1124,-138,50,-88
k8581,k,Other acute pancreatitis with uninfected necrosis,Diseases of the digestive system,15,13,14,-0.133333333,0.076923077,-0.066666667,3841,3909,3821,68,-88,-20
k8590,k,"Acute pancreatitis without necrosis or infection, unspecified",Diseases of the digestive system,2518,2404,2572,-0.045274027,0.069883527,0.021445592,154,151,148,-3,-3,-6
k8591,k,"Acute pancreatitis with uninfected necrosis, unspecified",Diseases of the digestive system,123,152,146,0.235772358,-0.039473684,0.18699187,1330,1118,1150,-212,32,-180
k8592,k,"Acute pancreatitis with infected necrosis, unspecified",Diseases of the digestive system,22,29,28,0.318181818,-0.034482759,0.272727273,3310,2766,2894,-544,128,-416
k860,k,Alcohol-induced chronic pancreatitis,Diseases of the digestive system,292,299,362,0.023972603,0.210702341,0.239726027,805,746,684,-59,-62,-121
k861,k,Other chronic pancreatitis,Diseases of the digestive system,1600,1593,1672,-0.004375,0.049591965,0.045,233,224,222,-9,-2,-11
k862,k,Cyst of pancreas,Diseases of the digestive system,381,380,454,-0.002624672,0.194736842,0.19160105,661,637,589,-24,-48,-72
k863,k,Pseudocyst of pancreas,Diseases of the digestive system,507,436,491,-0.140039448,0.126146789,-0.031558185,559,593,561,34,-32,2
k8681,k,Exocrine pancreatic insufficiency,Diseases of the digestive system,464,380,370,-0.181034483,-0.026315789,-0.202586207,589,636,666,47,30,77
k8689,k,Other specified diseases of pancreas,Diseases of the digestive system,704,617,685,-0.123579545,0.110210697,-0.026988636,447,464,443,17,-21,-4
k869,k,"Disease of pancreas, unspecified",Diseases of the digestive system,295,254,284,-0.138983051,0.118110236,-0.037288136,795,821,787,26,-34,-8
k900,k,Celiac disease,Diseases of the digestive system,690,518,576,-0.249275362,0.111969112,-0.165217391,453,519,496,66,-23,43
k9041,k,Non-celiac gluten sensitivity,Diseases of the digestive system,24,23,32,-0.041666667,0.391304348,0.333333333,3172,3108,2707,-64,-401,-465
k9049,k,"Malabsorption due to intolerance, not elsewhere classified",Diseases of the digestive system,51,46,58,-0.098039216,0.260869565,0.137254902,2190,2177,1978,-13,-199,-212
k909,k,"Intestinal malabsorption, unspecified",Diseases of the digestive system,163,163,146,0,-0.104294479,-0.104294479,1110,1065,1142,-45,77,32
k910,k,Vomiting following gastrointestinal surgery,Diseases of the digestive system,28,25,23,-0.107142857,-0.08,-0.178571429,2947,2979,3155,32,176,208
k911,k,Postgastric surgery syndromes,Diseases of the digestive system,43,34,33,-0.209302326,-0.029411765,-0.23255814,2383,2529,2660,146,131,277
k912,k,"Postsurgical malabsorption, not elsewhere classified",Diseases of the digestive system,357,344,313,-0.036414566,-0.090116279,-0.1232493,688,670,739,-18,69,51
k9130,k,"Postprocedural intestinal obstruction, unspecified as to partial versus complete",Diseases of the digestive system,68,55,60,-0.191176471,0.090909091,-0.117647059,1872,1980,1944,108,-36,72
k9131,k,Postprocedural partial intestinal obstruction,Diseases of the digestive system,33,19,20,-0.424242424,0.052631579,-0.393939394,2709,3394,3327,685,-67,618
k9161,k,Intraoperative hemorrhage and hematoma of a digestive system organ or structure complicating a digestive system procedure,Diseases of the digestive system,16,21,21,0.3125,0,0.3125,3738,3245,3267,-493,22,-471
k9171,k,Accidental puncture and laceration of a digestive system organ or structure during a digestive system procedure,Diseases of the digestive system,150,114,140,-0.24,0.228070175,-0.066666667,1172,1318,1165,146,-153,-7
k9172,k,Accidental puncture and laceration of a digestive system organ or structure during other procedure,Diseases of the digestive system,55,45,43,-0.181818182,-0.044444444,-0.218181818,2105,2198,2333,93,135,228
k9181,k,Other intraoperative complications of digestive system,Diseases of the digestive system,15,18,15,0.2,-0.166666667,0,3819,3466,3716,-353,250,-103
k91840,k,Postprocedural hemorrhage of a digestive system organ or structure following a digestive system procedure,Diseases of the digestive system,136,99,126,-0.272058824,0.272727273,-0.073529412,1237,1419,1260,182,-159,23
k91841,k,Postprocedural hemorrhage of a digestive system organ or structure following other procedure,Diseases of the digestive system,15,17,22,0.133333333,0.294117647,0.466666667,3818,3558,3209,-260,-349,-609
k91850,k,Pouchitis,Diseases of the digestive system,27,35,30,0.296296296,-0.142857143,0.111111111,2996,2494,2786,-502,292,-210
k9186,k,Retained cholelithiasis following cholecystectomy,Diseases of the digestive system,45,24,25,-0.466666667,0.041666667,-0.444444444,2324,3035,3026,711,-9,702
k91870,k,Postprocedural hematoma of a digestive system organ or structure following a digestive system procedure,Diseases of the digestive system,88,74,66,-0.159090909,-0.108108108,-0.25,1614,1681,1839,67,158,225
k91871,k,Postprocedural hematoma of a digestive system organ or structure following other procedure,Diseases of the digestive system,25,25,23,0,-0.08,-0.08,3102,2971,3146,-131,175,44
k91872,k,Postprocedural seroma of a digestive system organ or structure following a digestive system procedure,Diseases of the digestive system,31,28,33,-0.096774194,0.178571429,0.064516129,2785,2811,2654,26,-157,-131
k9189,k,Other postprocedural complications and disorders of digestive system,Diseases of the digestive system,824,640,721,-0.223300971,0.1265625,-0.125,389,453,430,64,-23,41
k920,k,Hematemesis,Diseases of the digestive system,1775,1674,1894,-0.056901408,0.131421744,0.067042254,215,213,198,-2,-15,-17
k921,k,Melena,Diseases of the digestive system,2720,2642,2855,-0.028676471,0.080620742,0.049632353,145,144,138,-1,-6,-7
k922,k,"Gastrointestinal hemorrhage, unspecified",Diseases of the digestive system,3172,3089,3432,-0.026166456,0.111039171,0.081967213,128,129,124,1,-5,-4
k9289,k,Other specified diseases of the digestive system,Diseases of the digestive system,27,12,19,-0.555555556,0.583333333,-0.296296296,2989,3969,3386,980,-583,397
k9401,k,Colostomy hemorrhage,Diseases of the digestive system,23,17,10,-0.260869565,-0.411764706,-0.565217391,3214,3549,4120,335,571,906
k9402,k,Colostomy infection,Diseases of the digestive system,10,11,16,0.1,0.454545455,0.6,4156,4051,3616,-105,-435,-540
k9403,k,Colostomy malfunction,Diseases of the digestive system,40,35,40,-0.125,0.142857143,0,2456,2489,2412,33,-77,-44
k9409,k,Other complications of colostomy,Diseases of the digestive system,53,70,62,0.320754717,-0.114285714,0.169811321,2127,1734,1904,-393,170,-223
k9412,k,Enterostomy infection,Diseases of the digestive system,15,17,17,0.133333333,0,0.133333333,3805,3547,3538,-258,-9,-267
k9413,k,Enterostomy malfunction,Diseases of the digestive system,104,92,104,-0.115384615,0.130434783,0,1462,1491,1410,29,-81,-52
k9419,k,Other complications of enterostomy,Diseases of the digestive system,52,36,57,-0.307692308,0.583333333,0.096153846,2150,2457,1984,307,-473,-166
k9421,k,Gastrostomy hemorrhage,Diseases of the digestive system,25,23,32,-0.08,0.391304348,0.28,3092,3086,2689,-6,-397,-403
k9422,k,Gastrostomy infection,Diseases of the digestive system,80,85,86,0.0625,0.011764706,0.075,1707,1554,1580,-153,26,-127
k9423,k,Gastrostomy malfunction,Diseases of the digestive system,348,368,344,0.057471264,-0.065217391,-0.011494253,693,641,690,-52,49,-3
k9429,k,Other complications of gastrostomy,Diseases of the digestive system,56,71,53,0.267857143,-0.253521127,-0.053571429,2071,1720,2064,-351,344,-7
k9509,k,Other complications of gastric band procedure,Diseases of the digestive system,80,54,63,-0.325,0.166666667,-0.2125,1706,1986,1887,280,-99,181
k9589,k,Other complications of other bariatric procedure,Diseases of the digestive system,106,97,92,-0.08490566,-0.051546392,-0.132075472,1446,1437,1526,-9,89,80
l00,l,Staphylococcal scalded skin syndrome,Diseases of the skin and subcutaneous tissue,13,10,11,-0.230769231,0.1,-0.153846154,3952,4121,4033,169,-88,81
l0100,l,"Impetigo, unspecified",Diseases of the skin and subcutaneous tissue,72,55,76,-0.236111111,0.381818182,0.055555556,1807,1967,1688,160,-279,-119
l0201,l,Cutaneous abscess of face,Diseases of the skin and subcutaneous tissue,316,234,238,-0.259493671,0.017094017,-0.246835443,746,855,872,109,17,126
l0211,l,Cutaneous abscess of neck,Diseases of the skin and subcutaneous tissue,277,273,254,-0.014440433,-0.06959707,-0.083032491,812,781,841,-31,60,29
l02211,l,Cutaneous abscess of abdominal wall,Diseases of the skin and subcutaneous tissue,734,590,600,-0.196185286,0.016949153,-0.182561308,426,467,472,41,5,46
l02212,l,"Cutaneous abscess of back [any part, except buttock]",Diseases of the skin and subcutaneous tissue,188,158,181,-0.159574468,0.14556962,-0.037234043,1012,1073,1018,61,-55,6
l02213,l,Cutaneous abscess of chest wall,Diseases of the skin and subcutaneous tissue,150,157,149,0.046666667,-0.050955414,-0.006666667,1163,1078,1120,-85,42,-43
l02214,l,Cutaneous abscess of groin,Diseases of the skin and subcutaneous tissue,286,259,285,-0.094405594,0.1003861,-0.003496503,800,806,777,6,-29,-23
l02215,l,Cutaneous abscess of perineum,Diseases of the skin and subcutaneous tissue,214,147,165,-0.313084112,0.12244898,-0.228971963,953,1113,1065,160,-48,112
l02216,l,Cutaneous abscess of umbilicus,Diseases of the skin and subcutaneous tissue,29,19,14,-0.344827586,-0.263157895,-0.517241379,2865,3363,3766,498,403,901
l0231,l,Cutaneous abscess of buttock,Diseases of the skin and subcutaneous tissue,563,465,490,-0.174067496,0.053763441,-0.129662522,501,559,554,58,-5,53
l02411,l,Cutaneous abscess of right axilla,Diseases of the skin and subcutaneous tissue,74,46,58,-0.378378378,0.260869565,-0.216216216,1773,2151,1953,378,-198,180
l02412,l,Cutaneous abscess of left axilla,Diseases of the skin and subcutaneous tissue,78,46,61,-0.41025641,0.326086957,-0.217948718,1713,2151,1903,438,-248,190
l02413,l,Cutaneous abscess of right upper limb,Diseases of the skin and subcutaneous tissue,491,381,364,-0.224032587,-0.044619423,-0.258655804,562,625,666,63,41,104
l02414,l,Cutaneous abscess of left upper limb,Diseases of the skin and subcutaneous tissue,546,415,366,-0.23992674,-0.118072289,-0.32967033,520,598,662,78,64,142
l02415,l,Cutaneous abscess of right lower limb,Diseases of the skin and subcutaneous tissue,675,589,570,-0.127407407,-0.032258065,-0.155555556,449,467,496,18,29,47
l02416,l,Cutaneous abscess of left lower limb,Diseases of the skin and subcutaneous tissue,581,578,605,-0.005163511,0.046712803,0.04130809,484,474,469,-10,-5,-15
l02419,l,"Cutaneous abscess of limb, unspecified",Diseases of the skin and subcutaneous tissue,65,54,42,-0.169230769,-0.222222222,-0.353846154,1904,1972,2331,68,359,427
l02511,l,Cutaneous abscess of right hand,Diseases of the skin and subcutaneous tissue,319,345,280,0.081504702,-0.188405797,-0.122257053,731,658,780,-73,122,49
l02512,l,Cutaneous abscess of left hand,Diseases of the skin and subcutaneous tissue,238,227,207,-0.046218487,-0.088105727,-0.130252101,885,870,936,-15,66,51
l02611,l,Cutaneous abscess of right foot,Diseases of the skin and subcutaneous tissue,520,469,503,-0.098076923,0.07249467,-0.032692308,540,554,541,14,-13,1
l02612,l,Cutaneous abscess of left foot,Diseases of the skin and subcutaneous tissue,509,448,474,-0.119842829,0.058035714,-0.068762279,544,572,559,28,-13,15
l02619,l,Cutaneous abscess of unspecified foot,Diseases of the skin and subcutaneous tissue,23,12,12,-0.47826087,0,-0.47826087,3183,3936,3921,753,-15,738
l02811,l,"Cutaneous abscess of head [any part, except face]",Diseases of the skin and subcutaneous tissue,82,69,72,-0.158536585,0.043478261,-0.12195122,1661,1732,1725,71,-7,64
l02818,l,Cutaneous abscess of other sites,Diseases of the skin and subcutaneous tissue,30,14,16,-0.533333333,0.142857143,-0.466666667,2801,3759,3584,958,-175,783
l0291,l,"Cutaneous abscess, unspecified",Diseases of the skin and subcutaneous tissue,86,53,71,-0.38372093,0.339622642,-0.174418605,1613,1986,1748,373,-238,135
l0292,l,"Furuncle, unspecified",Diseases of the skin and subcutaneous tissue,25,19,20,-0.24,0.052631579,-0.2,3063,3349,3281,286,-68,218
l03011,l,Cellulitis of right finger,Diseases of the skin and subcutaneous tissue,328,282,258,-0.140243902,-0.085106383,-0.213414634,713,751,819,38,68,106
l03012,l,Cellulitis of left finger,Diseases of the skin and subcutaneous tissue,218,227,200,0.041284404,-0.118942731,-0.082568807,931,867,958,-64,91,27
l03019,l,Cellulitis of unspecified finger,Diseases of the skin and subcutaneous tissue,13,19,12,0.461538462,-0.368421053,-0.076923077,3924,3347,3915,-577,568,-9
l03031,l,Cellulitis of right toe,Diseases of the skin and subcutaneous tissue,535,431,395,-0.194392523,-0.083526682,-0.261682243,526,584,627,58,43,101
l03032,l,Cellulitis of left toe,Diseases of the skin and subcutaneous tissue,456,387,367,-0.151315789,-0.051679587,-0.195175439,583,613,656,30,43,73
l03039,l,Cellulitis of unspecified toe,Diseases of the skin and subcutaneous tissue,19,22,23,0.157894737,0.045454545,0.210526316,3455,3119,3105,-336,-14,-350
l03111,l,Cellulitis of right axilla,Diseases of the skin and subcutaneous tissue,31,30,37,-0.032258065,0.233333333,0.193548387,2746,2660,2456,-86,-204,-290
l03112,l,Cellulitis of left axilla,Diseases of the skin and subcutaneous tissue,58,31,36,-0.465517241,0.161290323,-0.379310345,2016,2609,2479,593,-130,463
l03113,l,Cellulitis of right upper limb,Diseases of the skin and subcutaneous tissue,1432,1212,1153,-0.153631285,-0.048679868,-0.194832402,253,272,289,19,17,36
l03114,l,Cellulitis of left upper limb,Diseases of the skin and subcutaneous tissue,1416,1108,1082,-0.217514124,-0.023465704,-0.235875706,258,286,308,28,22,50
l03115,l,Cellulitis of right lower limb,Diseases of the skin and subcutaneous tissue,6346,5833,5722,-0.080838323,-0.019029659,-0.098329656,62,65,72,3,7,10
l03116,l,Cellulitis of left lower limb,Diseases of the skin and subcutaneous tissue,6338,5778,5466,-0.088355948,-0.053997923,-0.137582834,62,67,78,5,11,16
l03119,l,Cellulitis of unspecified part of limb,Diseases of the skin and subcutaneous tissue,225,227,171,0.008888889,-0.246696035,-0.24,908,861,1029,-47,168,121
l03211,l,Cellulitis of face,Diseases of the skin and subcutaneous tissue,804,664,586,-0.174129353,-0.11746988,-0.271144279,391,434,478,43,44,87
l03213,l,Periorbital cellulitis,Diseases of the skin and subcutaneous tissue,334,282,238,-0.155688623,-0.156028369,-0.28742515,695,744,853,49,109,158
l03221,l,Cellulitis of neck,Diseases of the skin and subcutaneous tissue,251,234,223,-0.067729084,-0.047008547,-0.111553785,840,835,883,-5,48,43
l03311,l,Cellulitis of abdominal wall,Diseases of the skin and subcutaneous tissue,1076,866,891,-0.195167286,0.02886836,-0.171933086,305,342,352,37,10,47
l03312,l,Cellulitis of back [any part except buttock],Diseases of the skin and subcutaneous tissue,171,139,170,-0.187134503,0.223021583,-0.005847953,1050,1132,1026,82,-106,-24
l03313,l,Cellulitis of chest wall,Diseases of the skin and subcutaneous tissue,316,260,240,-0.17721519,-0.076923077,-0.240506329,727,786,846,59,60,119
l03314,l,Cellulitis of groin,Diseases of the skin and subcutaneous tissue,251,202,215,-0.195219124,0.064356436,-0.143426295,838,921,894,83,-27,56
l03315,l,Cellulitis of perineum,Diseases of the skin and subcutaneous tissue,115,92,101,-0.2,0.097826087,-0.12173913,1347,1457,1403,110,-54,56
l03316,l,Cellulitis of umbilicus,Diseases of the skin and subcutaneous tissue,18,22,12,0.222222222,-0.454545455,-0.333333333,3521,3104,3897,-417,793,376
l03317,l,Cellulitis of buttock,Diseases of the skin and subcutaneous tissue,403,346,357,-0.141439206,0.031791908,-0.114143921,616,646,663,30,17,47
l03319,l,"Cellulitis of trunk, unspecified",Diseases of the skin and subcutaneous tissue,28,31,35,0.107142857,0.129032258,0.25,2880,2595,2511,-285,-84,-369
l03811,l,"Cellulitis of head [any part, except face]",Diseases of the skin and subcutaneous tissue,75,56,66,-0.253333333,0.178571429,-0.12,1721,1920,1794,199,-126,73
l03818,l,Cellulitis of other sites,Diseases of the skin and subcutaneous tissue,32,33,35,0.03125,0.060606061,0.09375,2693,2515,2510,-178,-5,-183
l0390,l,"Cellulitis, unspecified",Diseases of the skin and subcutaneous tissue,619,539,545,-0.129240711,0.011131725,-0.119547658,465,487,506,22,19,41
l040,l,"Acute lymphadenitis of face, head and neck",Diseases of the skin and subcutaneous tissue,41,40,50,-0.024390244,0.25,0.219512195,2376,2290,2093,-86,-197,-283
l0501,l,Pilonidal cyst with abscess,Diseases of the skin and subcutaneous tissue,43,31,36,-0.279069767,0.161290323,-0.162790698,2321,2591,2462,270,-129,141
l0591,l,Pilonidal cyst without abscess,Diseases of the skin and subcutaneous tissue,35,29,34,-0.171428571,0.172413793,-0.028571429,2570,2687,2547,117,-140,-23
l080,l,Pyoderma,Diseases of the skin and subcutaneous tissue,27,23,27,-0.148148148,0.173913043,0,2929,3032,2856,103,-176,-73
l0889,l,Other specified local infections of the skin and subcutaneous tissue,Diseases of the skin and subcutaneous tissue,126,97,98,-0.23015873,0.010309278,-0.222222222,1257,1403,1434,146,31,177
l089,l,"Local infection of the skin and subcutaneous tissue, unspecified",Diseases of the skin and subcutaneous tissue,640,611,656,-0.0453125,0.073649755,0.025,458,456,442,-2,-14,-16
l100,l,Pemphigus vulgaris,Diseases of the skin and subcutaneous tissue,16,11,15,-0.3125,0.363636364,-0.0625,3656,3981,3637,325,-344,-19
l120,l,Bullous pemphigoid,Diseases of the skin and subcutaneous tissue,58,68,52,0.172413793,-0.235294118,-0.103448276,1998,1729,2042,-269,313,44
l2084,l,Intrinsic (allergic) eczema,Diseases of the skin and subcutaneous tissue,22,26,24,0.181818182,-0.076923077,0.090909091,3213,2858,3027,-355,169,-186
l209,l,"Atopic dermatitis, unspecified",Diseases of the skin and subcutaneous tissue,93,88,85,-0.053763441,-0.034090909,-0.086021505,1521,1484,1555,-37,71,34
l210,l,Seborrhea capitis,Diseases of the skin and subcutaneous tissue,22,29,25,0.318181818,-0.137931034,0.136363636,3212,2683,2956,-529,273,-256
l219,l,"Seborrheic dermatitis, unspecified",Diseases of the skin and subcutaneous tissue,105,111,88,0.057142857,-0.207207207,-0.161904762,1418,1288,1527,-130,239,109
l22,l,Diaper dermatitis,Diseases of the skin and subcutaneous tissue,538,486,512,-0.096654275,0.053497942,-0.048327138,517,529,526,12,-3,9
l231,l,Allergic contact dermatitis due to adhesives,Diseases of the skin and subcutaneous tissue,18,15,18,-0.166666667,0.2,0,3504,3620,3394,116,-226,-110
l2389,l,Allergic contact dermatitis due to other agents,Diseases of the skin and subcutaneous tissue,11,13,11,0.181818182,-0.153846154,0,4011,3798,3966,-213,168,-45
l239,l,"Allergic contact dermatitis, unspecified cause",Diseases of the skin and subcutaneous tissue,39,29,23,-0.256410256,-0.206896552,-0.41025641,2433,2681,3073,248,392,640
l258,l,Unspecified contact dermatitis due to other agents,Diseases of the skin and subcutaneous tissue,20,18,23,-0.1,0.277777778,0.15,3349,3382,3073,33,-309,-276
l259,l,"Unspecified contact dermatitis, unspecified cause",Diseases of the skin and subcutaneous tissue,195,191,152,-0.020512821,-0.204188482,-0.220512821,966,951,1081,-15,130,115
l270,l,Generalized skin eruption due to drugs and medicaments taken internally,Diseases of the skin and subcutaneous tissue,488,441,433,-0.096311475,-0.01814059,-0.112704918,548,566,585,18,19,37
l271,l,Localized skin eruption due to drugs and medicaments taken internally,Diseases of the skin and subcutaneous tissue,115,69,73,-0.4,0.057971014,-0.365217391,1340,1706,1685,366,-21,345
l280,l,Lichen simplex chronicus,Diseases of the skin and subcutaneous tissue,43,47,48,0.093023256,0.021276596,0.11627907,2312,2089,2134,-223,45,-178
l298,l,Other pruritus,Diseases of the skin and subcutaneous tissue,97,96,108,-0.010309278,0.125,0.113402062,1481,1408,1346,-73,-62,-135
l299,l,"Pruritus, unspecified",Diseases of the skin and subcutaneous tissue,944,814,816,-0.137711864,0.002457002,-0.13559322,336,365,375,29,10,39
l304,l,Erythema intertrigo,Diseases of the skin and subcutaneous tissue,239,223,223,-0.066945607,0,-0.066945607,863,865,875,2,10,12
l308,l,Other specified dermatitis,Diseases of the skin and subcutaneous tissue,87,102,101,0.172413793,-0.009803922,0.16091954,1571,1342,1394,-229,52,-177
l309,l,"Dermatitis, unspecified",Diseases of the skin and subcutaneous tissue,1076,1022,972,-0.050185874,-0.048923679,-0.096654275,305,310,330,5,20,25
l400,l,Psoriasis vulgaris,Diseases of the skin and subcutaneous tissue,49,43,67,-0.12244898,0.558139535,0.367346939,2156,2180,1759,24,-421,-397
l4050,l,"Arthropathic psoriasis, unspecified",Diseases of the skin and subcutaneous tissue,506,440,502,-0.130434783,0.140909091,-0.007905138,534,564,530,30,-34,-4
l408,l,Other psoriasis,Diseases of the skin and subcutaneous tissue,20,17,19,-0.15,0.117647059,-0.05,3338,3463,3303,125,-160,-35
l409,l,"Psoriasis, unspecified",Diseases of the skin and subcutaneous tissue,1081,1011,1018,-0.064754857,0.006923838,-0.058279371,304,311,318,7,7,14
l439,l,"Lichen planus, unspecified",Diseases of the skin and subcutaneous tissue,27,21,27,-0.222222222,0.285714286,0,2910,3150,2838,240,-312,-72
l500,l,Allergic urticaria,Diseases of the skin and subcutaneous tissue,103,94,77,-0.087378641,-0.180851064,-0.252427184,1420,1420,1628,0,208,208
l501,l,Idiopathic urticaria,Diseases of the skin and subcutaneous tissue,11,13,11,0.181818182,-0.153846154,0,3994,3781,3949,-213,168,-45
l508,l,Other urticaria,Diseases of the skin and subcutaneous tissue,19,19,16,0,-0.157894737,-0.157894737,3406,3296,3527,-110,231,121
l509,l,"Urticaria, unspecified",Diseases of the skin and subcutaneous tissue,129,138,149,0.069767442,0.079710145,0.15503876,1224,1126,1082,-98,-44,-142
l511,l,Stevens-Johnson syndrome,Diseases of the skin and subcutaneous tissue,35,34,32,-0.028571429,-0.058823529,-0.085714286,2549,2446,2615,-103,169,66
l519,l,"Erythema multiforme, unspecified",Diseases of the skin and subcutaneous tissue,35,23,45,-0.342857143,0.956521739,0.285714286,2549,3008,2201,459,-807,-348
l52,l,Erythema nodosum,Diseases of the skin and subcutaneous tissue,75,30,62,-0.6,1.066666667,-0.173333333,1703,2618,1842,915,-776,139
l538,l,Other specified erythematous conditions,Diseases of the skin and subcutaneous tissue,62,48,44,-0.225806452,-0.083333333,-0.290322581,1910,2056,2228,146,172,318
l539,l,"Erythematous condition, unspecified",Diseases of the skin and subcutaneous tissue,174,146,135,-0.16091954,-0.075342466,-0.224137931,1019,1082,1151,63,69,132
l559,l,"Sunburn, unspecified",Diseases of the skin and subcutaneous tissue,21,29,26,0.380952381,-0.103448276,0.238095238,3254,2663,2879,-591,216,-375
l570,l,Actinic keratosis,Diseases of the skin and subcutaneous tissue,61,67,61,0.098360656,-0.089552239,0,1923,1728,1853,-195,125,-70
l598,l,Other specified disorders of the skin and subcutaneous tissue related to radiation,Diseases of the skin and subcutaneous tissue,47,36,43,-0.234042553,0.194444444,-0.085106383,2190,2386,2252,196,-134,62
l600,l,Ingrowing nail,Diseases of the skin and subcutaneous tissue,149,123,97,-0.174496644,-0.211382114,-0.348993289,1126,1212,1428,86,216,302
l602,l,Onychogryphosis,Diseases of the skin and subcutaneous tissue,30,34,19,0.133333333,-0.441176471,-0.366666667,2745,2441,3290,-304,849,545
l603,l,Nail dystrophy,Diseases of the skin and subcutaneous tissue,44,35,29,-0.204545455,-0.171428571,-0.340909091,2268,2413,2726,145,313,458
l659,l,"Nonscarring hair loss, unspecified",Diseases of the skin and subcutaneous tissue,51,55,49,0.078431373,-0.109090909,-0.039215686,2105,1909,2094,-196,185,-11
l680,l,Hirsutism,Diseases of the skin and subcutaneous tissue,37,35,33,-0.054054054,-0.057142857,-0.108108108,2465,2412,2564,-53,152,99
l700,l,Acne vulgaris,Diseases of the skin and subcutaneous tissue,53,36,46,-0.320754717,0.277777778,-0.132075472,2055,2384,2170,329,-214,115
l709,l,"Acne, unspecified",Diseases of the skin and subcutaneous tissue,241,227,185,-0.058091286,-0.185022026,-0.232365145,853,847,976,-6,129,123
l719,l,"Rosacea, unspecified",Diseases of the skin and subcutaneous tissue,131,121,90,-0.076335878,-0.256198347,-0.312977099,1208,1218,1500,10,282,292
l720,l,Epidermal cyst,Diseases of the skin and subcutaneous tissue,20,25,14,0.25,-0.44,-0.3,3318,2870,3676,-448,806,358
l723,l,Sebaceous cyst,Diseases of the skin and subcutaneous tissue,96,77,75,-0.197916667,-0.025974026,-0.21875,1479,1579,1642,100,63,163
l729,l,"Follicular cyst of the skin and subcutaneous tissue, unspecified",Diseases of the skin and subcutaneous tissue,21,15,25,-0.285714286,0.666666667,0.19047619,3243,3583,2923,340,-660,-320
l731,l,Pseudofolliculitis barbae,Diseases of the skin and subcutaneous tissue,27,14,17,-0.481481481,0.214285714,-0.37037037,2892,3679,3433,787,-246,541
l732,l,Hidradenitis suppurativa,Diseases of the skin and subcutaneous tissue,200,166,178,-0.17,0.072289157,-0.11,952,1004,987,52,-17,35
l738,l,Other specified follicular disorders,Diseases of the skin and subcutaneous tissue,24,15,15,-0.375,0,-0.375,3049,3582,3591,533,9,542
l739,l,"Follicular disorder, unspecified",Diseases of the skin and subcutaneous tissue,210,127,137,-0.395238095,0.078740157,-0.347619048,928,1181,1140,253,-41,212
l740,l,Miliaria rubra,Diseases of the skin and subcutaneous tissue,26,40,28,0.538461538,-0.3,0.076923077,2939,2260,2774,-679,514,-165
l7622,l,Postprocedural hemorrhage of skin and subcutaneous tissue following other procedure,Diseases of the skin and subcutaneous tissue,78,65,68,-0.166666667,0.046153846,-0.128205128,1660,1749,1736,89,-13,76
l7631,l,Postprocedural hematoma of skin and subcutaneous tissue following a dermatologic procedure,Diseases of the skin and subcutaneous tissue,25,17,30,-0.32,0.764705882,0.2,2992,3436,2684,444,-752,-308
l7632,l,Postprocedural hematoma of skin and subcutaneous tissue following other procedure,Diseases of the skin and subcutaneous tissue,478,374,437,-0.217573222,0.168449198,-0.085774059,548,611,578,63,-33,30
l7634,l,Postprocedural seroma of skin and subcutaneous tissue following other procedure,Diseases of the skin and subcutaneous tissue,167,118,137,-0.293413174,0.161016949,-0.179640719,1041,1234,1139,193,-95,98
l7682,l,Other postprocedural complications of skin and subcutaneous tissue,Diseases of the skin and subcutaneous tissue,53,42,51,-0.20754717,0.214285714,-0.037735849,2047,2192,2038,145,-154,-9
l80,l,Vitiligo,Diseases of the skin and subcutaneous tissue,112,89,104,-0.205357143,0.168539326,-0.071428571,1351,1452,1358,101,-94,7
l813,l,Cafe au lait spots,Diseases of the skin and subcutaneous tissue,21,23,21,0.095238095,-0.086956522,0,3232,2984,3142,-248,158,-90
l816,l,Other disorders of diminished melanin formation,Diseases of the skin and subcutaneous tissue,12,10,11,-0.166666667,0.1,-0.083333333,3899,4002,3916,103,-86,17
l818,l,Other specified disorders of pigmentation,Diseases of the skin and subcutaneous tissue,28,10,12,-0.642857143,0.2,-0.571428571,2830,4002,3828,1172,-174,998
l819,l,"Disorder of pigmentation, unspecified",Diseases of the skin and subcutaneous tissue,21,11,10,-0.476190476,-0.090909091,-0.523809524,3231,3922,3986,691,64,755
l821,l,Other seborrheic keratosis,Diseases of the skin and subcutaneous tissue,46,29,43,-0.369565217,0.482758621,-0.065217391,2199,2644,2239,445,-405,40
l83,l,Acanthosis nigricans,Diseases of the skin and subcutaneous tissue,64,84,98,0.3125,0.166666667,0.53125,1867,1505,1415,-362,-90,-452
l84,l,Corns and callosities,Diseases of the skin and subcutaneous tissue,192,240,158,0.25,-0.341666667,-0.177083333,965,811,1045,-154,234,80
l853,l,Xerosis cutis,Diseases of the skin and subcutaneous tissue,184,231,205,0.255434783,-0.112554113,0.114130435,980,837,914,-143,77,-66
l859,l,"Epidermal thickening, unspecified",Diseases of the skin and subcutaneous tissue,16,24,20,0.5,-0.166666667,0.25,3593,2918,3196,-675,278,-397
l88,l,Pyoderma gangrenosum,Diseases of the skin and subcutaneous tissue,49,63,67,0.285714286,0.063492063,0.367346939,2132,1774,1741,-358,-33,-391
l89102,l,"Pressure ulcer of unspecified part of back, stage 2",Diseases of the skin and subcutaneous tissue,34,21,20,-0.382352941,-0.047619048,-0.411764706,2557,3115,3195,558,80,638
l89103,l,"Pressure ulcer of unspecified part of back, stage 3",Diseases of the skin and subcutaneous tissue,15,15,11,0,-0.266666667,-0.266666667,3672,3566,3908,-106,342,236
l89109,l,"Pressure ulcer of unspecified part of back, unspecified stage",Diseases of the skin and subcutaneous tissue,31,30,27,-0.032258065,-0.1,-0.129032258,2676,2593,2807,-83,214,131
l89150,l,"Pressure ulcer of sacral region, unstageable",Diseases of the skin and subcutaneous tissue,359,396,447,0.103064067,0.128787879,0.245125348,655,591,568,-64,-23,-87
l89151,l,"Pressure ulcer of sacral region, stage 1",Diseases of the skin and subcutaneous tissue,381,342,365,-0.102362205,0.067251462,-0.041994751,627,641,642,14,1,15
l89152,l,"Pressure ulcer of sacral region, stage 2",Diseases of the skin and subcutaneous tissue,893,854,832,-0.043673012,-0.025761124,-0.068309071,348,343,362,-5,19,14
l89153,l,"Pressure ulcer of sacral region, stage 3",Diseases of the skin and subcutaneous tissue,611,622,756,0.018003273,0.215434084,0.237315876,461,446,398,-15,-48,-63
l89154,l,"Pressure ulcer of sacral region, stage 4",Diseases of the skin and subcutaneous tissue,718,666,864,-0.072423398,0.297297297,0.203342618,425,428,354,3,-74,-71
l89156,l,Pressure-induced deep tissue damage of sacral region,Diseases of the skin and subcutaneous tissue,67,299,359,3.462686567,0.200668896,4.358208955,1808,702,648,-1106,-54,-1160
l89159,l,"Pressure ulcer of sacral region, unspecified stage",Diseases of the skin and subcutaneous tissue,643,620,642,-0.035769829,0.035483871,-0.00155521,451,447,439,-4,-8,-12
l89210,l,"Pressure ulcer of right hip, unstageable",Diseases of the skin and subcutaneous tissue,42,23,31,-0.452380952,0.347826087,-0.261904762,2293,2970,2625,677,-345,332
l89212,l,"Pressure ulcer of right hip, stage 2",Diseases of the skin and subcutaneous tissue,21,20,31,-0.047619048,0.55,0.476190476,3216,3181,2625,-35,-556,-591
l89213,l,"Pressure ulcer of right hip, stage 3",Diseases of the skin and subcutaneous tissue,36,38,63,0.055555556,0.657894737,0.75,2477,2299,1807,-178,-492,-670
l89214,l,"Pressure ulcer of right hip, stage 4",Diseases of the skin and subcutaneous tissue,54,63,56,0.166666667,-0.111111111,0.037037037,2023,1767,1915,-256,148,-108
l89216,l,Pressure-induced deep tissue damage of right hip,Diseases of the skin and subcutaneous tissue,13,16,16,0.230769231,0,0.230769231,3814,3491,3478,-323,-13,-336
l89219,l,"Pressure ulcer of right hip, unspecified stage",Diseases of the skin and subcutaneous tissue,32,33,36,0.03125,0.090909091,0.125,2630,2458,2409,-172,-49,-221
l89220,l,"Pressure ulcer of left hip, unstageable",Diseases of the skin and subcutaneous tissue,22,26,29,0.181818182,0.115384615,0.318181818,3148,2799,2695,-349,-104,-453
l89222,l,"Pressure ulcer of left hip, stage 2",Diseases of the skin and subcutaneous tissue,24,24,31,0,0.291666667,0.291666667,3022,2905,2622,-117,-283,-400
l89223,l,"Pressure ulcer of left hip, stage 3",Diseases of the skin and subcutaneous tissue,36,29,40,-0.194444444,0.379310345,0.111111111,2476,2629,2308,153,-321,-168
l89224,l,"Pressure ulcer of left hip, stage 4",Diseases of the skin and subcutaneous tissue,68,64,73,-0.058823529,0.140625,0.073529412,1782,1750,1656,-32,-94,-126
l89229,l,"Pressure ulcer of left hip, unspecified stage",Diseases of the skin and subcutaneous tissue,38,31,26,-0.184210526,-0.161290323,-0.315789474,2414,2534,2838,120,304,424
l89300,l,"Pressure ulcer of unspecified buttock, unstageable",Diseases of the skin and subcutaneous tissue,16,12,19,-0.25,0.583333333,0.1875,3573,3813,3247,240,-566,-326
l89301,l,"Pressure ulcer of unspecified buttock, stage 1",Diseases of the skin and subcutaneous tissue,31,39,27,0.258064516,-0.307692308,-0.129032258,2662,2266,2791,-396,525,129
l89302,l,"Pressure ulcer of unspecified buttock, stage 2",Diseases of the skin and subcutaneous tissue,53,55,59,0.037735849,0.072727273,0.113207547,2034,1887,1864,-147,-23,-170
l89303,l,"Pressure ulcer of unspecified buttock, stage 3",Diseases of the skin and subcutaneous tissue,14,35,33,1.5,-0.057142857,1.357142857,3723,2384,2535,-1339,151,-1188
l89309,l,"Pressure ulcer of unspecified buttock, unspecified stage",Diseases of the skin and subcutaneous tissue,96,97,87,0.010416667,-0.103092784,-0.09375,1466,1374,1500,-92,126,34
l89310,l,"Pressure ulcer of right buttock, unstageable",Diseases of the skin and subcutaneous tissue,96,84,84,-0.125,0,-0.125,1466,1495,1529,29,34,63
l89311,l,"Pressure ulcer of right buttock, stage 1",Diseases of the skin and subcutaneous tissue,83,66,71,-0.204819277,0.075757576,-0.144578313,1592,1724,1689,132,-35,97
l89312,l,"Pressure ulcer of right buttock, stage 2",Diseases of the skin and subcutaneous tissue,243,236,230,-0.028806584,-0.025423729,-0.053497942,840,813,851,-27,38,11
l89313,l,"Pressure ulcer of right buttock, stage 3",Diseases of the skin and subcutaneous tissue,178,188,212,0.056179775,0.127659574,0.191011236,994,936,884,-58,-52,-110
l89314,l,"Pressure ulcer of right buttock, stage 4",Diseases of the skin and subcutaneous tissue,141,132,138,-0.063829787,0.045454545,-0.021276596,1142,1146,1118,4,-28,-24
l89316,l,Pressure-induced deep tissue damage of right buttock,Diseases of the skin and subcutaneous tissue,18,85,91,3.722222222,0.070588235,4.055555556,3420,1479,1470,-1941,-9,-1950
l89319,l,"Pressure ulcer of right buttock, unspecified stage",Diseases of the skin and subcutaneous tissue,115,98,92,-0.147826087,-0.06122449,-0.2,1315,1356,1457,41,101,142
l89320,l,"Pressure ulcer of left buttock, unstageable",Diseases of the skin and subcutaneous tissue,98,74,83,-0.244897959,0.121621622,-0.153061224,1444,1595,1532,151,-63,88
l89321,l,"Pressure ulcer of left buttock, stage 1",Diseases of the skin and subcutaneous tissue,68,67,68,-0.014705882,0.014925373,0,1774,1701,1713,-73,12,-61
l89322,l,"Pressure ulcer of left buttock, stage 2",Diseases of the skin and subcutaneous tissue,254,265,233,0.043307087,-0.120754717,-0.082677165,812,757,842,-55,85,30
l89323,l,"Pressure ulcer of left buttock, stage 3",Diseases of the skin and subcutaneous tissue,170,185,208,0.088235294,0.124324324,0.223529412,1024,939,894,-85,-45,-130
l89324,l,"Pressure ulcer of left buttock, stage 4",Diseases of the skin and subcutaneous tissue,139,118,154,-0.151079137,0.305084746,0.107913669,1154,1220,1049,66,-171,-105
l89326,l,Pressure-induced deep tissue damage of left buttock,Diseases of the skin and subcutaneous tissue,18,87,100,3.833333333,0.149425287,4.555555556,3414,1458,1377,-1956,-81,-2037
l89329,l,"Pressure ulcer of left buttock, unspecified stage",Diseases of the skin and subcutaneous tissue,125,99,109,-0.208,0.101010101,-0.128,1231,1345,1313,114,-32,82
l89510,l,"Pressure ulcer of right ankle, unstageable",Diseases of the skin and subcutaneous tissue,21,22,35,0.047619048,0.590909091,0.666666667,3193,3004,2435,-189,-569,-758
l89513,l,"Pressure ulcer of right ankle, stage 3",Diseases of the skin and subcutaneous tissue,21,13,17,-0.380952381,0.307692308,-0.19047619,3193,3702,3378,509,-324,185
l89519,l,"Pressure ulcer of right ankle, unspecified stage",Diseases of the skin and subcutaneous tissue,31,22,16,-0.290322581,-0.272727273,-0.483870968,2648,3004,3451,356,447,803
l89520,l,"Pressure ulcer of left ankle, unstageable",Diseases of the skin and subcutaneous tissue,25,20,21,-0.2,0.05,-0.16,2950,3153,3100,203,-53,150
l89522,l,"Pressure ulcer of left ankle, stage 2",Diseases of the skin and subcutaneous tissue,12,14,10,0.166666667,-0.285714286,-0.166666667,3847,3620,3936,-227,316,89
l89523,l,"Pressure ulcer of left ankle, stage 3",Diseases of the skin and subcutaneous tissue,17,13,22,-0.235294118,0.692307692,0.294117647,3477,3699,3046,222,-653,-431
l89529,l,"Pressure ulcer of left ankle, unspecified stage",Diseases of the skin and subcutaneous tissue,25,19,19,-0.24,0,-0.24,2950,3222,3226,272,4,276
l89610,l,"Pressure ulcer of right heel, unstageable",Diseases of the skin and subcutaneous tissue,177,147,134,-0.169491525,-0.088435374,-0.242937853,996,1062,1137,66,75,141
l89611,l,"Pressure ulcer of right heel, stage 1",Diseases of the skin and subcutaneous tissue,68,68,87,0,0.279411765,0.279411765,1769,1680,1489,-89,-191,-280
l89612,l,"Pressure ulcer of right heel, stage 2",Diseases of the skin and subcutaneous tissue,67,60,60,-0.104477612,0,-0.104477612,1791,1795,1830,4,35,39
l89613,l,"Pressure ulcer of right heel, stage 3",Diseases of the skin and subcutaneous tissue,78,71,57,-0.08974359,-0.197183099,-0.269230769,1636,1634,1876,-2,242,240
l89614,l,"Pressure ulcer of right heel, stage 4",Diseases of the skin and subcutaneous tissue,30,30,24,0,-0.2,-0.2,2690,2559,2936,-131,377,246
l89616,l,Pressure-induced deep tissue damage of right heel,Diseases of the skin and subcutaneous tissue,27,139,184,4.148148148,0.323741007,5.814814815,2842,1101,967,-1741,-134,-1875
l89619,l,"Pressure ulcer of right heel, unspecified stage",Diseases of the skin and subcutaneous tissue,128,120,112,-0.0625,-0.066666667,-0.125,1210,1207,1287,-3,80,77
l89620,l,"Pressure ulcer of left heel, unstageable",Diseases of the skin and subcutaneous tissue,179,158,146,-0.117318436,-0.075949367,-0.184357542,987,1021,1074,34,53,87
l89621,l,"Pressure ulcer of left heel, stage 1",Diseases of the skin and subcutaneous tissue,72,76,99,0.055555556,0.302631579,0.375,1714,1565,1384,-149,-181,-330
l89622,l,"Pressure ulcer of left heel, stage 2",Diseases of the skin and subcutaneous tissue,72,65,67,-0.097222222,0.030769231,-0.069444444,1714,1714,1712,0,-2,-2
l89623,l,"Pressure ulcer of left heel, stage 3",Diseases of the skin and subcutaneous tissue,79,71,47,-0.101265823,-0.338028169,-0.405063291,1625,1630,2097,5,467,472
l89624,l,"Pressure ulcer of left heel, stage 4",Diseases of the skin and subcutaneous tissue,41,28,19,-0.317073171,-0.321428571,-0.536585366,2298,2655,3215,357,560,917
l89626,l,Pressure-induced deep tissue damage of left heel,Diseases of the skin and subcutaneous tissue,37,143,230,2.864864865,0.608391608,5.216216216,2414,1081,850,-1333,-231,-1564
l89629,l,"Pressure ulcer of left heel, unspecified stage",Diseases of the skin and subcutaneous tissue,134,117,105,-0.126865672,-0.102564103,-0.21641791,1175,1222,1329,47,107,154
l89810,l,"Pressure ulcer of head, unstageable",Diseases of the skin and subcutaneous tissue,16,20,50,0.25,1.5,2.125,3536,3139,2019,-397,-1120,-1517
l89811,l,"Pressure ulcer of head, stage 1",Diseases of the skin and subcutaneous tissue,12,13,19,0.083333333,0.461538462,0.583333333,3830,3683,3212,-147,-471,-618
l89812,l,"Pressure ulcer of head, stage 2",Diseases of the skin and subcutaneous tissue,11,24,35,1.181818182,0.458333333,2.181818182,3889,2870,2422,-1019,-448,-1467
l89819,l,"Pressure ulcer of head, unspecified stage",Diseases of the skin and subcutaneous tissue,29,19,29,-0.344827586,0.526315789,0,2730,3206,2660,476,-546,-70
l89890,l,"Pressure ulcer of other site, unstageable",Diseases of the skin and subcutaneous tissue,107,92,117,-0.140186916,0.27173913,0.093457944,1363,1408,1246,45,-162,-117
l89891,l,"Pressure ulcer of other site, stage 1",Diseases of the skin and subcutaneous tissue,34,38,49,0.117647059,0.289473684,0.441176471,2517,2267,2041,-250,-226,-476
l89892,l,"Pressure ulcer of other site, stage 2",Diseases of the skin and subcutaneous tissue,104,125,119,0.201923077,-0.048,0.144230769,1382,1179,1232,-203,53,-150
l89893,l,"Pressure ulcer of other site, stage 3",Diseases of the skin and subcutaneous tissue,99,90,92,-0.090909091,0.022222222,-0.070707071,1420,1415,1443,-5,28,23
l89894,l,"Pressure ulcer of other site, stage 4",Diseases of the skin and subcutaneous tissue,39,50,51,0.282051282,0.02,0.307692308,2357,1944,1993,-413,49,-364
l89896,l,Pressure-induced deep tissue damage of other site,Diseases of the skin and subcutaneous tissue,24,90,119,2.75,0.322222222,3.958333333,2981,1415,1232,-1566,-183,-1749
l89899,l,"Pressure ulcer of other site, unspecified stage",Diseases of the skin and subcutaneous tissue,140,136,141,-0.028571429,0.036764706,0.007142857,1146,1113,1092,-33,-21,-54
l8990,l,"Pressure ulcer of unspecified site, unspecified stage",Diseases of the skin and subcutaneous tissue,111,106,109,-0.045045045,0.028301887,-0.018018018,1333,1278,1304,-55,26,-29
l8991,l,"Pressure ulcer of unspecified site, stage 1",Diseases of the skin and subcutaneous tissue,24,19,15,-0.208333333,-0.210526316,-0.375,2979,3198,3505,219,307,526
l8992,l,"Pressure ulcer of unspecified site, stage 2",Diseases of the skin and subcutaneous tissue,25,16,16,-0.36,0,-0.36,2928,3437,3422,509,-15,494
l900,l,Lichen sclerosus et atrophicus,Diseases of the skin and subcutaneous tissue,25,12,23,-0.52,0.916666667,-0.08,2928,3760,2966,832,-794,38
l905,l,Scar conditions and fibrosis of skin,Diseases of the skin and subcutaneous tissue,105,109,111,0.038095238,0.018348624,0.057142857,1376,1259,1283,-117,24,-93
l910,l,Hypertrophic scar,Diseases of the skin and subcutaneous tissue,90,89,87,-0.011111111,-0.02247191,-0.033333333,1501,1421,1476,-80,55,-25
l918,l,Other hypertrophic disorders of the skin,Diseases of the skin and subcutaneous tissue,37,27,32,-0.27027027,0.185185185,-0.135135135,2405,2694,2536,289,-158,131
l928,l,Other granulomatous disorders of the skin and subcutaneous tissue,Diseases of the skin and subcutaneous tissue,17,15,12,-0.117647059,-0.2,-0.294117647,3447,3495,3745,48,250,298
l929,l,"Granulomatous disorder of the skin and subcutaneous tissue, unspecified",Diseases of the skin and subcutaneous tissue,30,22,14,-0.266666667,-0.363636364,-0.533333333,2672,2978,3579,306,601,907
l930,l,Discoid lupus erythematosus,Diseases of the skin and subcutaneous tissue,133,100,109,-0.248120301,0.09,-0.180451128,1176,1325,1303,149,-22,127
l97119,l,Non-pressure chronic ulcer of right thigh with unspecified severity,Diseases of the skin and subcutaneous tissue,19,31,34,0.631578947,0.096774194,0.789473684,3297,2493,2449,-804,-44,-848
l97129,l,Non-pressure chronic ulcer of left thigh with unspecified severity,Diseases of the skin and subcutaneous tissue,20,25,28,0.25,0.12,0.4,3227,2796,2701,-431,-95,-526
l97211,l,Non-pressure chronic ulcer of right calf limited to breakdown of skin,Diseases of the skin and subcutaneous tissue,27,26,17,-0.037037037,-0.346153846,-0.37037037,2821,2751,3342,-70,591,521
l97219,l,Non-pressure chronic ulcer of right calf with unspecified severity,Diseases of the skin and subcutaneous tissue,92,78,78,-0.152173913,0,-0.152173913,1478,1523,1569,45,46,91
l97221,l,Non-pressure chronic ulcer of left calf limited to breakdown of skin,Diseases of the skin and subcutaneous tissue,23,21,15,-0.086956522,-0.285714286,-0.347826087,3028,3046,3495,18,449,467
l97222,l,Non-pressure chronic ulcer of left calf with fat layer exposed,Diseases of the skin and subcutaneous tissue,14,25,16,0.785714286,-0.36,0.142857143,3664,2794,3413,-870,619,-251
l97229,l,Non-pressure chronic ulcer of left calf with unspecified severity,Diseases of the skin and subcutaneous tissue,88,80,72,-0.090909091,-0.1,-0.181818182,1514,1511,1637,-3,126,123
l97311,l,Non-pressure chronic ulcer of right ankle limited to breakdown of skin,Diseases of the skin and subcutaneous tissue,34,20,23,-0.411764706,0.15,-0.323529412,2506,3118,2958,612,-160,452
l97312,l,Non-pressure chronic ulcer of right ankle with fat layer exposed,Diseases of the skin and subcutaneous tissue,19,18,20,-0.052631579,0.111111111,0.052631579,3291,3253,3122,-38,-131,-169
l97319,l,Non-pressure chronic ulcer of right ankle with unspecified severity,Diseases of the skin and subcutaneous tissue,160,128,146,-0.2,0.140625,-0.0875,1052,1153,1073,101,-80,21
l97321,l,Non-pressure chronic ulcer of left ankle limited to breakdown of skin,Diseases of the skin and subcutaneous tissue,15,14,24,-0.066666667,0.714285714,0.6,3588,3576,2908,-12,-668,-680
l97328,l,Non-pressure chronic ulcer of left ankle with other specified severity,Diseases of the skin and subcutaneous tissue,14,13,11,-0.071428571,-0.153846154,-0.214285714,3659,3654,3818,-5,164,159
l97329,l,Non-pressure chronic ulcer of left ankle with unspecified severity,Diseases of the skin and subcutaneous tissue,156,132,107,-0.153846154,-0.189393939,-0.314102564,1076,1139,1309,63,170,233
l97409,l,Non-pressure chronic ulcer of unspecified heel and midfoot with unspecified severity,Diseases of the skin and subcutaneous tissue,37,43,22,0.162162162,-0.488372093,-0.405405405,2400,2107,3009,-293,902,609
l97411,l,Non-pressure chronic ulcer of right heel and midfoot limited to breakdown of skin,Diseases of the skin and subcutaneous tissue,46,37,51,-0.195652174,0.378378378,0.108695652,2150,2283,1983,133,-300,-167
l97412,l,Non-pressure chronic ulcer of right heel and midfoot with fat layer exposed,Diseases of the skin and subcutaneous tissue,39,30,42,-0.230769231,0.4,0.076923077,2347,2533,2205,186,-328,-142
l97413,l,Non-pressure chronic ulcer of right heel and midfoot with necrosis of muscle,Diseases of the skin and subcutaneous tissue,22,15,14,-0.318181818,-0.066666667,-0.363636364,3085,3479,3563,394,84,478
l97414,l,Non-pressure chronic ulcer of right heel and midfoot with necrosis of bone,Diseases of the skin and subcutaneous tissue,35,28,35,-0.2,0.25,0,2468,2634,2405,166,-229,-63
l97416,l,Non-pressure chronic ulcer of right heel and midfoot with bone involvement without evidence of necrosis,Diseases of the skin and subcutaneous tissue,21,21,25,0,0.19047619,0.19047619,3147,3038,2836,-109,-202,-311
l97418,l,Non-pressure chronic ulcer of right heel and midfoot with other specified severity,Diseases of the skin and subcutaneous tissue,35,36,50,0.028571429,0.388888889,0.428571429,2468,2313,2004,-155,-309,-464
l97419,l,Non-pressure chronic ulcer of right heel and midfoot with unspecified severity,Diseases of the skin and subcutaneous tissue,319,341,317,0.068965517,-0.070381232,-0.006269592,703,638,694,-65,56,-9
l97421,l,Non-pressure chronic ulcer of left heel and midfoot limited to breakdown of skin,Diseases of the skin and subcutaneous tissue,38,32,42,-0.157894737,0.3125,0.105263158,2373,2447,2203,74,-244,-170
l97422,l,Non-pressure chronic ulcer of left heel and midfoot with fat layer exposed,Diseases of the skin and subcutaneous tissue,37,21,46,-0.432432432,1.19047619,0.243243243,2396,3035,2099,639,-936,-297
l97423,l,Non-pressure chronic ulcer of left heel and midfoot with necrosis of muscle,Diseases of the skin and subcutaneous tissue,20,15,15,-0.25,0,-0.25,3210,3473,3479,263,6,269
l97424,l,Non-pressure chronic ulcer of left heel and midfoot with necrosis of bone,Diseases of the skin and subcutaneous tissue,27,27,26,0,-0.037037037,-0.037037037,2808,2681,2779,-127,98,-29
l97426,l,Non-pressure chronic ulcer of left heel and midfoot with bone involvement without evidence of necrosis,Diseases of the skin and subcutaneous tissue,24,19,30,-0.208333333,0.578947368,0.25,2957,3173,2604,216,-569,-353
l97428,l,Non-pressure chronic ulcer of left heel and midfoot with other specified severity,Diseases of the skin and subcutaneous tissue,53,35,47,-0.339622642,0.342857143,-0.113207547,1998,2338,2076,340,-262,78
l97429,l,Non-pressure chronic ulcer of left heel and midfoot with unspecified severity,Diseases of the skin and subcutaneous tissue,344,326,354,-0.052325581,0.085889571,0.029069767,668,659,648,-9,-11,-20
l97509,l,Non-pressure chronic ulcer of other part of unspecified foot with unspecified severity,Diseases of the skin and subcutaneous tissue,242,240,206,-0.008264463,-0.141666667,-0.148760331,840,801,898,-39,97,58
l97511,l,Non-pressure chronic ulcer of other part of right foot limited to breakdown of skin,Diseases of the skin and subcutaneous tissue,119,100,96,-0.159663866,-0.04,-0.193277311,1267,1320,1392,53,72,125
l97512,l,Non-pressure chronic ulcer of other part of right foot with fat layer exposed,Diseases of the skin and subcutaneous tissue,119,85,64,-0.285714286,-0.247058824,-0.462184874,1267,1452,1743,185,291,476
l97513,l,Non-pressure chronic ulcer of other part of right foot with necrosis of muscle,Diseases of the skin and subcutaneous tissue,43,38,49,-0.11627907,0.289473684,0.139534884,2226,2248,2021,22,-227,-205
l97514,l,Non-pressure chronic ulcer of other part of right foot with necrosis of bone,Diseases of the skin and subcutaneous tissue,119,104,95,-0.12605042,-0.086538462,-0.201680672,1267,1288,1404,21,116,137
l97516,l,Non-pressure chronic ulcer of other part of right foot with bone involvement without evidence of necrosis,Diseases of the skin and subcutaneous tissue,91,77,63,-0.153846154,-0.181818182,-0.307692308,1478,1527,1763,49,236,285
l97518,l,Non-pressure chronic ulcer of other part of right foot with other specified severity,Diseases of the skin and subcutaneous tissue,158,144,114,-0.088607595,-0.208333333,-0.278481013,1057,1070,1263,13,193,206
l97519,l,Non-pressure chronic ulcer of other part of right foot with unspecified severity,Diseases of the skin and subcutaneous tissue,1792,1569,1622,-0.124441964,0.033779477,-0.094866071,210,226,227,16,1,17
l97521,l,Non-pressure chronic ulcer of other part of left foot limited to breakdown of skin,Diseases of the skin and subcutaneous tissue,124,93,91,-0.25,-0.021505376,-0.266129032,1223,1381,1440,158,59,217
l97522,l,Non-pressure chronic ulcer of other part of left foot with fat layer exposed,Diseases of the skin and subcutaneous tissue,105,67,77,-0.361904762,0.149253731,-0.266666667,1364,1663,1567,299,-96,203
l97523,l,Non-pressure chronic ulcer of other part of left foot with necrosis of muscle,Diseases of the skin and subcutaneous tissue,37,33,33,-0.108108108,0,-0.108108108,2384,2396,2470,12,74,86
l97524,l,Non-pressure chronic ulcer of other part of left foot with necrosis of bone,Diseases of the skin and subcutaneous tissue,104,78,83,-0.25,0.064102564,-0.201923077,1366,1511,1500,145,-11,134
l97525,l,Non-pressure chronic ulcer of other part of left foot with muscle involvement without evidence of necrosis,Diseases of the skin and subcutaneous tissue,15,12,11,-0.2,-0.083333333,-0.266666667,3560,3714,3790,154,76,230
l97526,l,Non-pressure chronic ulcer of other part of left foot with bone involvement without evidence of necrosis,Diseases of the skin and subcutaneous tissue,63,58,67,-0.079365079,0.155172414,0.063492063,1827,1791,1687,-36,-104,-140
l97528,l,Non-pressure chronic ulcer of other part of left foot with other specified severity,Diseases of the skin and subcutaneous tissue,118,141,98,0.194915254,-0.304964539,-0.169491525,1271,1086,1377,-185,291,106
l97529,l,Non-pressure chronic ulcer of other part of left foot with unspecified severity,Diseases of the skin and subcutaneous tissue,1735,1465,1461,-0.155619597,-0.002730375,-0.157925072,213,236,242,23,6,29
l97811,l,Non-pressure chronic ulcer of other part of right lower leg limited to breakdown of skin,Diseases of the skin and subcutaneous tissue,56,37,42,-0.339285714,0.135135135,-0.25,1933,2267,2186,334,-81,253
l97812,l,Non-pressure chronic ulcer of other part of right lower leg with fat layer exposed,Diseases of the skin and subcutaneous tissue,26,22,10,-0.153846154,-0.545454545,-0.615384615,2836,2943,3854,107,911,1018
l97818,l,Non-pressure chronic ulcer of other part of right lower leg with other specified severity,Diseases of the skin and subcutaneous tissue,39,34,29,-0.128205128,-0.147058824,-0.256410256,2329,2346,2617,17,271,288
l97819,l,Non-pressure chronic ulcer of other part of right lower leg with unspecified severity,Diseases of the skin and subcutaneous tissue,211,223,214,0.056872038,-0.040358744,0.014218009,910,844,874,-66,30,-36
l97821,l,Non-pressure chronic ulcer of other part of left lower leg limited to breakdown of skin,Diseases of the skin and subcutaneous tissue,52,39,48,-0.25,0.230769231,-0.076923077,2002,2207,2033,205,-174,31
l97822,l,Non-pressure chronic ulcer of other part of left lower leg with fat layer exposed,Diseases of the skin and subcutaneous tissue,29,21,12,-0.275862069,-0.428571429,-0.586206897,2684,3012,3697,328,685,1013
l97828,l,Non-pressure chronic ulcer of other part of left lower leg with other specified severity,Diseases of the skin and subcutaneous tissue,37,34,35,-0.081081081,0.029411765,-0.054054054,2376,2344,2382,-32,38,6
l97829,l,Non-pressure chronic ulcer of other part of left lower leg with unspecified severity,Diseases of the skin and subcutaneous tissue,218,193,208,-0.114678899,0.077720207,-0.04587156,893,916,888,23,-28,-5
l97909,l,Non-pressure chronic ulcer of unspecified part of unspecified lower leg with unspecified severity,Diseases of the skin and subcutaneous tissue,112,107,93,-0.044642857,-0.130841121,-0.169642857,1314,1262,1414,-52,152,100
l97911,l,Non-pressure chronic ulcer of unspecified part of right lower leg limited to breakdown of skin,Diseases of the skin and subcutaneous tissue,42,41,53,-0.023809524,0.292682927,0.261904762,2232,2151,1918,-81,-233,-314
l97919,l,Non-pressure chronic ulcer of unspecified part of right lower leg with unspecified severity,Diseases of the skin and subcutaneous tissue,502,462,470,-0.079681275,0.017316017,-0.06374502,528,541,542,13,1,14
l97921,l,Non-pressure chronic ulcer of unspecified part of left lower leg limited to breakdown of skin,Diseases of the skin and subcutaneous tissue,53,42,51,-0.20754717,0.214285714,-0.037735849,1979,2116,1963,137,-153,-16
l97922,l,Non-pressure chronic ulcer of unspecified part of left lower leg with fat layer exposed,Diseases of the skin and subcutaneous tissue,10,13,11,0.3,-0.153846154,0.1,3878,3611,3776,-267,165,-102
l97929,l,Non-pressure chronic ulcer of unspecified part of left lower leg with unspecified severity,Diseases of the skin and subcutaneous tissue,555,487,498,-0.122522523,0.022587269,-0.102702703,489,518,525,29,7,36
l981,l,Factitial dermatitis,Diseases of the skin and subcutaneous tissue,25,28,20,0.12,-0.285714286,-0.2,2878,2603,3080,-275,477,202
l98419,l,Non-pressure chronic ulcer of buttock with unspecified severity,Diseases of the skin and subcutaneous tissue,68,53,47,-0.220588235,-0.113207547,-0.308823529,1731,1861,2053,130,192,322
l98429,l,Non-pressure chronic ulcer of back with unspecified severity,Diseases of the skin and subcutaneous tissue,68,49,66,-0.279411765,0.346938776,-0.029411765,1731,1937,1697,206,-240,-34
l98491,l,Non-pressure chronic ulcer of skin of other sites limited to breakdown of skin,Diseases of the skin and subcutaneous tissue,24,39,25,0.625,-0.358974359,0.041666667,2924,2199,2800,-725,601,-124
l98498,l,Non-pressure chronic ulcer of skin of other sites with other specified severity,Diseases of the skin and subcutaneous tissue,24,36,23,0.5,-0.361111111,-0.041666667,2924,2285,2914,-639,629,-10
l98499,l,Non-pressure chronic ulcer of skin of other sites with unspecified severity,Diseases of the skin and subcutaneous tissue,213,200,185,-0.061032864,-0.075,-0.131455399,903,892,953,-11,61,50
l987,l,Excessive and redundant skin and subcutaneous tissue,Diseases of the skin and subcutaneous tissue,21,14,10,-0.333333333,-0.285714286,-0.523809524,3105,3526,3836,421,310,731
l988,l,Other specified disorders of the skin and subcutaneous tissue,Diseases of the skin and subcutaneous tissue,150,133,150,-0.113333333,0.127819549,0,1092,1120,1051,28,-69,-41
l989,l,"Disorder of the skin and subcutaneous tissue, unspecified",Diseases of the skin and subcutaneous tissue,331,262,306,-0.208459215,0.167938931,-0.075528701,676,755,705,79,-50,29
m00011,m,"Staphylococcal arthritis, right shoulder",Diseases of the musculoskeletal system and connective tissue,17,27,19,0.588235294,-0.296296296,0.117647059,3383,2645,3141,-738,496,-242
m00012,m,"Staphylococcal arthritis, left shoulder",Diseases of the musculoskeletal system and connective tissue,14,16,21,0.142857143,0.3125,0.5,3604,3371,3016,-233,-355,-588
m00051,m,"Staphylococcal arthritis, right hip",Diseases of the musculoskeletal system and connective tissue,17,16,17,-0.058823529,0.0625,0,3383,3371,3286,-12,-85,-97
m00052,m,"Staphylococcal arthritis, left hip",Diseases of the musculoskeletal system and connective tissue,18,12,20,-0.333333333,0.666666667,0.111111111,3315,3685,3072,370,-613,-243
m00061,m,"Staphylococcal arthritis, right knee",Diseases of the musculoskeletal system and connective tissue,76,58,80,-0.236842105,0.379310345,0.052631579,1618,1781,1520,163,-261,-98
m00062,m,"Staphylococcal arthritis, left knee",Diseases of the musculoskeletal system and connective tissue,58,60,61,0.034482759,0.016666667,0.051724138,1897,1751,1768,-146,17,-129
m00071,m,"Staphylococcal arthritis, right ankle and foot",Diseases of the musculoskeletal system and connective tissue,23,22,22,-0.043478261,0,-0.043478261,2974,2922,2962,-52,40,-12
m00072,m,"Staphylococcal arthritis, left ankle and foot",Diseases of the musculoskeletal system and connective tissue,20,17,19,-0.15,0.117647059,-0.05,3166,3289,3136,123,-153,-30
m00261,m,"Other streptococcal arthritis, right knee",Diseases of the musculoskeletal system and connective tissue,15,28,20,0.866666667,-0.285714286,0.333333333,3528,2594,3069,-934,475,-459
m00262,m,"Other streptococcal arthritis, left knee",Diseases of the musculoskeletal system and connective tissue,16,24,13,0.5,-0.458333333,-0.1875,3449,2802,3597,-647,795,148
m00811,m,"Arthritis due to other bacteria, right shoulder",Diseases of the musculoskeletal system and connective tissue,24,21,20,-0.125,-0.047619048,-0.166666667,2919,2991,3069,72,78,150
m00812,m,"Arthritis due to other bacteria, left shoulder",Diseases of the musculoskeletal system and connective tissue,11,17,19,0.545454545,0.117647059,0.727272727,3794,3286,3134,-508,-152,-660
m00841,m,"Arthritis due to other bacteria, right hand",Diseases of the musculoskeletal system and connective tissue,14,14,12,0,-0.142857143,-0.142857143,3595,3513,3670,-82,157,75
m00851,m,"Arthritis due to other bacteria, right hip",Diseases of the musculoskeletal system and connective tissue,15,21,17,0.4,-0.19047619,0.133333333,3526,2991,3278,-535,287,-248
m00852,m,"Arthritis due to other bacteria, left hip",Diseases of the musculoskeletal system and connective tissue,14,14,19,0,0.357142857,0.357142857,3594,3512,3134,-82,-378,-460
m00861,m,"Arthritis due to other bacteria, right knee",Diseases of the musculoskeletal system and connective tissue,69,46,64,-0.333333333,0.391304348,-0.072463768,1715,2005,1724,290,-281,9
m00862,m,"Arthritis due to other bacteria, left knee",Diseases of the musculoskeletal system and connective tissue,45,38,48,-0.155555556,0.263157895,0.066666667,2148,2221,2020,73,-201,-128
m00871,m,"Arthritis due to other bacteria, right ankle and foot",Diseases of the musculoskeletal system and connective tissue,38,25,18,-0.342105263,-0.28,-0.526315789,2338,2741,3200,403,459,862
m00872,m,"Arthritis due to other bacteria, left ankle and foot",Diseases of the musculoskeletal system and connective tissue,24,22,24,-0.083333333,0.090909091,0,2916,2917,2859,1,-58,-57
m009,m,"Pyogenic arthritis, unspecified",Diseases of the musculoskeletal system and connective tissue,829,813,767,-0.019300362,-0.056580566,-0.074788902,373,360,390,-13,30,17
m0230,m,"Reiter's disease, unspecified site",Diseases of the musculoskeletal system and connective tissue,16,29,15,0.8125,-0.482758621,-0.0625,3443,2534,3423,-909,889,-20
m0500,m,"Felty's syndrome, unspecified site",Diseases of the musculoskeletal system and connective tissue,14,14,11,0,-0.214285714,-0.214285714,3588,3506,3746,-82,240,158
m0510,m,Rheumatoid lung disease with rheumatoid arthritis of unspecified site,Diseases of the musculoskeletal system and connective tissue,49,51,37,0.040816327,-0.274509804,-0.244897959,2054,1891,2299,-163,408,245
m0550,m,Rheumatoid polyneuropathy with rheumatoid arthritis of unspecified site,Diseases of the musculoskeletal system and connective tissue,20,19,11,-0.05,-0.421052632,-0.45,3159,3120,3745,-39,625,586
m0579,m,Rheumatoid arthritis with rheumatoid factor of multiple sites without organ or systems involvement,Diseases of the musculoskeletal system and connective tissue,27,37,18,0.37037037,-0.513513514,-0.333333333,2767,2247,3197,-520,950,430
m059,m,"Rheumatoid arthritis with rheumatoid factor, unspecified",Diseases of the musculoskeletal system and connective tissue,64,72,48,0.125,-0.333333333,-0.25,1795,1582,2019,-213,437,224
m0600,m,"Rheumatoid arthritis without rheumatoid factor, unspecified site",Diseases of the musculoskeletal system and connective tissue,40,25,43,-0.375,0.72,0.075,2273,2736,2142,463,-594,-131
m0609,m,"Rheumatoid arthritis without rheumatoid factor, multiple sites",Diseases of the musculoskeletal system and connective tissue,11,14,10,0.272727273,-0.285714286,-0.090909091,3779,3501,3807,-278,306,28
m064,m,Inflammatory polyarthropathy,Diseases of the musculoskeletal system and connective tissue,132,116,120,-0.121212121,0.034482759,-0.090909091,1163,1207,1204,44,-3,41
m069,m,"Rheumatoid arthritis, unspecified",Diseases of the musculoskeletal system and connective tissue,6595,5738,5992,-0.129946929,0.044266295,-0.091432904,57,67,67,10,0,10
m0800,m,Unspecified juvenile rheumatoid arthritis of unspecified site,Diseases of the musculoskeletal system and connective tissue,75,57,40,-0.24,-0.298245614,-0.466666667,1628,1793,2218,165,425,590
m0820,m,"Juvenile rheumatoid arthritis with systemic onset, unspecified site",Diseases of the musculoskeletal system and connective tissue,14,10,10,-0.285714286,0,-0.285714286,3580,3815,3804,235,-11,224
m1a9xx0,m,"Chronic gout, unspecified, without tophus (tophi)",Diseases of the musculoskeletal system and connective tissue,426,388,468,-0.089201878,0.206185567,0.098591549,576,587,541,11,-46,-35
m1a9xx1,m,"Chronic gout, unspecified, with tophus (tophi)",Diseases of the musculoskeletal system and connective tissue,82,50,54,-0.390243902,0.08,-0.341463415,1552,1901,1888,349,-13,336
m1000,m,"Idiopathic gout, unspecified site",Diseases of the musculoskeletal system and connective tissue,19,15,16,-0.210526316,0.066666667,-0.157894737,3217,3405,3333,188,-72,116
m10061,m,"Idiopathic gout, right knee",Diseases of the musculoskeletal system and connective tissue,20,17,16,-0.15,-0.058823529,-0.2,3151,3269,3333,118,64,182
m10062,m,"Idiopathic gout, left knee",Diseases of the musculoskeletal system and connective tissue,14,21,12,0.5,-0.428571429,-0.142857143,3576,2976,3651,-600,675,75
m10071,m,"Idiopathic gout, right ankle and foot",Diseases of the musculoskeletal system and connective tissue,36,27,25,-0.25,-0.074074074,-0.305555556,2381,2630,2784,249,154,403
m10072,m,"Idiopathic gout, left ankle and foot",Diseases of the musculoskeletal system and connective tissue,28,27,21,-0.035714286,-0.222222222,-0.25,2705,2630,3000,-75,370,295
m109,m,"Gout, unspecified",Diseases of the musculoskeletal system and connective tissue,6549,6275,6003,-0.041838449,-0.043346614,-0.083371507,58,60,66,2,6,8
m1120,m,"Other chondrocalcinosis, unspecified site",Diseases of the musculoskeletal system and connective tissue,77,52,51,-0.324675325,-0.019230769,-0.337662338,1604,1867,1949,263,82,345
m11261,m,"Other chondrocalcinosis, right knee",Diseases of the musculoskeletal system and connective tissue,56,49,40,-0.125,-0.183673469,-0.285714286,1911,1922,2214,11,292,303
m11262,m,"Other chondrocalcinosis, left knee",Diseases of the musculoskeletal system and connective tissue,41,30,27,-0.268292683,-0.1,-0.341463415,2238,2479,2683,241,204,445
m12811,m,"Other specific arthropathies, not elsewhere classified, right shoulder",Diseases of the musculoskeletal system and connective tissue,43,45,53,0.046511628,0.177777778,0.23255814,2188,2016,1903,-172,-113,-285
m12812,m,"Other specific arthropathies, not elsewhere classified, left shoulder",Diseases of the musculoskeletal system and connective tissue,44,19,24,-0.568181818,0.263157895,-0.454545455,2161,3104,2844,943,-260,683
m129,m,"Arthropathy, unspecified",Diseases of the musculoskeletal system and connective tissue,459,368,325,-0.198257081,-0.116847826,-0.291938998,552,603,673,51,70,121
m130,m,"Polyarthritis, unspecified",Diseases of the musculoskeletal system and connective tissue,78,84,91,0.076923077,0.083333333,0.166666667,1591,1443,1424,-148,-19,-167
m1380,m,"Other specified arthritis, unspecified site",Diseases of the musculoskeletal system and connective tissue,23,19,24,-0.173913043,0.263157895,0.043478261,2949,3102,2842,153,-260,-107
m13811,m,"Other specified arthritis, right shoulder",Diseases of the musculoskeletal system and connective tissue,12,10,16,-0.166666667,0.6,0.333333333,3700,3799,3322,99,-477,-378
m14671,m,"Charcot's joint, right ankle and foot",Diseases of the musculoskeletal system and connective tissue,25,31,25,0.24,-0.193548387,0,2848,2430,2777,-418,347,-71
m14672,m,"Charcot's joint, left ankle and foot",Diseases of the musculoskeletal system and connective tissue,28,29,20,0.035714286,-0.310344828,-0.285714286,2697,2518,3045,-179,527,348
m150,m,Primary generalized (osteo)arthritis,Diseases of the musculoskeletal system and connective tissue,37,35,20,-0.054054054,-0.428571429,-0.459459459,2343,2288,3045,-55,757,702
m154,m,Erosive (osteo)arthritis,Diseases of the musculoskeletal system and connective tissue,17,17,13,0,-0.235294118,-0.235294118,3346,3254,3561,-92,307,215
m159,m,"Polyosteoarthritis, unspecified",Diseases of the musculoskeletal system and connective tissue,456,487,438,0.067982456,-0.100616016,-0.039473684,556,515,563,-41,48,7
m160,m,Bilateral primary osteoarthritis of hip,Diseases of the musculoskeletal system and connective tissue,438,308,314,-0.296803653,0.019480519,-0.283105023,563,674,688,111,14,125
m1610,m,"Unilateral primary osteoarthritis, unspecified hip",Diseases of the musculoskeletal system and connective tissue,170,126,111,-0.258823529,-0.119047619,-0.347058824,1004,1148,1261,144,113,257
m1611,m,"Unilateral primary osteoarthritis, right hip",Diseases of the musculoskeletal system and connective tissue,2907,1492,1271,-0.486756106,-0.148123324,-0.562779498,132,230,269,98,39,137
m1612,m,"Unilateral primary osteoarthritis, left hip",Diseases of the musculoskeletal system and connective tissue,2299,1299,1070,-0.434971727,-0.176289453,-0.534580252,163,257,302,94,45,139
m1651,m,"Unilateral post-traumatic osteoarthritis, right hip",Diseases of the musculoskeletal system and connective tissue,26,22,18,-0.153846154,-0.181818182,-0.307692308,2788,2889,3171,101,282,383
m1652,m,"Unilateral post-traumatic osteoarthritis, left hip",Diseases of the musculoskeletal system and connective tissue,26,21,15,-0.192307692,-0.285714286,-0.423076923,2788,2958,3391,170,433,603
m169,m,"Osteoarthritis of hip, unspecified",Diseases of the musculoskeletal system and connective tissue,27,36,20,0.333333333,-0.444444444,-0.259259259,2743,2258,3040,-485,782,297
m170,m,Bilateral primary osteoarthritis of knee,Diseases of the musculoskeletal system and connective tissue,1041,874,832,-0.160422671,-0.04805492,-0.200768492,304,330,355,26,25,51
m1710,m,"Unilateral primary osteoarthritis, unspecified knee",Diseases of the musculoskeletal system and connective tissue,361,296,307,-0.180055402,0.037162162,-0.149584488,632,688,691,56,3,59
m1711,m,"Unilateral primary osteoarthritis, right knee",Diseases of the musculoskeletal system and connective tissue,2853,1883,1705,-0.33999299,-0.094530005,-0.402383456,134,185,210,51,25,76
m1712,m,"Unilateral primary osteoarthritis, left knee",Diseases of the musculoskeletal system and connective tissue,2673,1750,1673,-0.345304901,-0.044,-0.374111485,138,198,213,60,15,75
m1731,m,"Unilateral post-traumatic osteoarthritis, right knee",Diseases of the musculoskeletal system and connective tissue,41,20,26,-0.512195122,0.3,-0.365853659,2225,3020,2716,795,-304,491
m1732,m,"Unilateral post-traumatic osteoarthritis, left knee",Diseases of the musculoskeletal system and connective tissue,46,20,24,-0.565217391,0.2,-0.47826087,2096,3020,2831,924,-189,735
m179,m,"Osteoarthritis of knee, unspecified",Diseases of the musculoskeletal system and connective tissue,24,13,12,-0.458333333,-0.076923077,-0.5,2879,3537,3621,658,84,742
m19011,m,"Primary osteoarthritis, right shoulder",Diseases of the musculoskeletal system and connective tissue,1006,850,930,-0.155069583,0.094117647,-0.07554672,311,335,328,24,-7,17
m19012,m,"Primary osteoarthritis, left shoulder",Diseases of the musculoskeletal system and connective tissue,867,683,792,-0.212226067,0.159590044,-0.08650519,353,412,372,59,-40,19
m19019,m,"Primary osteoarthritis, unspecified shoulder",Diseases of the musculoskeletal system and connective tissue,113,98,92,-0.132743363,-0.06122449,-0.185840708,1283,1305,1402,22,97,119
m19021,m,"Primary osteoarthritis, right elbow",Diseases of the musculoskeletal system and connective tissue,24,19,26,-0.208333333,0.368421053,0.083333333,2876,3082,2713,206,-369,-163
m19022,m,"Primary osteoarthritis, left elbow",Diseases of the musculoskeletal system and connective tissue,18,14,15,-0.222222222,0.071428571,-0.166666667,3260,3460,3380,200,-80,120
m19031,m,"Primary osteoarthritis, right wrist",Diseases of the musculoskeletal system and connective tissue,56,37,48,-0.339285714,0.297297297,-0.142857143,1897,2223,1998,326,-225,101
m19032,m,"Primary osteoarthritis, left wrist",Diseases of the musculoskeletal system and connective tissue,44,41,45,-0.068181818,0.097560976,0.022727273,2145,2114,2066,-31,-48,-79
m19039,m,"Primary osteoarthritis, unspecified wrist",Diseases of the musculoskeletal system and connective tissue,15,12,10,-0.2,-0.166666667,-0.333333333,3471,3616,3761,145,145,290
m19041,m,"Primary osteoarthritis, right hand",Diseases of the musculoskeletal system and connective tissue,246,223,204,-0.093495935,-0.085201794,-0.170731707,809,826,880,17,54,71
m19042,m,"Primary osteoarthritis, left hand",Diseases of the musculoskeletal system and connective tissue,229,218,205,-0.048034934,-0.059633028,-0.104803493,845,838,877,-7,39,32
m19049,m,"Primary osteoarthritis, unspecified hand",Diseases of the musculoskeletal system and connective tissue,69,48,70,-0.304347826,0.458333333,0.014492754,1691,1934,1628,243,-306,-63
m19071,m,"Primary osteoarthritis, right ankle and foot",Diseases of the musculoskeletal system and connective tissue,197,180,166,-0.086294416,-0.077777778,-0.157360406,916,920,980,4,60,64
m19072,m,"Primary osteoarthritis, left ankle and foot",Diseases of the musculoskeletal system and connective tissue,165,142,128,-0.139393939,-0.098591549,-0.224242424,1005,1054,1139,49,85,134
m19079,m,"Primary osteoarthritis, unspecified ankle and foot",Diseases of the musculoskeletal system and connective tissue,70,43,50,-0.385714286,0.162790698,-0.285714286,1674,2048,1948,374,-100,274
m19111,m,"Post-traumatic osteoarthritis, right shoulder",Diseases of the musculoskeletal system and connective tissue,20,15,17,-0.25,0.133333333,-0.15,3110,3362,3224,252,-138,114
m19171,m,"Post-traumatic osteoarthritis, right ankle and foot",Diseases of the musculoskeletal system and connective tissue,24,24,26,0,0.083333333,0.083333333,2868,2755,2705,-113,-50,-163
m19172,m,"Post-traumatic osteoarthritis, left ankle and foot",Diseases of the musculoskeletal system and connective tissue,28,13,17,-0.535714286,0.307692308,-0.392857143,2674,3522,3223,848,-299,549
m1990,m,"Unspecified osteoarthritis, unspecified site",Diseases of the musculoskeletal system and connective tissue,17217,13639,13963,-0.207817854,0.023755407,-0.188999245,14,20,21,6,1,7
m1991,m,"Primary osteoarthritis, unspecified site",Diseases of the musculoskeletal system and connective tissue,114,98,53,-0.140350877,-0.459183673,-0.535087719,1271,1300,1883,29,583,612
m2010,m,"Hallux valgus (acquired), unspecified foot",Diseases of the musculoskeletal system and connective tissue,23,18,14,-0.217391304,-0.222222222,-0.391304348,2915,3134,3441,219,307,526
m2011,m,"Hallux valgus (acquired), right foot",Diseases of the musculoskeletal system and connective tissue,32,15,14,-0.53125,-0.066666667,-0.5625,2496,3358,3441,862,83,945
m2012,m,"Hallux valgus (acquired), left foot",Diseases of the musculoskeletal system and connective tissue,19,21,13,0.105263158,-0.380952381,-0.315789474,3168,2939,3527,-229,588,359
m2040,m,"Other hammer toe(s) (acquired), unspecified foot",Diseases of the musculoskeletal system and connective tissue,42,25,31,-0.404761905,0.24,-0.261904762,2182,2696,2491,514,-205,309
m2041,m,"Other hammer toe(s) (acquired), right foot",Diseases of the musculoskeletal system and connective tissue,53,61,46,0.150943396,-0.245901639,-0.132075472,1937,1711,2034,-226,323,97
m2042,m,"Other hammer toe(s) (acquired), left foot",Diseases of the musculoskeletal system and connective tissue,56,46,43,-0.178571429,-0.065217391,-0.232142857,1889,1972,2110,83,138,221
m2100,m,"Valgus deformity, not elsewhere classified, unspecified site",Diseases of the musculoskeletal system and connective tissue,21,15,15,-0.285714286,0,-0.285714286,3035,3354,3364,319,10,329
m21061,m,"Valgus deformity, not elsewhere classified, right knee",Diseases of the musculoskeletal system and connective tissue,116,97,61,-0.163793103,-0.371134021,-0.474137931,1256,1312,1742,56,430,486
m21062,m,"Valgus deformity, not elsewhere classified, left knee",Diseases of the musculoskeletal system and connective tissue,97,54,70,-0.443298969,0.296296296,-0.278350515,1389,1808,1625,419,-183,236
m21071,m,"Valgus deformity, not elsewhere classified, right ankle",Diseases of the musculoskeletal system and connective tissue,12,15,11,0.25,-0.266666667,-0.083333333,3653,3352,3676,-301,324,23
m21072,m,"Valgus deformity, not elsewhere classified, left ankle",Diseases of the musculoskeletal system and connective tissue,13,14,13,0.076923077,-0.071428571,0,3591,3438,3521,-153,83,-70
m21161,m,"Varus deformity, not elsewhere classified, right knee",Diseases of the musculoskeletal system and connective tissue,116,71,75,-0.387931034,0.056338028,-0.353448276,1256,1567,1549,311,-18,293
m21162,m,"Varus deformity, not elsewhere classified, left knee",Diseases of the musculoskeletal system and connective tissue,126,86,73,-0.317460317,-0.151162791,-0.420634921,1182,1406,1577,224,171,395
m21331,m,"Wrist drop, right wrist",Diseases of the musculoskeletal system and connective tissue,19,18,31,-0.052631579,0.722222222,0.631578947,3160,3126,2485,-34,-641,-675
m21332,m,"Wrist drop, left wrist",Diseases of the musculoskeletal system and connective tissue,25,31,27,0.24,-0.129032258,0.08,2810,2400,2650,-410,250,-160
m21371,m,"Foot drop, right foot",Diseases of the musculoskeletal system and connective tissue,558,530,535,-0.050179211,0.009433962,-0.041218638,476,474,488,-2,14,12
m21372,m,"Foot drop, left foot",Diseases of the musculoskeletal system and connective tissue,565,546,556,-0.033628319,0.018315018,-0.015929204,468,464,475,-4,11,7
m21379,m,"Foot drop, unspecified foot",Diseases of the musculoskeletal system and connective tissue,88,68,95,-0.227272727,0.397058824,0.079545455,1460,1607,1369,147,-238,-91
m2140,m,"Flat foot [pes planus] (acquired), unspecified foot",Diseases of the musculoskeletal system and connective tissue,27,12,15,-0.555555556,0.25,-0.444444444,2712,3587,3355,875,-232,643
m2141,m,"Flat foot [pes planus] (acquired), right foot",Diseases of the musculoskeletal system and connective tissue,18,17,21,-0.055555556,0.235294118,0.166666667,3230,3211,2952,-19,-259,-278
m2142,m,"Flat foot [pes planus] (acquired), left foot",Diseases of the musculoskeletal system and connective tissue,15,15,25,0,0.666666667,0.666666667,3442,3344,2740,-98,-604,-702
m21611,m,Bunion of right foot,Diseases of the musculoskeletal system and connective tissue,20,10,11,-0.5,0.1,-0.45,3091,3740,3665,649,-75,574
m216x1,m,Other acquired deformities of right foot,Diseases of the musculoskeletal system and connective tissue,13,19,24,0.461538462,0.263157895,0.846153846,3580,3059,2803,-521,-256,-777
m2170,m,"Unequal limb length (acquired), unspecified site",Diseases of the musculoskeletal system and connective tissue,59,69,55,0.169491525,-0.202898551,-0.06779661,1836,1590,1839,-246,249,3
m21751,m,"Unequal limb length (acquired), right femur",Diseases of the musculoskeletal system and connective tissue,25,17,20,-0.32,0.176470588,-0.2,2805,3209,3003,404,-206,198
m21752,m,"Unequal limb length (acquired), left femur",Diseases of the musculoskeletal system and connective tissue,22,24,16,0.090909091,-0.333333333,-0.272727273,2961,2741,3272,-220,531,311
m21851,m,Other specified acquired deformities of right thigh,Diseases of the musculoskeletal system and connective tissue,11,10,10,-0.090909091,0,-0.090909091,3694,3736,3724,42,-12,30
m21961,m,Unspecified acquired deformity of right lower leg,Diseases of the musculoskeletal system and connective tissue,20,21,20,0.05,-0.047619048,0,3088,2926,3003,-162,77,-85
m21962,m,Unspecified acquired deformity of left lower leg,Diseases of the musculoskeletal system and connective tissue,25,26,19,0.04,-0.269230769,-0.24,2805,2641,3063,-164,422,258
m2352,m,"Chronic instability of knee, left knee",Diseases of the musculoskeletal system and connective tissue,24,15,11,-0.375,-0.266666667,-0.541666667,2849,3338,3659,489,321,810
m24411,m,"Recurrent dislocation, right shoulder",Diseases of the musculoskeletal system and connective tissue,22,11,30,-0.5,1.727272727,0.363636364,2959,3654,2519,695,-1135,-440
m24412,m,"Recurrent dislocation, left shoulder",Diseases of the musculoskeletal system and connective tissue,17,16,22,-0.058823529,0.375,0.294117647,3287,3279,2897,-8,-382,-390
m24451,m,"Recurrent dislocation, right hip",Diseases of the musculoskeletal system and connective tissue,22,18,16,-0.181818182,-0.111111111,-0.272727273,2959,3117,3268,158,151,309
m24452,m,"Recurrent dislocation, left hip",Diseases of the musculoskeletal system and connective tissue,17,16,19,-0.058823529,0.1875,0.117647059,3286,3278,3061,-8,-217,-225
m2450,m,"Contracture, unspecified joint",Diseases of the musculoskeletal system and connective tissue,49,37,24,-0.244897959,-0.351351351,-0.510204082,2012,2204,2801,192,597,789
m24511,m,"Contracture, right shoulder",Diseases of the musculoskeletal system and connective tissue,14,23,14,0.642857143,-0.391304348,0,3496,2795,3414,-701,619,-82
m24541,m,"Contracture, right hand",Diseases of the musculoskeletal system and connective tissue,49,33,36,-0.326530612,0.090909091,-0.265306122,2012,2320,2276,308,-44,264
m24542,m,"Contracture, left hand",Diseases of the musculoskeletal system and connective tissue,44,35,40,-0.204545455,0.142857143,-0.090909091,2125,2254,2179,129,-75,54
m24551,m,"Contracture, right hip",Diseases of the musculoskeletal system and connective tissue,44,21,25,-0.522727273,0.19047619,-0.431818182,2125,2921,2736,796,-185,611
m24552,m,"Contracture, left hip",Diseases of the musculoskeletal system and connective tissue,43,16,19,-0.627906977,0.1875,-0.558139535,2148,3273,3057,1125,-216,909
m24561,m,"Contracture, right knee",Diseases of the musculoskeletal system and connective tissue,87,84,69,-0.034482759,-0.178571429,-0.206896552,1468,1421,1627,-47,206,159
m24562,m,"Contracture, left knee",Diseases of the musculoskeletal system and connective tissue,107,69,65,-0.355140187,-0.057971014,-0.392523364,1310,1589,1679,279,90,369
m24571,m,"Contracture, right ankle",Diseases of the musculoskeletal system and connective tissue,28,22,23,-0.214285714,0.045454545,-0.178571429,2653,2850,2838,197,-12,185
m24572,m,"Contracture, left ankle",Diseases of the musculoskeletal system and connective tissue,26,26,27,0,0.038461538,0.038461538,2746,2636,2641,-110,5,-105
m24661,m,"Ankylosis, right knee",Diseases of the musculoskeletal system and connective tissue,51,20,39,-0.607843137,0.95,-0.235294118,1969,2981,2201,1012,-780,232
m24662,m,"Ankylosis, left knee",Diseases of the musculoskeletal system and connective tissue,40,28,59,-0.3,1.107142857,0.475,2217,2533,1765,316,-768,-452
m247,m,Protrusio acetabuli,Diseases of the musculoskeletal system and connective tissue,29,15,17,-0.482758621,0.133333333,-0.413793103,2603,3323,3188,720,-135,585
m2500,m,"Hemarthrosis, unspecified joint",Diseases of the musculoskeletal system and connective tissue,23,30,20,0.304347826,-0.333333333,-0.130434783,2886,2435,2991,-451,556,105
m25061,m,"Hemarthrosis, right knee",Diseases of the musculoskeletal system and connective tissue,52,44,41,-0.153846154,-0.068181818,-0.211538462,1944,2014,2150,70,136,206
m25062,m,"Hemarthrosis, left knee",Diseases of the musculoskeletal system and connective tissue,64,36,52,-0.4375,0.444444444,-0.1875,1757,2227,1892,470,-335,135
m25361,m,"Other instability, right knee",Diseases of the musculoskeletal system and connective tissue,18,18,18,0,0,0,3206,3103,3113,-103,10,-93
m25362,m,"Other instability, left knee",Diseases of the musculoskeletal system and connective tissue,34,13,17,-0.617647059,0.307692308,-0.5,2393,3473,3184,1080,-289,791
m25371,m,"Other instability, right ankle",Diseases of the musculoskeletal system and connective tissue,13,12,20,-0.076923077,0.666666667,0.538461538,3552,3557,2989,5,-568,-563
m25372,m,"Other instability, left ankle",Diseases of the musculoskeletal system and connective tissue,17,15,12,-0.117647059,-0.2,-0.294117647,3269,3319,3554,50,235,285
m25412,m,"Effusion, left shoulder",Diseases of the musculoskeletal system and connective tissue,15,14,14,-0.066666667,0,-0.066666667,3413,3401,3397,-12,-4,-16
m25421,m,"Effusion, right elbow",Diseases of the musculoskeletal system and connective tissue,26,24,12,-0.076923077,-0.5,-0.538461538,2740,2730,3553,-10,823,813
m25422,m,"Effusion, left elbow",Diseases of the musculoskeletal system and connective tissue,28,28,20,0,-0.285714286,-0.285714286,2647,2530,2989,-117,459,342
m25451,m,"Effusion, right hip",Diseases of the musculoskeletal system and connective tissue,29,33,32,0.137931034,-0.03030303,0.103448276,2600,2315,2432,-285,117,-168
m25452,m,"Effusion, left hip",Diseases of the musculoskeletal system and connective tissue,29,29,28,0,-0.034482759,-0.034482759,2600,2474,2593,-126,119,-7
m25461,m,"Effusion, right knee",Diseases of the musculoskeletal system and connective tissue,266,226,233,-0.15037594,0.030973451,-0.12406015,770,813,817,43,4,47
m25462,m,"Effusion, left knee",Diseases of the musculoskeletal system and connective tissue,251,228,185,-0.091633466,-0.188596491,-0.262948207,795,806,931,11,125,136
m25471,m,"Effusion, right ankle",Diseases of the musculoskeletal system and connective tissue,40,41,34,0.025,-0.170731707,-0.15,2213,2091,2346,-122,255,133
m25472,m,"Effusion, left ankle",Diseases of the musculoskeletal system and connective tissue,41,51,37,0.243902439,-0.274509804,-0.097560976,2188,1851,2245,-337,394,57
m2550,m,Pain in unspecified joint,Diseases of the musculoskeletal system and connective tissue,167,158,133,-0.053892216,-0.158227848,-0.203592814,992,987,1102,-5,115,110
m25511,m,Pain in right shoulder,Diseases of the musculoskeletal system and connective tissue,920,913,824,-0.007608696,-0.097480832,-0.104347826,328,321,356,-7,35,28
m25512,m,Pain in left shoulder,Diseases of the musculoskeletal system and connective tissue,878,747,807,-0.149202733,0.080321285,-0.080865604,346,371,362,25,-9,16
m25519,m,Pain in unspecified shoulder,Diseases of the musculoskeletal system and connective tissue,183,177,154,-0.032786885,-0.129943503,-0.158469945,939,920,1011,-19,91,72
m25521,m,Pain in right elbow,Diseases of the musculoskeletal system and connective tissue,105,74,101,-0.295238095,0.364864865,-0.038095238,1318,1513,1309,195,-204,-9
m25522,m,Pain in left elbow,Diseases of the musculoskeletal system and connective tissue,102,104,109,0.019607843,0.048076923,0.068627451,1334,1246,1259,-88,13,-75
m25531,m,Pain in right wrist,Diseases of the musculoskeletal system and connective tissue,137,142,126,0.03649635,-0.112676056,-0.080291971,1117,1045,1144,-72,99,27
m25532,m,Pain in left wrist,Diseases of the musculoskeletal system and connective tissue,140,126,134,-0.1,0.063492063,-0.042857143,1102,1126,1094,24,-32,-8
m25541,m,Pain in joints of right hand,Diseases of the musculoskeletal system and connective tissue,28,19,27,-0.321428571,0.421052632,-0.035714286,2633,3025,2623,392,-402,-10
m25542,m,Pain in joints of left hand,Diseases of the musculoskeletal system and connective tissue,16,14,23,-0.125,0.642857143,0.4375,3319,3384,2818,65,-566,-501
m25551,m,Pain in right hip,Diseases of the musculoskeletal system and connective tissue,1193,1131,1040,-0.051969824,-0.08045977,-0.128248114,272,272,306,0,34,34
m25552,m,Pain in left hip,Diseases of the musculoskeletal system and connective tissue,1098,991,971,-0.097449909,-0.020181635,-0.115664845,291,306,319,15,13,28
m25559,m,Pain in unspecified hip,Diseases of the musculoskeletal system and connective tissue,182,188,157,0.032967033,-0.164893617,-0.137362637,938,898,999,-40,101,61
m25561,m,Pain in right knee,Diseases of the musculoskeletal system and connective tissue,1014,871,838,-0.141025641,-0.037887486,-0.17357002,307,324,348,17,24,41
m25562,m,Pain in left knee,Diseases of the musculoskeletal system and connective tissue,936,781,741,-0.165598291,-0.051216389,-0.208333333,321,356,383,35,27,62
m25569,m,Pain in unspecified knee,Diseases of the musculoskeletal system and connective tissue,208,166,156,-0.201923077,-0.060240964,-0.25,884,948,1001,64,53,117
m25571,m,Pain in right ankle and joints of right foot,Diseases of the musculoskeletal system and connective tissue,346,307,297,-0.112716763,-0.03257329,-0.141618497,637,662,696,25,34,59
m25572,m,Pain in left ankle and joints of left foot,Diseases of the musculoskeletal system and connective tissue,295,270,264,-0.084745763,-0.022222222,-0.105084746,719,719,754,0,35,35
m25579,m,Pain in unspecified ankle and joints of unspecified foot,Diseases of the musculoskeletal system and connective tissue,36,25,42,-0.305555556,0.68,0.166666667,2306,2651,2103,345,-548,-203
m25611,m,"Stiffness of right shoulder, not elsewhere classified",Diseases of the musculoskeletal system and connective tissue,15,14,18,-0.066666667,0.285714286,0.2,3386,3375,3086,-11,-289,-300
m25711,m,"Osteophyte, right shoulder",Diseases of the musculoskeletal system and connective tissue,15,21,23,0.4,0.095238095,0.533333333,3386,2888,2809,-498,-79,-577
m25712,m,"Osteophyte, left shoulder",Diseases of the musculoskeletal system and connective tissue,11,20,29,0.818181818,0.45,1.636363636,3637,2951,2519,-686,-432,-1118
m25751,m,"Osteophyte, right hip",Diseases of the musculoskeletal system and connective tissue,22,14,15,-0.363636364,0.071428571,-0.318181818,2917,3373,3296,456,-77,379
m25752,m,"Osteophyte, left hip",Diseases of the musculoskeletal system and connective tissue,19,14,24,-0.263157895,0.714285714,0.263157895,3103,3373,2766,270,-607,-337
m25761,m,"Osteophyte, right knee",Diseases of the musculoskeletal system and connective tissue,32,64,87,1,0.359375,1.71875,2452,1636,1410,-816,-226,-1042
m25762,m,"Osteophyte, left knee",Diseases of the musculoskeletal system and connective tissue,37,62,95,0.675675676,0.532258065,1.567567568,2277,1669,1351,-608,-318,-926
m2578,m,"Osteophyte, vertebrae",Diseases of the musculoskeletal system and connective tissue,244,274,268,0.12295082,-0.02189781,0.098360656,798,712,742,-86,30,-56
m25811,m,"Other specified joint disorders, right shoulder",Diseases of the musculoskeletal system and connective tissue,29,19,18,-0.344827586,-0.052631579,-0.379310345,2576,3011,3080,435,69,504
m25812,m,"Other specified joint disorders, left shoulder",Diseases of the musculoskeletal system and connective tissue,23,12,11,-0.47826087,-0.083333333,-0.52173913,2853,3519,3598,666,79,745
m2602,m,Maxillary hypoplasia,Diseases of the musculoskeletal system and connective tissue,33,28,30,-0.151515152,0.071428571,-0.090909091,2406,2505,2486,99,-19,80
m2604,m,Mandibular hypoplasia,Diseases of the musculoskeletal system and connective tissue,18,12,17,-0.333333333,0.416666667,-0.055555556,3171,3518,3148,347,-370,-23
m2609,m,Other specified anomalies of jaw size,Diseases of the musculoskeletal system and connective tissue,32,26,18,-0.1875,-0.307692308,-0.4375,2449,2605,3079,156,474,630
m2619,m,Other specified anomalies of jaw-cranial base relationship,Diseases of the musculoskeletal system and connective tissue,15,19,29,0.266666667,0.526315789,0.933333333,3376,3009,2515,-367,-494,-861
m264,m,"Malocclusion, unspecified",Diseases of the musculoskeletal system and connective tissue,58,48,57,-0.172413793,0.1875,-0.017241379,1835,1897,1773,62,-124,-62
m26609,m,"Unspecified temporomandibular joint disorder, unspecified side",Diseases of the musculoskeletal system and connective tissue,94,65,66,-0.308510638,0.015384615,-0.29787234,1385,1622,1640,237,18,255
m26629,m,"Arthralgia of temporomandibular joint, unspecified side",Diseases of the musculoskeletal system and connective tissue,29,22,22,-0.24137931,0,-0.24137931,2572,2813,2850,241,37,278
m2669,m,Other specified disorders of temporomandibular joint,Diseases of the musculoskeletal system and connective tissue,33,31,22,-0.060606061,-0.290322581,-0.333333333,2404,2363,2850,-41,487,446
m272,m,Inflammatory conditions of jaws,Diseases of the musculoskeletal system and connective tissue,199,170,180,-0.145728643,0.058823529,-0.095477387,900,928,926,28,-2,26
m300,m,Polyarteritis nodosa,Diseases of the musculoskeletal system and connective tissue,29,39,23,0.344827586,-0.41025641,-0.206896552,2570,2119,2799,-451,680,229
m301,m,Polyarteritis with lung involvement [Churg-Strauss],Diseases of the musculoskeletal system and connective tissue,26,24,25,-0.076923077,0.041666667,-0.038461538,2703,2696,2696,-7,0,-7
m303,m,Mucocutaneous lymph node syndrome [Kawasaki],Diseases of the musculoskeletal system and connective tissue,36,46,37,0.277777778,-0.195652174,0.027777778,2301,1937,2222,-364,285,-79
m310,m,Hypersensitivity angiitis,Diseases of the musculoskeletal system and connective tissue,33,32,26,-0.03030303,-0.1875,-0.212121212,2402,2323,2646,-79,323,244
m311,m,Thrombotic microangiopathy,Diseases of the musculoskeletal system and connective tissue,97,116,162,0.195876289,0.396551724,0.670103093,1364,1167,977,-197,-190,-387
m3130,m,Wegener's granulomatosis without renal involvement,Diseases of the musculoskeletal system and connective tissue,98,102,91,0.040816327,-0.107843137,-0.071428571,1356,1243,1382,-113,139,26
m3131,m,Wegener's granulomatosis with renal involvement,Diseases of the musculoskeletal system and connective tissue,53,44,48,-0.169811321,0.090909091,-0.094339623,1901,1986,1952,85,-34,51
m315,m,Giant cell arteritis with polymyalgia rheumatica,Diseases of the musculoskeletal system and connective tissue,15,16,11,0.066666667,-0.3125,-0.266666667,3364,3216,3582,-148,366,218
m316,m,Other giant cell arteritis,Diseases of the musculoskeletal system and connective tissue,131,115,103,-0.122137405,-0.104347826,-0.213740458,1128,1171,1276,43,105,148
m317,m,Microscopic polyangiitis,Diseases of the musculoskeletal system and connective tissue,38,28,31,-0.263157895,0.107142857,-0.184210526,2247,2494,2440,247,-54,193
m3213,m,Lung involvement in systemic lupus erythematosus,Diseases of the musculoskeletal system and connective tissue,26,19,24,-0.269230769,0.263157895,-0.076923077,2696,2995,2750,299,-245,54
m3214,m,Glomerular disease in systemic lupus erythematosus,Diseases of the musculoskeletal system and connective tissue,306,324,316,0.058823529,-0.024691358,0.032679739,697,636,669,-61,33,-28
m3219,m,Other organ or system involvement in systemic lupus erythematosus,Diseases of the musculoskeletal system and connective tissue,46,38,41,-0.173913043,0.078947368,-0.108695652,2040,2140,2119,100,-21,79
m329,m,"Systemic lupus erythematosus, unspecified",Diseases of the musculoskeletal system and connective tissue,1700,1526,1563,-0.102352941,0.024246396,-0.080588235,209,222,229,13,7,20
m3313,m,Other dermatomyositis without myopathy,Diseases of the musculoskeletal system and connective tissue,42,38,49,-0.095238095,0.289473684,0.166666667,2133,2139,1926,6,-213,-207
m3320,m,"Polymyositis, organ involvement unspecified",Diseases of the musculoskeletal system and connective tissue,51,54,61,0.058823529,0.12962963,0.196078431,1939,1772,1706,-167,-66,-233
m341,m,CR(E)ST syndrome,Diseases of the musculoskeletal system and connective tissue,107,71,84,-0.336448598,0.183098592,-0.214953271,1289,1538,1428,249,-110,139
m3481,m,Systemic sclerosis with lung involvement,Diseases of the musculoskeletal system and connective tissue,22,18,16,-0.181818182,-0.111111111,-0.272727273,2889,3047,3190,158,143,301
m3489,m,Other systemic sclerosis,Diseases of the musculoskeletal system and connective tissue,11,11,10,0,-0.090909091,-0.090909091,3603,3566,3632,-37,66,29
m349,m,"Systemic sclerosis, unspecified",Diseases of the musculoskeletal system and connective tissue,273,227,215,-0.168498168,-0.052863436,-0.212454212,748,797,836,49,39,88
m3500,m,"Sicca syndrome, unspecified",Diseases of the musculoskeletal system and connective tissue,707,708,644,0.001414427,-0.09039548,-0.089108911,408,390,418,-18,28,10
m351,m,Other overlap syndromes,Diseases of the musculoskeletal system and connective tissue,99,96,92,-0.03030303,-0.041666667,-0.070707071,1337,1292,1367,-45,75,30
m352,m,Behcet's disease,Diseases of the musculoskeletal system and connective tissue,40,41,46,0.025,0.12195122,0.15,2179,2056,1986,-123,-70,-193
m353,m,Polymyalgia rheumatica,Diseases of the musculoskeletal system and connective tissue,532,568,464,0.067669173,-0.183098592,-0.127819549,490,444,525,-46,81,35
m359,m,"Systemic involvement of connective tissue, unspecified",Diseases of the musculoskeletal system and connective tissue,35,31,45,-0.114285714,0.451612903,0.285714286,2319,2344,2007,25,-337,-312
m40202,m,"Unspecified kyphosis, cervical region",Diseases of the musculoskeletal system and connective tissue,82,76,69,-0.073170732,-0.092105263,-0.158536585,1492,1471,1595,-21,124,103
m40204,m,"Unspecified kyphosis, thoracic region",Diseases of the musculoskeletal system and connective tissue,110,127,75,0.154545455,-0.409448819,-0.318181818,1264,1101,1514,-163,413,250
m40205,m,"Unspecified kyphosis, thoracolumbar region",Diseases of the musculoskeletal system and connective tissue,27,29,22,0.074074074,-0.24137931,-0.185185185,2639,2426,2825,-213,399,186
m40209,m,"Unspecified kyphosis, site unspecified",Diseases of the musculoskeletal system and connective tissue,173,155,125,-0.104046243,-0.193548387,-0.277456647,956,979,1129,23,150,173
m40292,m,"Other kyphosis, cervical region",Diseases of the musculoskeletal system and connective tissue,27,18,30,-0.333333333,0.666666667,0.111111111,2638,3037,2462,399,-575,-176
m40294,m,"Other kyphosis, thoracic region",Diseases of the musculoskeletal system and connective tissue,30,27,25,-0.1,-0.074074074,-0.166666667,2501,2522,2673,21,151,172
m4036,m,"Flatback syndrome, lumbar region",Diseases of the musculoskeletal system and connective tissue,16,16,23,0,0.4375,0.4375,3266,3194,2773,-72,-421,-493
m41124,m,"Adolescent idiopathic scoliosis, thoracic region",Diseases of the musculoskeletal system and connective tissue,23,22,25,-0.043478261,0.136363636,0.086956522,2818,2785,2673,-33,-112,-145
m41125,m,"Adolescent idiopathic scoliosis, thoracolumbar region",Diseases of the musculoskeletal system and connective tissue,56,52,70,-0.071428571,0.346153846,0.25,1843,1799,1586,-44,-213,-257
m41129,m,"Adolescent idiopathic scoliosis, site unspecified",Diseases of the musculoskeletal system and connective tissue,24,18,18,-0.25,0,-0.25,2768,3034,3042,266,8,274
m4120,m,"Other idiopathic scoliosis, site unspecified",Diseases of the musculoskeletal system and connective tissue,17,18,28,0.058823529,0.555555556,0.647058824,3196,3034,2540,-162,-494,-656
m4126,m,"Other idiopathic scoliosis, lumbar region",Diseases of the musculoskeletal system and connective tissue,21,24,18,0.142857143,-0.25,-0.142857143,2932,2671,3041,-261,370,109
m4140,m,"Neuromuscular scoliosis, site unspecified",Diseases of the musculoskeletal system and connective tissue,94,57,75,-0.393617021,0.315789474,-0.20212766,1372,1725,1513,353,-212,141
m4145,m,"Neuromuscular scoliosis, thoracolumbar region",Diseases of the musculoskeletal system and connective tissue,45,29,34,-0.355555556,0.172413793,-0.244444444,2056,2423,2300,367,-123,244
m4150,m,"Other secondary scoliosis, site unspecified",Diseases of the musculoskeletal system and connective tissue,46,28,30,-0.391304348,0.071428571,-0.347826087,2028,2475,2459,447,-16,431
m4155,m,"Other secondary scoliosis, thoracolumbar region",Diseases of the musculoskeletal system and connective tissue,23,15,12,-0.347826087,-0.2,-0.47826087,2813,3240,3471,427,231,658
m4156,m,"Other secondary scoliosis, lumbar region",Diseases of the musculoskeletal system and connective tissue,125,104,96,-0.168,-0.076923077,-0.232,1160,1225,1329,65,104,169
m4157,m,"Other secondary scoliosis, lumbosacral region",Diseases of the musculoskeletal system and connective tissue,16,11,12,-0.3125,0.090909091,-0.25,3256,3543,3470,287,-73,214
m4184,m,"Other forms of scoliosis, thoracic region",Diseases of the musculoskeletal system and connective tissue,21,20,27,-0.047619048,0.35,0.285714286,2927,2908,2577,-19,-331,-350
m4185,m,"Other forms of scoliosis, thoracolumbar region",Diseases of the musculoskeletal system and connective tissue,41,35,38,-0.146341463,0.085714286,-0.073170732,2146,2201,2178,55,-23,32
m4186,m,"Other forms of scoliosis, lumbar region",Diseases of the musculoskeletal system and connective tissue,135,85,131,-0.37037037,0.541176471,-0.02962963,1107,1379,1095,272,-284,-12
m4187,m,"Other forms of scoliosis, lumbosacral region",Diseases of the musculoskeletal system and connective tissue,16,11,12,-0.3125,0.090909091,-0.25,3253,3540,3467,287,-73,214
m419,m,"Scoliosis, unspecified",Diseases of the musculoskeletal system and connective tissue,1617,1511,1400,-0.065553494,-0.073461284,-0.134199134,216,224,244,8,20,28
m4302,m,"Spondylolysis, cervical region",Diseases of the musculoskeletal system and connective tissue,10,15,17,0.5,0.133333333,0.7,3632,3235,3099,-397,-136,-533
m4306,m,"Spondylolysis, lumbar region",Diseases of the musculoskeletal system and connective tissue,60,48,53,-0.2,0.104166667,-0.116666667,1771,1876,1829,105,-47,58
m4307,m,"Spondylolysis, lumbosacral region",Diseases of the musculoskeletal system and connective tissue,23,12,14,-0.47826087,0.166666667,-0.391304348,2808,3464,3308,656,-156,500
m4310,m,"Spondylolisthesis, site unspecified",Diseases of the musculoskeletal system and connective tissue,99,100,79,0.01010101,-0.21,-0.202020202,1331,1252,1473,-79,221,142
m4312,m,"Spondylolisthesis, cervical region",Diseases of the musculoskeletal system and connective tissue,211,211,204,0,-0.033175355,-0.033175355,868,832,860,-36,28,-8
m4313,m,"Spondylolisthesis, cervicothoracic region",Diseases of the musculoskeletal system and connective tissue,18,13,28,-0.277777778,1.153846154,0.555555556,3119,3378,2530,259,-848,-589
m4316,m,"Spondylolisthesis, lumbar region",Diseases of the musculoskeletal system and connective tissue,1730,1472,1565,-0.149132948,0.063179348,-0.095375723,207,227,228,20,1,21
m4317,m,"Spondylolisthesis, lumbosacral region",Diseases of the musculoskeletal system and connective tissue,384,362,387,-0.057291667,0.069060773,0.0078125,585,584,585,-1,1,0
m4319,m,"Spondylolisthesis, multiple sites in spine",Diseases of the musculoskeletal system and connective tissue,18,11,10,-0.388888889,-0.090909091,-0.444444444,3117,3531,3595,414,64,478
m436,m,Torticollis,Diseases of the musculoskeletal system and connective tissue,189,166,162,-0.121693122,-0.024096386,-0.142857143,906,935,968,29,33,62
m452,m,Ankylosing spondylitis of cervical region,Diseases of the musculoskeletal system and connective tissue,23,17,21,-0.260869565,0.235294118,-0.086956522,2803,3102,2850,299,-252,47
m456,m,Ankylosing spondylitis lumbar region,Diseases of the musculoskeletal system and connective tissue,17,11,14,-0.352941176,0.272727273,-0.176470588,3176,3529,3301,353,-228,125
m459,m,Ankylosing spondylitis of unspecified sites in spine,Diseases of the musculoskeletal system and connective tissue,207,212,205,0.024154589,-0.033018868,-0.009661836,874,829,856,-45,27,-18
m461,m,"Sacroiliitis, not elsewhere classified",Diseases of the musculoskeletal system and connective tissue,74,46,74,-0.378378378,0.608695652,0,1571,1911,1515,340,-396,-56
m4620,m,"Osteomyelitis of vertebra, site unspecified",Diseases of the musculoskeletal system and connective tissue,24,30,29,0.25,-0.033333333,0.208333333,2753,2369,2474,-384,105,-279
m4622,m,"Osteomyelitis of vertebra, cervical region",Diseases of the musculoskeletal system and connective tissue,83,62,87,-0.253012048,0.403225806,0.048192771,1469,1644,1389,175,-255,-80
m4624,m,"Osteomyelitis of vertebra, thoracic region",Diseases of the musculoskeletal system and connective tissue,157,155,165,-0.012738854,0.064516129,0.050955414,1007,973,959,-34,-14,-48
m4625,m,"Osteomyelitis of vertebra, thoracolumbar region",Diseases of the musculoskeletal system and connective tissue,33,18,14,-0.454545455,-0.222222222,-0.575757576,2364,3014,3296,650,282,932
m4626,m,"Osteomyelitis of vertebra, lumbar region",Diseases of the musculoskeletal system and connective tissue,273,280,271,0.025641026,-0.032142857,-0.007326007,743,691,728,-52,37,-15
m4627,m,"Osteomyelitis of vertebra, lumbosacral region",Diseases of the musculoskeletal system and connective tissue,51,56,73,0.098039216,0.303571429,0.431372549,1915,1725,1526,-190,-199,-389
m4628,m,"Osteomyelitis of vertebra, sacral and sacrococcygeal region",Diseases of the musculoskeletal system and connective tissue,256,209,260,-0.18359375,0.244019139,0.015625,766,831,749,65,-82,-17
m4636,m,"Infection of intervertebral disc (pyogenic), lumbar region",Diseases of the musculoskeletal system and connective tissue,13,14,15,0.076923077,0.071428571,0.153846154,3438,3299,3222,-139,-77,-216
m4640,m,"Discitis, unspecified, site unspecified",Diseases of the musculoskeletal system and connective tissue,25,29,25,0.16,-0.137931034,0,2703,2405,2648,-298,243,-55
m4642,m,"Discitis, unspecified, cervical region",Diseases of the musculoskeletal system and connective tissue,31,37,36,0.193548387,-0.027027027,0.161290323,2433,2137,2204,-296,67,-229
m4644,m,"Discitis, unspecified, thoracic region",Diseases of the musculoskeletal system and connective tissue,98,86,91,-0.12244898,0.058139535,-0.071428571,1334,1363,1363,29,0,29
m4645,m,"Discitis, unspecified, thoracolumbar region",Diseases of the musculoskeletal system and connective tissue,13,10,11,-0.230769231,0.1,-0.153846154,3435,3589,3519,154,-70,84
m4646,m,"Discitis, unspecified, lumbar region",Diseases of the musculoskeletal system and connective tissue,185,183,174,-0.010810811,-0.049180328,-0.059459459,907,887,928,-20,41,21
m4647,m,"Discitis, unspecified, lumbosacral region",Diseases of the musculoskeletal system and connective tissue,21,40,40,0.904761905,0,0.904761905,2903,2058,2110,-845,52,-793
m4649,m,"Discitis, unspecified, multiple sites in spine",Diseases of the musculoskeletal system and connective tissue,19,18,25,-0.052631579,0.388888889,0.315789474,3027,3006,2644,-21,-362,-383
m4690,m,"Unspecified inflammatory spondylopathy, site unspecified",Diseases of the musculoskeletal system and connective tissue,100,76,16,-0.24,-0.789473684,-0.84,1316,1455,3141,139,1686,1825
m4696,m,"Unspecified inflammatory spondylopathy, lumbar region",Diseases of the musculoskeletal system and connective tissue,75,30,16,-0.6,-0.466666667,-0.786666667,1544,2359,3141,815,782,1597
m4712,m,"Other spondylosis with myelopathy, cervical region",Diseases of the musculoskeletal system and connective tissue,512,488,489,-0.046875,0.00204918,-0.044921875,497,492,508,-5,16,11
m4714,m,"Other spondylosis with myelopathy, thoracic region",Diseases of the musculoskeletal system and connective tissue,38,31,34,-0.184210526,0.096774194,-0.105263158,2207,2316,2278,109,-38,71
m4716,m,"Other spondylosis with myelopathy, lumbar region",Diseases of the musculoskeletal system and connective tissue,45,52,43,0.155555556,-0.173076923,-0.044444444,2034,1780,2035,-254,255,1
m4722,m,"Other spondylosis with radiculopathy, cervical region",Diseases of the musculoskeletal system and connective tissue,324,262,339,-0.191358025,0.29389313,0.046296296,654,719,632,65,-87,-22
m4726,m,"Other spondylosis with radiculopathy, lumbar region",Diseases of the musculoskeletal system and connective tissue,787,702,713,-0.108005083,0.015669516,-0.094027954,373,394,398,21,4,25
m4727,m,"Other spondylosis with radiculopathy, lumbosacral region",Diseases of the musculoskeletal system and connective tissue,145,128,164,-0.117241379,0.28125,0.131034483,1048,1080,956,32,-124,-92
m47812,m,"Spondylosis without myelopathy or radiculopathy, cervical region",Diseases of the musculoskeletal system and connective tissue,554,575,559,0.037906137,-0.027826087,0.009025271,465,436,460,-29,24,-5
m47814,m,"Spondylosis without myelopathy or radiculopathy, thoracic region",Diseases of the musculoskeletal system and connective tissue,171,196,138,0.14619883,-0.295918367,-0.192982456,953,857,1041,-96,184,88
m47815,m,"Spondylosis without myelopathy or radiculopathy, thoracolumbar region",Diseases of the musculoskeletal system and connective tissue,36,45,34,0.25,-0.244444444,-0.055555556,2249,1915,2272,-334,357,23
m47816,m,"Spondylosis without myelopathy or radiculopathy, lumbar region",Diseases of the musculoskeletal system and connective tissue,884,876,793,-0.009049774,-0.094748858,-0.102941176,335,320,362,-15,42,27
m47817,m,"Spondylosis without myelopathy or radiculopathy, lumbosacral region",Diseases of the musculoskeletal system and connective tissue,120,101,108,-0.158333333,0.069306931,-0.1,1175,1227,1224,52,-3,49
m47819,m,"Spondylosis without myelopathy or radiculopathy, site unspecified",Diseases of the musculoskeletal system and connective tissue,55,39,66,-0.290909091,0.692307692,0.2,1834,2070,1599,236,-471,-235
m47892,m,"Other spondylosis, cervical region",Diseases of the musculoskeletal system and connective tissue,121,65,64,-0.462809917,-0.015384615,-0.47107438,1167,1585,1627,418,42,460
m47896,m,"Other spondylosis, lumbar region",Diseases of the musculoskeletal system and connective tissue,177,108,84,-0.389830508,-0.222222222,-0.525423729,929,1182,1401,253,219,472
m47897,m,"Other spondylosis, lumbosacral region",Diseases of the musculoskeletal system and connective tissue,22,26,27,0.181818182,0.038461538,0.227272727,2829,2533,2541,-296,8,-288
m479,m,"Spondylosis, unspecified",Diseases of the musculoskeletal system and connective tissue,475,396,328,-0.166315789,-0.171717172,-0.309473684,515,554,644,39,90,129
m4800,m,"Spinal stenosis, site unspecified",Diseases of the musculoskeletal system and connective tissue,852,719,708,-0.156103286,-0.015299026,-0.169014085,347,378,398,31,20,51
m4802,m,"Spinal stenosis, cervical region",Diseases of the musculoskeletal system and connective tissue,2396,2215,2216,-0.075542571,0.000451467,-0.075125209,153,154,164,1,10,11
m4803,m,"Spinal stenosis, cervicothoracic region",Diseases of the musculoskeletal system and connective tissue,40,42,51,0.05,0.214285714,0.275,2135,1983,1843,-152,-140,-292
m4804,m,"Spinal stenosis, thoracic region",Diseases of the musculoskeletal system and connective tissue,375,351,369,-0.064,0.051282051,-0.016,589,587,596,-2,9,7
m4805,m,"Spinal stenosis, thoracolumbar region",Diseases of the musculoskeletal system and connective tissue,71,49,52,-0.309859155,0.06122449,-0.267605634,1584,1819,1819,235,0,235
m48061,m,"Spinal stenosis, lumbar region without neurogenic claudication",Diseases of the musculoskeletal system and connective tissue,3511,3102,3124,-0.116491028,0.007092199,-0.110225007,112,123,125,11,2,13
m48062,m,"Spinal stenosis, lumbar region with neurogenic claudication",Diseases of the musculoskeletal system and connective tissue,1403,1210,1283,-0.137562366,0.060330579,-0.085531005,242,256,259,14,3,17
m4807,m,"Spinal stenosis, lumbosacral region",Diseases of the musculoskeletal system and connective tissue,691,631,751,-0.08683068,0.190174326,0.08683068,407,413,373,6,-40,-34
m4810,m,"Ankylosing hyperostosis [Forestier], site unspecified",Diseases of the musculoskeletal system and connective tissue,29,25,14,-0.137931034,-0.44,-0.517241379,2497,2564,3260,67,696,763
m4850xa,m,"Collapsed vertebra, not elsewhere classified, site unspecified, initial encounter for fracture",Diseases of the musculoskeletal system and connective tissue,52,45,38,-0.134615385,-0.155555556,-0.269230769,1867,1903,2139,36,236,272
m4852xa,m,"Collapsed vertebra, not elsewhere classified, cervical region, initial encounter for fracture",Diseases of the musculoskeletal system and connective tissue,19,27,19,0.421052632,-0.296296296,0,2999,2469,2921,-530,452,-78
m4854xa,m,"Collapsed vertebra, not elsewhere classified, thoracic region, initial encounter for fracture",Diseases of the musculoskeletal system and connective tissue,564,563,584,-0.00177305,0.037300178,0.035460993,452,435,440,-17,5,-12
m4854xd,m,"Collapsed vertebra, not elsewhere classified, thoracic region, subsequent encounter for fracture with routine healing",Diseases of the musculoskeletal system and connective tissue,98,90,73,-0.081632653,-0.188888889,-0.255102041,1314,1305,1506,-9,201,192
m4855xa,m,"Collapsed vertebra, not elsewhere classified, thoracolumbar region, initial encounter for fracture",Diseases of the musculoskeletal system and connective tissue,35,31,33,-0.114285714,0.064516129,-0.057142857,2265,2292,2295,27,3,30
m4856xa,m,"Collapsed vertebra, not elsewhere classified, lumbar region, initial encounter for fracture",Diseases of the musculoskeletal system and connective tissue,554,514,515,-0.072202166,0.001945525,-0.070397112,458,465,481,7,16,23
m4856xd,m,"Collapsed vertebra, not elsewhere classified, lumbar region, subsequent encounter for fracture with routine healing",Diseases of the musculoskeletal system and connective tissue,78,88,75,0.128205128,-0.147727273,-0.038461538,1493,1321,1480,-172,159,-13
m488x2,m,"Other specified spondylopathies, cervical region",Diseases of the musculoskeletal system and connective tissue,17,16,13,-0.058823529,-0.1875,-0.235294118,3127,3125,3333,-2,208,206
m5000,m,"Cervical disc disorder with myelopathy, unspecified cervical region",Diseases of the musculoskeletal system and connective tissue,70,53,36,-0.242857143,-0.320754717,-0.485714286,1588,1742,2175,154,433,587
m5001,m,"Cervical disc disorder with myelopathy, high cervical region",Diseases of the musculoskeletal system and connective tissue,133,136,120,0.022556391,-0.117647059,-0.097744361,1086,1030,1131,-56,101,45
m50021,m,Cervical disc disorder at C4-C5 level with myelopathy,Diseases of the musculoskeletal system and connective tissue,89,93,52,0.04494382,-0.440860215,-0.415730337,1379,1283,1811,-96,528,432
m50022,m,Cervical disc disorder at C5-C6 level with myelopathy,Diseases of the musculoskeletal system and connective tissue,64,78,63,0.21875,-0.192307692,-0.015625,1679,1405,1633,-274,228,-46
m50023,m,Cervical disc disorder at C6-C7 level with myelopathy,Diseases of the musculoskeletal system and connective tissue,50,49,40,-0.02,-0.183673469,-0.2,1901,1808,2082,-93,274,181
m5010,m,"Cervical disc disorder with radiculopathy, unspecified cervical region",Diseases of the musculoskeletal system and connective tissue,43,32,44,-0.255813953,0.375,0.023255814,2051,2249,1983,198,-266,-68
m5011,m,"Cervical disc disorder with radiculopathy, high cervical region",Diseases of the musculoskeletal system and connective tissue,68,60,72,-0.117647059,0.2,0.058823529,1609,1639,1512,30,-127,-97
m50121,m,Cervical disc disorder at C4-C5 level with radiculopathy,Diseases of the musculoskeletal system and connective tissue,79,61,66,-0.227848101,0.081967213,-0.164556962,1483,1626,1585,143,-41,102
m50122,m,Cervical disc disorder at C5-C6 level with radiculopathy,Diseases of the musculoskeletal system and connective tissue,102,78,78,-0.235294118,0,-0.235294118,1281,1405,1453,124,48,172
m50123,m,Cervical disc disorder at C6-C7 level with radiculopathy,Diseases of the musculoskeletal system and connective tissue,91,43,46,-0.527472527,0.069767442,-0.494505495,1361,1938,1932,577,-6,571
m5013,m,"Cervical disc disorder with radiculopathy, cervicothoracic region",Diseases of the musculoskeletal system and connective tissue,16,11,15,-0.3125,0.363636364,-0.0625,3181,3468,3173,287,-295,-8
m5020,m,"Other cervical disc displacement, unspecified cervical region",Diseases of the musculoskeletal system and connective tissue,52,49,41,-0.057692308,-0.163265306,-0.211538462,1855,1805,2053,-50,248,198
m5021,m,"Other cervical disc displacement, high cervical region",Diseases of the musculoskeletal system and connective tissue,22,28,50,0.272727273,0.785714286,1.272727273,2802,2410,1846,-392,-564,-956
m50221,m,Other cervical disc displacement at C4-C5 level,Diseases of the musculoskeletal system and connective tissue,31,22,30,-0.290322581,0.363636364,-0.032258065,2389,2711,2397,322,-314,8
m50222,m,Other cervical disc displacement at C5-C6 level,Diseases of the musculoskeletal system and connective tissue,43,34,64,-0.209302326,0.882352941,0.488372093,2046,2165,1611,119,-554,-435
m50223,m,Other cervical disc displacement at C6-C7 level,Diseases of the musculoskeletal system and connective tissue,27,29,34,0.074074074,0.172413793,0.259259259,2567,2358,2240,-209,-118,-327
m5030,m,"Other cervical disc degeneration, unspecified cervical region",Diseases of the musculoskeletal system and connective tissue,325,280,268,-0.138461538,-0.042857143,-0.175384615,641,678,720,37,42,79
m5031,m,"Other cervical disc degeneration, high cervical region",Diseases of the musculoskeletal system and connective tissue,35,23,31,-0.342857143,0.347826087,-0.114285714,2250,2649,2357,399,-292,107
m50321,m,Other cervical disc degeneration at C4-C5 level,Diseases of the musculoskeletal system and connective tissue,28,29,30,0.035714286,0.034482759,0.071428571,2517,2357,2393,-160,36,-124
m50322,m,Other cervical disc degeneration at C5-C6 level,Diseases of the musculoskeletal system and connective tissue,40,25,54,-0.375,1.16,0.35,2112,2541,1770,429,-771,-342
m50323,m,Other cervical disc degeneration at C6-C7 level,Diseases of the musculoskeletal system and connective tissue,19,19,23,0,0.210526316,0.210526316,2975,2895,2692,-80,-203,-283
m5090,m,"Cervical disc disorder, unspecified, unspecified cervical region",Diseases of the musculoskeletal system and connective tissue,37,24,20,-0.351351351,-0.166666667,-0.459459459,2188,2594,2839,406,245,651
m5104,m,"Intervertebral disc disorders with myelopathy, thoracic region",Diseases of the musculoskeletal system and connective tissue,45,37,33,-0.177777778,-0.108108108,-0.266666667,2000,2095,2277,95,182,277
m5106,m,"Intervertebral disc disorders with myelopathy, lumbar region",Diseases of the musculoskeletal system and connective tissue,62,44,46,-0.290322581,0.045454545,-0.258064516,1701,1918,1928,217,10,227
m5114,m,"Intervertebral disc disorders with radiculopathy, thoracic region",Diseases of the musculoskeletal system and connective tissue,21,17,34,-0.19047619,1,0.619047619,2848,3030,2237,182,-793,-611
m5116,m,"Intervertebral disc disorders with radiculopathy, lumbar region",Diseases of the musculoskeletal system and connective tissue,1363,1114,1122,-0.182685253,0.007181329,-0.176815847,244,267,281,23,14,37
m5117,m,"Intervertebral disc disorders with radiculopathy, lumbosacral region",Diseases of the musculoskeletal system and connective tissue,420,381,408,-0.092857143,0.070866142,-0.028571429,540,556,556,16,0,16
m5124,m,"Other intervertebral disc displacement, thoracic region",Diseases of the musculoskeletal system and connective tissue,67,46,50,-0.313432836,0.086956522,-0.253731343,1622,1868,1841,246,-27,219
m5125,m,"Other intervertebral disc displacement, thoracolumbar region",Diseases of the musculoskeletal system and connective tissue,10,12,10,0.2,-0.166666667,0,3541,3379,3512,-162,133,-29
m5126,m,"Other intervertebral disc displacement, lumbar region",Diseases of the musculoskeletal system and connective tissue,459,395,423,-0.139433551,0.070886076,-0.078431373,518,546,543,28,-3,25
m5127,m,"Other intervertebral disc displacement, lumbosacral region",Diseases of the musculoskeletal system and connective tissue,119,126,140,0.058823529,0.111111111,0.176470588,1170,1078,1011,-92,-67,-159
m5134,m,"Other intervertebral disc degeneration, thoracic region",Diseases of the musculoskeletal system and connective tissue,91,96,78,0.054945055,-0.1875,-0.142857143,1356,1253,1448,-103,195,92
m5135,m,"Other intervertebral disc degeneration, thoracolumbar region",Diseases of the musculoskeletal system and connective tissue,48,47,60,-0.020833333,0.276595745,0.25,1926,1844,1659,-82,-185,-267
m5136,m,"Other intervertebral disc degeneration, lumbar region",Diseases of the musculoskeletal system and connective tissue,1276,977,1140,-0.234326019,0.166837257,-0.106583072,257,299,276,42,-23,19
m5137,m,"Other intervertebral disc degeneration, lumbosacral region",Diseases of the musculoskeletal system and connective tissue,317,272,300,-0.141955836,0.102941176,-0.05362776,650,687,666,37,-21,16
m5186,m,"Other intervertebral disc disorders, lumbar region",Diseases of the musculoskeletal system and connective tissue,18,17,17,-0.055555556,0,-0.055555556,3033,3021,3013,-12,-8,-20
m519,m,"Unspecified thoracic, thoracolumbar and lumbosacral intervertebral disc disorder",Diseases of the musculoskeletal system and connective tissue,97,87,80,-0.103092784,-0.08045977,-0.175257732,1309,1323,1420,14,97,111
m532x2,m,"Spinal instabilities, cervical region",Diseases of the musculoskeletal system and connective tissue,62,56,72,-0.096774194,0.285714286,0.161290323,1692,1685,1502,-7,-183,-190
m532x6,m,"Spinal instabilities, lumbar region",Diseases of the musculoskeletal system and connective tissue,113,95,108,-0.159292035,0.136842105,-0.044247788,1208,1256,1207,48,-49,-1
m532x7,m,"Spinal instabilities, lumbosacral region",Diseases of the musculoskeletal system and connective tissue,25,22,17,-0.12,-0.227272727,-0.32,2635,2690,3010,55,320,375
m533,m,"Sacrococcygeal disorders, not elsewhere classified",Diseases of the musculoskeletal system and connective tissue,145,122,115,-0.15862069,-0.057377049,-0.206896552,1029,1093,1162,64,69,133
m5382,m,"Other specified dorsopathies, cervical region",Diseases of the musculoskeletal system and connective tissue,21,18,16,-0.142857143,-0.111111111,-0.238095238,2834,2935,3071,101,136,237
m5410,m,"Radiculopathy, site unspecified",Diseases of the musculoskeletal system and connective tissue,234,222,242,-0.051282051,0.09009009,0.034188034,792,785,760,-7,-25,-32
m5412,m,"Radiculopathy, cervical region",Diseases of the musculoskeletal system and connective tissue,530,472,470,-0.109433962,-0.004237288,-0.113207547,477,490,505,13,15,28
m5414,m,"Radiculopathy, thoracic region",Diseases of the musculoskeletal system and connective tissue,32,31,33,-0.03125,0.064516129,0.03125,2335,2260,2260,-75,0,-75
m5416,m,"Radiculopathy, lumbar region",Diseases of the musculoskeletal system and connective tissue,1429,1152,1333,-0.193841847,0.157118056,-0.067179846,237,261,247,24,-14,10
m5417,m,"Radiculopathy, lumbosacral region",Diseases of the musculoskeletal system and connective tissue,207,198,195,-0.043478261,-0.015151515,-0.057971014,849,832,856,-17,24,7
m5418,m,"Radiculopathy, sacral and sacrococcygeal region",Diseases of the musculoskeletal system and connective tissue,21,26,18,0.238095238,-0.307692308,-0.142857143,2829,2481,2938,-348,457,109
m542,m,Cervicalgia,Diseases of the musculoskeletal system and connective tissue,2015,1760,1718,-0.126550868,-0.023863636,-0.147394541,174,194,204,20,10,30
m5430,m,"Sciatica, unspecified side",Diseases of the musculoskeletal system and connective tissue,598,489,451,-0.182274247,-0.077709611,-0.245819398,427,476,515,49,39,88
m5431,m,"Sciatica, right side",Diseases of the musculoskeletal system and connective tissue,148,144,122,-0.027027027,-0.152777778,-0.175675676,1015,982,1104,-33,122,89
m5432,m,"Sciatica, left side",Diseases of the musculoskeletal system and connective tissue,139,127,125,-0.086330935,-0.015748031,-0.100719424,1049,1060,1089,11,29,40
m5440,m,"Lumbago with sciatica, unspecified side",Diseases of the musculoskeletal system and connective tissue,152,124,140,-0.184210526,0.129032258,-0.078947368,996,1073,1003,77,-70,7
m5441,m,"Lumbago with sciatica, right side",Diseases of the musculoskeletal system and connective tissue,108,105,101,-0.027777778,-0.038095238,-0.064814815,1223,1171,1241,-52,70,18
m5442,m,"Lumbago with sciatica, left side",Diseases of the musculoskeletal system and connective tissue,108,101,113,-0.064814815,0.118811881,0.046296296,1223,1198,1167,-25,-31,-56
m545,m,Low back pain,Diseases of the musculoskeletal system and connective tissue,5880,5117,5407,-0.129761905,0.056673832,-0.080442177,66,75,75,9,0,9
m546,m,Pain in thoracic spine,Diseases of the musculoskeletal system and connective tissue,246,216,258,-0.12195122,0.194444444,0.048780488,761,792,726,31,-66,-35
m5481,m,Occipital neuralgia,Diseases of the musculoskeletal system and connective tissue,113,126,115,0.115044248,-0.087301587,0.017699115,1196,1066,1151,-130,85,-45
m5489,m,Other dorsalgia,Diseases of the musculoskeletal system and connective tissue,114,152,139,0.333333333,-0.085526316,0.219298246,1190,952,1007,-238,55,-183
m549,m,"Dorsalgia, unspecified",Diseases of the musculoskeletal system and connective tissue,9249,7934,8442,-0.142177533,0.064028233,-0.087252676,36,43,42,7,-1,6
m60009,m,"Infective myositis, unspecified site",Diseases of the musculoskeletal system and connective tissue,39,43,26,0.102564103,-0.395348837,-0.333333333,2111,1906,2514,-205,608,403
m60052,m,"Infective myositis, left thigh",Diseases of the musculoskeletal system and connective tissue,20,14,17,-0.3,0.214285714,-0.15,2875,3199,2990,324,-209,115
m60061,m,"Infective myositis, right lower leg",Diseases of the musculoskeletal system and connective tissue,14,18,10,0.285714286,-0.444444444,-0.285714286,3264,2916,3479,-348,563,215
m6008,m,"Infective myositis, other site",Diseases of the musculoskeletal system and connective tissue,91,74,82,-0.186813187,0.108108108,-0.098901099,1335,1422,1381,87,-41,46
m6088,m,"Other myositis, other site",Diseases of the musculoskeletal system and connective tissue,28,23,18,-0.178571429,-0.217391304,-0.357142857,2481,2611,2924,130,313,443
m609,m,"Myositis, unspecified",Diseases of the musculoskeletal system and connective tissue,329,282,269,-0.142857143,-0.046099291,-0.182370821,625,665,707,40,42,82
m6208,m,"Separation of muscle (nontraumatic), other site",Diseases of the musculoskeletal system and connective tissue,36,21,29,-0.416666667,0.380952381,-0.194444444,2181,2731,2382,550,-349,201
m6250,m,"Muscle wasting and atrophy, not elsewhere classified, unspecified site",Diseases of the musculoskeletal system and connective tissue,162,102,102,-0.37037037,0,-0.37037037,948,1182,1224,234,42,276
m62561,m,"Muscle wasting and atrophy, not elsewhere classified, right lower leg",Diseases of the musculoskeletal system and connective tissue,21,12,14,-0.428571429,0.166666667,-0.333333333,2811,3340,3187,529,-153,376
m62562,m,"Muscle wasting and atrophy, not elsewhere classified, left lower leg",Diseases of the musculoskeletal system and connective tissue,22,10,13,-0.545454545,0.3,-0.409090909,2755,3482,3266,727,-216,511
m6258,m,"Muscle wasting and atrophy, not elsewhere classified, other site",Diseases of the musculoskeletal system and connective tissue,14,18,12,0.285714286,-0.333333333,-0.142857143,3257,2911,3336,-346,425,79
m6281,m,Muscle weakness (generalized),Diseases of the musculoskeletal system and connective tissue,1172,1150,1090,-0.018771331,-0.052173913,-0.06996587,264,258,281,-6,23,17
m6282,m,Rhabdomyolysis,Diseases of the musculoskeletal system and connective tissue,3537,3282,4110,-0.072094996,0.252285192,0.162001696,108,116,103,8,-13,-5
m62830,m,Muscle spasm of back,Diseases of the musculoskeletal system and connective tissue,238,296,272,0.243697479,-0.081081081,0.142857143,772,642,700,-130,58,-72
m62831,m,Muscle spasm of calf,Diseases of the musculoskeletal system and connective tissue,18,12,10,-0.333333333,-0.166666667,-0.444444444,2997,3336,3468,339,132,471
m62838,m,Other muscle spasm,Diseases of the musculoskeletal system and connective tissue,1027,948,920,-0.076923077,-0.029535865,-0.104186952,290,298,315,8,17,25
m6284,m,Sarcopenia,Diseases of the musculoskeletal system and connective tissue,83,93,79,0.120481928,-0.150537634,-0.048192771,1405,1251,1410,-154,159,5
m6289,m,Other specified disorders of muscle,Diseases of the musculoskeletal system and connective tissue,38,43,37,0.131578947,-0.139534884,-0.026315789,2128,1898,2103,-230,205,-25
m65141,m,"Other infective (teno)synovitis, right hand",Diseases of the musculoskeletal system and connective tissue,45,32,37,-0.288888889,0.15625,-0.177777778,1962,2201,2103,239,-98,141
m65142,m,"Other infective (teno)synovitis, left hand",Diseases of the musculoskeletal system and connective tissue,29,25,36,-0.137931034,0.44,0.24137931,2430,2497,2121,67,-376,-309
m6530,m,"Trigger finger, unspecified finger",Diseases of the musculoskeletal system and connective tissue,11,14,10,0.272727273,-0.285714286,-0.090909091,3432,3184,3463,-248,279,31
m65811,m,"Other synovitis and tenosynovitis, right shoulder",Diseases of the musculoskeletal system and connective tissue,27,21,22,-0.222222222,0.047619048,-0.185185185,2516,2722,2693,206,-29,177
m65812,m,"Other synovitis and tenosynovitis, left shoulder",Diseases of the musculoskeletal system and connective tissue,15,19,28,0.266666667,0.473684211,0.866666667,3186,2845,2422,-341,-423,-764
m65841,m,"Other synovitis and tenosynovitis, right hand",Diseases of the musculoskeletal system and connective tissue,46,58,52,0.260869565,-0.103448276,0.130434783,1935,1630,1768,-305,138,-167
m65842,m,"Other synovitis and tenosynovitis, left hand",Diseases of the musculoskeletal system and connective tissue,42,37,42,-0.119047619,0.135135135,0,2021,2054,1983,33,-71,-38
m65861,m,"Other synovitis and tenosynovitis, right lower leg",Diseases of the musculoskeletal system and connective tissue,38,34,24,-0.105263158,-0.294117647,-0.368421053,2125,2121,2603,-4,482,478
m65862,m,"Other synovitis and tenosynovitis, left lower leg",Diseases of the musculoskeletal system and connective tissue,42,20,28,-0.523809524,0.4,-0.333333333,2021,2780,2420,759,-360,399
m65871,m,"Other synovitis and tenosynovitis, right ankle and foot",Diseases of the musculoskeletal system and connective tissue,37,30,33,-0.189189189,0.1,-0.108108108,2142,2271,2233,129,-38,91
m65872,m,"Other synovitis and tenosynovitis, left ankle and foot",Diseases of the musculoskeletal system and connective tissue,29,30,29,0.034482759,-0.033333333,0,2425,2271,2370,-154,99,-55
m6588,m,"Other synovitis and tenosynovitis, other site",Diseases of the musculoskeletal system and connective tissue,19,20,17,0.052631579,-0.15,-0.105263158,2914,2778,2969,-136,191,55
m659,m,"Synovitis and tenosynovitis, unspecified",Diseases of the musculoskeletal system and connective tissue,371,336,310,-0.094339623,-0.077380952,-0.164420485,575,586,641,11,55,66
m7021,m,"Olecranon bursitis, right elbow",Diseases of the musculoskeletal system and connective tissue,52,31,34,-0.403846154,0.096774194,-0.346153846,1816,2231,2194,415,-37,378
m7022,m,"Olecranon bursitis, left elbow",Diseases of the musculoskeletal system and connective tissue,52,36,25,-0.307692308,-0.305555556,-0.519230769,1816,2076,2541,260,465,725
m7041,m,"Prepatellar bursitis, right knee",Diseases of the musculoskeletal system and connective tissue,30,27,27,-0.1,0,-0.1,2376,2397,2454,21,57,78
m7042,m,"Prepatellar bursitis, left knee",Diseases of the musculoskeletal system and connective tissue,34,28,23,-0.176470588,-0.178571429,-0.323529412,2225,2355,2635,130,280,410
m7061,m,"Trochanteric bursitis, right hip",Diseases of the musculoskeletal system and connective tissue,56,43,40,-0.232142857,-0.069767442,-0.285714286,1754,1896,2031,142,135,277
m7062,m,"Trochanteric bursitis, left hip",Diseases of the musculoskeletal system and connective tissue,56,55,38,-0.017857143,-0.309090909,-0.321428571,1754,1666,2079,-88,413,325
m7071,m,"Other bursitis of hip, right hip",Diseases of the musculoskeletal system and connective tissue,17,12,12,-0.294117647,0,-0.294117647,3036,3314,3312,278,-2,276
m7072,m,"Other bursitis of hip, left hip",Diseases of the musculoskeletal system and connective tissue,13,13,13,0,0,0,3301,3231,3242,-70,11,-59
m71121,m,"Other infective bursitis, right elbow",Diseases of the musculoskeletal system and connective tissue,35,29,19,-0.171428571,-0.344827586,-0.457142857,2195,2304,2834,109,530,639
m71122,m,"Other infective bursitis, left elbow",Diseases of the musculoskeletal system and connective tissue,38,34,32,-0.105263158,-0.058823529,-0.157894737,2119,2117,2265,-2,148,146
m71161,m,"Other infective bursitis, right knee",Diseases of the musculoskeletal system and connective tissue,27,25,14,-0.074074074,-0.44,-0.481481481,2501,2483,3161,-18,678,660
m71162,m,"Other infective bursitis, left knee",Diseases of the musculoskeletal system and connective tissue,29,15,12,-0.482758621,-0.2,-0.586206897,2416,3085,3308,669,223,892
m7120,m,"Synovial cyst of popliteal space [Baker], unspecified knee",Diseases of the musculoskeletal system and connective tissue,51,60,41,0.176470588,-0.316666667,-0.196078431,1834,1601,2008,-233,407,174
m7121,m,"Synovial cyst of popliteal space [Baker], right knee",Diseases of the musculoskeletal system and connective tissue,73,62,63,-0.150684932,0.016129032,-0.136986301,1514,1577,1592,63,15,78
m7122,m,"Synovial cyst of popliteal space [Baker], left knee",Diseases of the musculoskeletal system and connective tissue,48,54,63,0.125,0.166666667,0.3125,1889,1678,1592,-211,-86,-297
m7138,m,"Other bursal cyst, other site",Diseases of the musculoskeletal system and connective tissue,216,152,137,-0.296296296,-0.098684211,-0.365740741,820,945,1015,125,70,195
m719,m,"Bursopathy, unspecified",Diseases of the musculoskeletal system and connective tissue,19,15,14,-0.210526316,-0.066666667,-0.263157895,2899,3081,3157,182,76,258
m720,m,Palmar fascial fibromatosis [Dupuytren],Diseases of the musculoskeletal system and connective tissue,34,21,33,-0.382352941,0.571428571,-0.029411765,2217,2703,2225,486,-478,8
m722,m,Plantar fascial fibromatosis,Diseases of the musculoskeletal system and connective tissue,101,98,91,-0.02970297,-0.071428571,-0.099009901,1255,1206,1311,-49,105,56
m726,m,Necrotizing fasciitis,Diseases of the musculoskeletal system and connective tissue,435,452,512,0.03908046,0.132743363,0.177011494,519,502,475,-17,-27,-44
m728,m,Other fibroblastic disorders,Diseases of the musculoskeletal system and connective tissue,13,20,33,0.538461538,0.65,1.538461538,3289,2761,2223,-528,-538,-1066
m729,m,"Fibroblastic disorder, unspecified",Diseases of the musculoskeletal system and connective tissue,45,44,41,-0.022222222,-0.068181818,-0.088888889,1950,1872,2003,-78,131,53
m7501,m,Adhesive capsulitis of right shoulder,Diseases of the musculoskeletal system and connective tissue,37,30,24,-0.189189189,-0.2,-0.351351351,2129,2258,2584,129,326,455
m7502,m,Adhesive capsulitis of left shoulder,Diseases of the musculoskeletal system and connective tissue,28,33,27,0.178571429,-0.181818182,-0.035714286,2445,2150,2442,-295,292,-3
m75100,m,"Unspecified rotator cuff tear or rupture of unspecified shoulder, not specified as traumatic",Diseases of the musculoskeletal system and connective tissue,54,52,31,-0.037037037,-0.403846154,-0.425925926,1781,1708,2295,-73,587,514
m75101,m,"Unspecified rotator cuff tear or rupture of right shoulder, not specified as traumatic",Diseases of the musculoskeletal system and connective tissue,313,234,282,-0.252396166,0.205128205,-0.099041534,648,737,681,89,-56,33
m75102,m,"Unspecified rotator cuff tear or rupture of left shoulder, not specified as traumatic",Diseases of the musculoskeletal system and connective tissue,222,193,206,-0.130630631,0.067357513,-0.072072072,799,831,817,32,-14,18
m75111,m,"Incomplete rotator cuff tear or rupture of right shoulder, not specified as traumatic",Diseases of the musculoskeletal system and connective tissue,45,25,35,-0.444444444,0.4,-0.222222222,1947,2471,2147,524,-324,200
m75112,m,"Incomplete rotator cuff tear or rupture of left shoulder, not specified as traumatic",Diseases of the musculoskeletal system and connective tissue,29,29,34,0,0.172413793,0.172413793,2403,2291,2182,-112,-109,-221
m75120,m,"Complete rotator cuff tear or rupture of unspecified shoulder, not specified as traumatic",Diseases of the musculoskeletal system and connective tissue,10,11,11,0.1,0,0.1,3450,3360,3365,-90,5,-85
m75121,m,"Complete rotator cuff tear or rupture of right shoulder, not specified as traumatic",Diseases of the musculoskeletal system and connective tissue,120,124,158,0.033333333,0.274193548,0.316666667,1133,1058,932,-75,-126,-201
m75122,m,"Complete rotator cuff tear or rupture of left shoulder, not specified as traumatic",Diseases of the musculoskeletal system and connective tissue,76,80,86,0.052631579,0.075,0.131578947,1463,1353,1333,-110,-20,-130
m7520,m,"Bicipital tendinitis, unspecified shoulder",Diseases of the musculoskeletal system and connective tissue,35,21,12,-0.4,-0.428571429,-0.657142857,2180,2691,3289,511,598,1109
m7521,m,"Bicipital tendinitis, right shoulder",Diseases of the musculoskeletal system and connective tissue,103,93,82,-0.097087379,-0.11827957,-0.203883495,1234,1244,1367,10,123,133
m7522,m,"Bicipital tendinitis, left shoulder",Diseases of the musculoskeletal system and connective tissue,86,52,56,-0.395348837,0.076923077,-0.348837209,1362,1703,1679,341,-24,317
m7531,m,Calcific tendinitis of right shoulder,Diseases of the musculoskeletal system and connective tissue,18,12,13,-0.333333333,0.083333333,-0.277777778,2952,3287,3218,335,-69,266
m7541,m,Impingement syndrome of right shoulder,Diseases of the musculoskeletal system and connective tissue,21,33,27,0.571428571,-0.181818182,0.285714286,2764,2143,2433,-621,290,-331
m7542,m,Impingement syndrome of left shoulder,Diseases of the musculoskeletal system and connective tissue,21,20,22,-0.047619048,0.1,0.047619048,2764,2747,2657,-17,-90,-107
m7551,m,Bursitis of right shoulder,Diseases of the musculoskeletal system and connective tissue,31,21,34,-0.322580645,0.619047619,0.096774194,2309,2688,2178,379,-510,-131
m7552,m,Bursitis of left shoulder,Diseases of the musculoskeletal system and connective tissue,16,27,18,0.6875,-0.333333333,0.125,3070,2374,2873,-696,499,-197
m7662,m,"Achilles tendinitis, left leg",Diseases of the musculoskeletal system and connective tissue,10,10,14,0,0.4,0.4,3440,3421,3137,-19,-284,-303
m7730,m,"Calcaneal spur, unspecified foot",Diseases of the musculoskeletal system and connective tissue,49,45,17,-0.081632653,-0.622222222,-0.653061224,1859,1836,2936,-23,1100,1077
m7732,m,"Calcaneal spur, left foot",Diseases of the musculoskeletal system and connective tissue,22,17,13,-0.227272727,-0.235294118,-0.409090909,2707,2936,3212,229,276,505
m778,m,"Other enthesopathies, not elsewhere classified",Diseases of the musculoskeletal system and connective tissue,10,14,22,0.4,0.571428571,1.2,3438,3136,2656,-302,-480,-782
m779,m,"Enthesopathy, unspecified",Diseases of the musculoskeletal system and connective tissue,61,85,57,0.393442623,-0.329411765,-0.06557377,1667,1303,1662,-364,359,-5
m7910,m,"Myalgia, unspecified site",Diseases of the musculoskeletal system and connective tissue,464,527,781,0.135775862,0.481973435,0.683189655,504,447,353,-57,-94,-151
m7918,m,"Myalgia, other site",Diseases of the musculoskeletal system and connective tissue,129,136,138,0.054263566,0.014705882,0.069767442,1073,1002,1002,-71,0,-71
m792,m,"Neuralgia and neuritis, unspecified",Diseases of the musculoskeletal system and connective tissue,190,180,233,-0.052631579,0.294444444,0.226315789,862,852,762,-10,-90,-100
m793,m,"Panniculitis, unspecified",Diseases of the musculoskeletal system and connective tissue,139,145,125,0.043165468,-0.137931034,-0.100719424,1032,960,1070,-72,110,38
m795,m,Residual foreign body in soft tissue,Diseases of the musculoskeletal system and connective tissue,61,49,66,-0.196721311,0.346938776,0.081967213,1663,1748,1535,85,-213,-128
m79601,m,Pain in right arm,Diseases of the musculoskeletal system and connective tissue,211,139,173,-0.341232227,0.244604317,-0.180094787,825,986,894,161,-92,69
m79602,m,Pain in left arm,Diseases of the musculoskeletal system and connective tissue,227,206,198,-0.092511013,-0.038834951,-0.127753304,792,800,835,8,35,43
m79603,m,"Pain in arm, unspecified",Diseases of the musculoskeletal system and connective tissue,24,22,30,-0.083333333,0.363636364,0.25,2597,2614,2313,17,-301,-284
m79604,m,Pain in right leg,Diseases of the musculoskeletal system and connective tissue,671,568,576,-0.153502235,0.014084507,-0.141579732,400,425,435,25,10,35
m79605,m,Pain in left leg,Diseases of the musculoskeletal system and connective tissue,647,575,574,-0.111282844,-0.00173913,-0.112828439,409,421,436,12,15,27
m79606,m,"Pain in leg, unspecified",Diseases of the musculoskeletal system and connective tissue,182,170,197,-0.065934066,0.158823529,0.082417582,872,871,834,-1,-37,-38
m79621,m,Pain in right upper arm,Diseases of the musculoskeletal system and connective tissue,47,29,30,-0.382978723,0.034482759,-0.361702128,1883,2274,2310,391,36,427
m79622,m,Pain in left upper arm,Diseases of the musculoskeletal system and connective tissue,45,39,45,-0.133333333,0.153846154,0,1930,1973,1887,43,-86,-43
m79631,m,Pain in right forearm,Diseases of the musculoskeletal system and connective tissue,31,30,33,-0.032258065,0.1,0.064516129,2295,2236,2201,-59,-35,-94
m79632,m,Pain in left forearm,Diseases of the musculoskeletal system and connective tissue,27,38,22,0.407407407,-0.421052632,-0.185185185,2464,1998,2641,-466,643,177
m79641,m,Pain in right hand,Diseases of the musculoskeletal system and connective tissue,206,225,207,0.09223301,-0.08,0.004854369,831,759,811,-72,52,-20
m79642,m,Pain in left hand,Diseases of the musculoskeletal system and connective tissue,146,145,138,-0.006849315,-0.048275862,-0.054794521,995,955,995,-40,40,0
m79643,m,Pain in unspecified hand,Diseases of the musculoskeletal system and connective tissue,24,17,18,-0.291666667,0.058823529,-0.25,2588,2918,2854,330,-64,266
m79644,m,Pain in right finger(s),Diseases of the musculoskeletal system and connective tissue,41,46,50,0.12195122,0.086956522,0.219512195,2010,1805,1781,-205,-24,-229
m79645,m,Pain in left finger(s),Diseases of the musculoskeletal system and connective tissue,46,32,31,-0.304347826,-0.03125,-0.326086957,1902,2160,2270,258,110,368
m79651,m,Pain in right thigh,Diseases of the musculoskeletal system and connective tissue,98,104,95,0.06122449,-0.086538462,-0.030612245,1261,1152,1263,-109,111,2
m79652,m,Pain in left thigh,Diseases of the musculoskeletal system and connective tissue,100,67,68,-0.33,0.014925373,-0.32,1245,1488,1500,243,12,255
m79661,m,Pain in right lower leg,Diseases of the musculoskeletal system and connective tissue,232,210,202,-0.094827586,-0.038095238,-0.129310345,776,789,819,13,30,43
m79662,m,Pain in left lower leg,Diseases of the musculoskeletal system and connective tissue,251,225,198,-0.103585657,-0.12,-0.211155378,741,759,831,18,72,90
m79669,m,Pain in unspecified lower leg,Diseases of the musculoskeletal system and connective tissue,26,30,22,0.153846154,-0.266666667,-0.153846154,2493,2227,2633,-266,406,140
m79671,m,Pain in right foot,Diseases of the musculoskeletal system and connective tissue,392,351,421,-0.104591837,0.199430199,0.073979592,550,565,530,15,-35,-20
m79672,m,Pain in left foot,Diseases of the musculoskeletal system and connective tissue,361,360,335,-0.002770083,-0.069444444,-0.072022161,581,556,607,-25,51,26
m79673,m,Pain in unspecified foot,Diseases of the musculoskeletal system and connective tissue,58,62,67,0.068965517,0.080645161,0.155172414,1702,1551,1505,-151,-46,-197
m79674,m,Pain in right toe(s),Diseases of the musculoskeletal system and connective tissue,75,68,55,-0.093333333,-0.191176471,-0.266666667,1456,1471,1682,15,211,226
m79675,m,Pain in left toe(s),Diseases of the musculoskeletal system and connective tissue,70,54,50,-0.228571429,-0.074074074,-0.285714286,1519,1650,1773,131,123,254
m797,m,Fibromyalgia,Diseases of the musculoskeletal system and connective tissue,6295,5218,5672,-0.171088165,0.087006516,-0.098967434,58,72,70,14,-2,12
m79a11,m,Nontraumatic compartment syndrome of right upper extremity,Diseases of the musculoskeletal system and connective tissue,17,11,14,-0.352941176,0.272727273,-0.176470588,2973,3315,3103,342,-212,130
m79a12,m,Nontraumatic compartment syndrome of left upper extremity,Diseases of the musculoskeletal system and connective tissue,12,12,16,0,0.333333333,0.333333333,3291,3248,2962,-43,-286,-329
m79a21,m,Nontraumatic compartment syndrome of right lower extremity,Diseases of the musculoskeletal system and connective tissue,33,21,30,-0.363636364,0.428571429,-0.090909091,2210,2655,2294,445,-361,84
m79a22,m,Nontraumatic compartment syndrome of left lower extremity,Diseases of the musculoskeletal system and connective tissue,18,26,21,0.444444444,-0.192307692,0.166666667,2914,2394,2668,-520,274,-246
m79a3,m,Nontraumatic compartment syndrome of abdomen,Diseases of the musculoskeletal system and connective tissue,36,31,41,-0.138888889,0.322580645,0.138888889,2118,2183,1972,65,-211,-146
m7981,m,Nontraumatic hematoma of soft tissue,Diseases of the musculoskeletal system and connective tissue,317,308,322,-0.028391167,0.045454545,0.015772871,632,617,617,-15,0,-15
m7989,m,Other specified soft tissue disorders,Diseases of the musculoskeletal system and connective tissue,1039,1094,1045,0.052935515,-0.044789762,0.005774783,284,266,289,-18,23,5
m8000xa,m,"Age-related osteoporosis with current pathological fracture, unspecified site, initial encounter for fracture",Diseases of the musculoskeletal system and connective tissue,86,101,85,0.174418605,-0.158415842,-0.011627907,1342,1162,1327,-180,165,-15
m80051a,m,"Age-related osteoporosis with current pathological fracture, right femur, initial encounter for fracture",Diseases of the musculoskeletal system and connective tissue,76,68,64,-0.105263158,-0.058823529,-0.157894737,1440,1467,1543,27,76,103
m80052a,m,"Age-related osteoporosis with current pathological fracture, left femur, initial encounter for fracture",Diseases of the musculoskeletal system and connective tissue,71,58,75,-0.183098592,0.293103448,0.056338028,1503,1594,1414,91,-180,-89
m8008xa,m,"Age-related osteoporosis with current pathological fracture, vertebra(e), initial encounter for fracture",Diseases of the musculoskeletal system and connective tissue,145,122,115,-0.15862069,-0.057377049,-0.206896552,991,1050,1120,59,70,129
m8008xd,m,"Age-related osteoporosis with current pathological fracture, vertebra(e), subsequent encounter for fracture with routine healing",Diseases of the musculoskeletal system and connective tissue,30,17,11,-0.433333333,-0.352941176,-0.633333333,2315,2896,3308,581,412,993
m80851a,m,"Other osteoporosis with current pathological fracture, right femur, initial encounter for fracture",Diseases of the musculoskeletal system and connective tissue,24,13,32,-0.458333333,1.461538462,0.333333333,2566,3156,2214,590,-942,-352
m80852a,m,"Other osteoporosis with current pathological fracture, left femur, initial encounter for fracture",Diseases of the musculoskeletal system and connective tissue,31,20,26,-0.35483871,0.3,-0.161290323,2273,2704,2431,431,-273,158
m8088xa,m,"Other osteoporosis with current pathological fracture, vertebra(e), initial encounter for fracture",Diseases of the musculoskeletal system and connective tissue,49,46,48,-0.06122449,0.043478261,-0.020408163,1830,1789,1805,-41,16,-25
m8088xd,m,"Other osteoporosis with current pathological fracture, vertebra(e), subsequent encounter for fracture with routine healing",Diseases of the musculoskeletal system and connective tissue,21,16,15,-0.238095238,-0.0625,-0.285714286,2717,2961,3021,244,60,304
m810,m,Age-related osteoporosis without current pathological fracture,Diseases of the musculoskeletal system and connective tissue,7974,6746,6731,-0.154000502,-0.00222354,-0.155881615,43,53,55,10,2,12
m818,m,Other osteoporosis without current pathological fracture,Diseases of the musculoskeletal system and connective tissue,102,101,93,-0.009803922,-0.079207921,-0.088235294,1223,1160,1267,-63,107,44
m8440xa,m,"Pathological fracture, unspecified site, initial encounter for fracture",Diseases of the musculoskeletal system and connective tissue,19,19,13,0,-0.315789474,-0.315789474,2831,2758,3162,-73,404,331
m84421a,m,"Pathological fracture, right humerus, initial encounter for fracture",Diseases of the musculoskeletal system and connective tissue,13,15,22,0.153846154,0.466666667,0.692307692,3219,3010,2614,-209,-396,-605
m84422a,m,"Pathological fracture, left humerus, initial encounter for fracture",Diseases of the musculoskeletal system and connective tissue,12,12,14,0,0.166666667,0.166666667,3273,3230,3086,-43,-144,-187
m84451a,m,"Pathological fracture, right femur, initial encounter for fracture",Diseases of the musculoskeletal system and connective tissue,37,35,39,-0.054054054,0.114285714,0.054054054,2084,2046,2004,-38,-42,-80
m84452a,m,"Pathological fracture, left femur, initial encounter for fracture",Diseases of the musculoskeletal system and connective tissue,36,29,38,-0.194444444,0.310344828,0.055555556,2108,2245,2030,137,-215,-78
m84454a,m,"Pathological fracture, pelvis, initial encounter for fracture",Diseases of the musculoskeletal system and connective tissue,23,38,19,0.652173913,-0.5,-0.173913043,2604,1976,2761,-628,785,157
m84474a,m,"Pathological fracture, right foot, initial encounter for fracture",Diseases of the musculoskeletal system and connective tissue,15,10,14,-0.333333333,0.4,-0.066666667,3086,3362,3083,276,-279,-3
m84477a,m,"Pathological fracture, right toe(s), initial encounter for fracture",Diseases of the musculoskeletal system and connective tissue,12,13,12,0.083333333,-0.076923077,0,3269,3146,3222,-123,76,-47
m8448xa,m,"Pathological fracture, other site, initial encounter for fracture",Diseases of the musculoskeletal system and connective tissue,273,254,260,-0.06959707,0.023622047,-0.047619048,701,690,706,-11,16,5
m8448xd,m,"Pathological fracture, other site, subsequent encounter for fracture with routine healing",Diseases of the musculoskeletal system and connective tissue,59,54,44,-0.084745763,-0.185185185,-0.254237288,1669,1640,1889,-29,249,220
m84550a,m,"Pathological fracture in neoplastic disease, pelvis, initial encounter for fracture",Diseases of the musculoskeletal system and connective tissue,21,24,11,0.142857143,-0.541666667,-0.476190476,2710,2467,3292,-243,825,582
m84551a,m,"Pathological fracture in neoplastic disease, right femur, initial encounter for fracture",Diseases of the musculoskeletal system and connective tissue,22,20,19,-0.090909091,-0.05,-0.136363636,2656,2695,2759,39,64,103
m84552a,m,"Pathological fracture in neoplastic disease, left femur, initial encounter for fracture",Diseases of the musculoskeletal system and connective tissue,19,28,21,0.473684211,-0.25,0.105263158,2824,2287,2651,-537,364,-173
m8458xa,m,"Pathological fracture in neoplastic disease, other specified site, initial encounter for fracture",Diseases of the musculoskeletal system and connective tissue,222,198,194,-0.108108108,-0.02020202,-0.126126126,786,805,828,19,23,42
m8458xd,m,"Pathological fracture in neoplastic disease, other specified site, subsequent encounter for fracture with routine healing",Diseases of the musculoskeletal system and connective tissue,31,26,26,-0.161290323,0,-0.161290323,2265,2377,2423,112,46,158
m8468xa,m,"Pathological fracture in other disease, other site, initial encounter for fracture",Diseases of the musculoskeletal system and connective tissue,20,27,19,0.35,-0.296296296,-0.05,2761,2326,2756,-435,430,-5
m8568,m,"Other cyst of bone, other site",Diseases of the musculoskeletal system and connective tissue,25,23,14,-0.08,-0.391304348,-0.44,2514,2514,3076,0,562,562
m8580,m,"Other specified disorders of bone density and structure, unspecified site",Diseases of the musculoskeletal system and connective tissue,2044,1703,1602,-0.166829746,-0.059307105,-0.216242661,168,194,218,26,24,50
m85851,m,"Other specified disorders of bone density and structure, right thigh",Diseases of the musculoskeletal system and connective tissue,14,12,10,-0.142857143,-0.166666667,-0.285714286,3135,3216,3341,81,125,206
m85861,m,"Other specified disorders of bone density and structure, right lower leg",Diseases of the musculoskeletal system and connective tissue,10,15,19,0.5,0.266666667,0.9,3369,2997,2755,-372,-242,-614
m85862,m,"Other specified disorders of bone density and structure, left lower leg",Diseases of the musculoskeletal system and connective tissue,17,11,18,-0.352941176,0.636363636,0.058823529,2943,3279,2814,336,-465,-129
m85871,m,"Other specified disorders of bone density and structure, right ankle and foot",Diseases of the musculoskeletal system and connective tissue,23,13,12,-0.434782609,-0.076923077,-0.47826087,2598,3135,3211,537,76,613
m85872,m,"Other specified disorders of bone density and structure, left ankle and foot",Diseases of the musculoskeletal system and connective tissue,17,10,16,-0.411764706,0.6,-0.058823529,2942,3347,2934,405,-413,-8
m8588,m,"Other specified disorders of bone density and structure, other site",Diseases of the musculoskeletal system and connective tissue,110,105,111,-0.045454545,0.057142857,0.009090909,1173,1132,1136,-41,4,-37
m8589,m,"Other specified disorders of bone density and structure, multiple sites",Diseases of the musculoskeletal system and connective tissue,35,15,42,-0.571428571,1.8,0.2,2133,2996,1932,863,-1064,-201
m8610,m,"Other acute osteomyelitis, unspecified site",Diseases of the musculoskeletal system and connective tissue,45,30,31,-0.333333333,0.033333333,-0.311111111,1903,2204,2241,301,37,338
m86141,m,"Other acute osteomyelitis, right hand",Diseases of the musculoskeletal system and connective tissue,33,34,29,0.03030303,-0.147058824,-0.121212121,2191,2060,2296,-131,236,105
m86142,m,"Other acute osteomyelitis, left hand",Diseases of the musculoskeletal system and connective tissue,23,27,19,0.173913043,-0.296296296,-0.173913043,2594,2322,2751,-272,429,157
m86152,m,"Other acute osteomyelitis, left femur",Diseases of the musculoskeletal system and connective tissue,19,12,19,-0.368421053,0.583333333,0,2813,3209,2751,396,-458,-62
m86161,m,"Other acute osteomyelitis, right tibia and fibula",Diseases of the musculoskeletal system and connective tissue,20,20,29,0,0.45,0.45,2753,2685,2296,-68,-389,-457
m86162,m,"Other acute osteomyelitis, left tibia and fibula",Diseases of the musculoskeletal system and connective tissue,27,28,20,0.037037037,-0.285714286,-0.259259259,2426,2282,2694,-144,412,268
m86171,m,"Other acute osteomyelitis, right ankle and foot",Diseases of the musculoskeletal system and connective tissue,644,584,642,-0.093167702,0.099315068,-0.00310559,405,411,395,6,-16,-10
m86172,m,"Other acute osteomyelitis, left ankle and foot",Diseases of the musculoskeletal system and connective tissue,667,570,510,-0.145427286,-0.105263158,-0.235382309,397,418,468,21,50,71
m86179,m,"Other acute osteomyelitis, unspecified ankle and foot",Diseases of the musculoskeletal system and connective tissue,24,18,22,-0.25,0.222222222,-0.083333333,2547,2792,2600,245,-192,53
m8618,m,"Other acute osteomyelitis, other site",Diseases of the musculoskeletal system and connective tissue,60,70,71,0.166666667,0.014285714,0.183333333,1641,1424,1457,-217,33,-184
m86471,m,"Chronic osteomyelitis with draining sinus, right ankle and foot",Diseases of the musculoskeletal system and connective tissue,14,13,10,-0.071428571,-0.230769231,-0.285714286,3120,3124,3325,4,201,205
m86472,m,"Chronic osteomyelitis with draining sinus, left ankle and foot",Diseases of the musculoskeletal system and connective tissue,14,16,12,0.142857143,-0.25,-0.142857143,3120,2935,3198,-185,263,78
m8660,m,"Other chronic osteomyelitis, unspecified site",Diseases of the musculoskeletal system and connective tissue,60,69,60,0.15,-0.130434783,0,1641,1442,1583,-199,141,-58
m86651,m,"Other chronic osteomyelitis, right thigh",Diseases of the musculoskeletal system and connective tissue,43,49,52,0.139534884,0.06122449,0.209302326,1938,1714,1718,-224,4,-220
m86652,m,"Other chronic osteomyelitis, left thigh",Diseases of the musculoskeletal system and connective tissue,51,48,40,-0.058823529,-0.166666667,-0.215686275,1783,1737,1972,-46,235,189
m86661,m,"Other chronic osteomyelitis, right tibia and fibula",Diseases of the musculoskeletal system and connective tissue,36,29,35,-0.194444444,0.206896552,-0.027777778,2096,2231,2094,135,-137,-2
m86662,m,"Other chronic osteomyelitis, left tibia and fibula",Diseases of the musculoskeletal system and connective tissue,52,57,31,0.096153846,-0.456140351,-0.403846154,1763,1598,2234,-165,636,471
m86671,m,"Other chronic osteomyelitis, right ankle and foot",Diseases of the musculoskeletal system and connective tissue,256,226,240,-0.1171875,0.061946903,-0.0625,720,747,737,27,-10,17
m86672,m,"Other chronic osteomyelitis, left ankle and foot",Diseases of the musculoskeletal system and connective tissue,260,197,214,-0.242307692,0.086294416,-0.176923077,709,802,782,93,-20,73
m86679,m,"Other chronic osteomyelitis, unspecified ankle and foot",Diseases of the musculoskeletal system and connective tissue,22,15,11,-0.318181818,-0.266666667,-0.5,2634,2979,3261,345,282,627
m8668,m,"Other chronic osteomyelitis, other site",Diseases of the musculoskeletal system and connective tissue,82,84,107,0.024390244,0.273809524,0.304878049,1373,1281,1154,-92,-127,-219
m868x4,m,"Other osteomyelitis, hand",Diseases of the musculoskeletal system and connective tissue,68,64,66,-0.058823529,0.03125,-0.029411765,1523,1498,1503,-25,5,-20
m868x5,m,"Other osteomyelitis, thigh",Diseases of the musculoskeletal system and connective tissue,17,20,18,0.176470588,-0.1,0.058823529,2920,2672,2793,-248,121,-127
m868x6,m,"Other osteomyelitis, lower leg",Diseases of the musculoskeletal system and connective tissue,115,94,98,-0.182608696,0.042553191,-0.147826087,1142,1205,1222,63,17,80
m868x7,m,"Other osteomyelitis, ankle and foot",Diseases of the musculoskeletal system and connective tissue,824,708,686,-0.140776699,-0.031073446,-0.167475728,337,370,383,33,13,46
m868x8,m,"Other osteomyelitis, other site",Diseases of the musculoskeletal system and connective tissue,127,124,136,-0.023622047,0.096774194,0.070866142,1060,1031,986,-29,-45,-74
m869,m,"Osteomyelitis, unspecified",Diseases of the musculoskeletal system and connective tissue,1593,1460,1371,-0.08349027,-0.060958904,-0.139359699,208,220,238,12,18,30
m87051,m,Idiopathic aseptic necrosis of right femur,Diseases of the musculoskeletal system and connective tissue,46,41,44,-0.108695652,0.073170732,-0.043478261,1864,1882,1873,18,-9,9
m87052,m,Idiopathic aseptic necrosis of left femur,Diseases of the musculoskeletal system and connective tissue,51,34,35,-0.333333333,0.029411765,-0.31372549,1774,2044,2085,270,41,311
m87851,m,"Other osteonecrosis, right femur",Diseases of the musculoskeletal system and connective tissue,145,89,71,-0.386206897,-0.202247191,-0.510344828,981,1234,1450,253,216,469
m87852,m,"Other osteonecrosis, left femur",Diseases of the musculoskeletal system and connective tissue,106,75,61,-0.29245283,-0.186666667,-0.424528302,1186,1357,1560,171,203,374
m8788,m,"Other osteonecrosis, other site",Diseases of the musculoskeletal system and connective tissue,22,17,15,-0.227272727,-0.117647059,-0.318181818,2624,2850,2974,226,124,350
m879,m,"Osteonecrosis, unspecified",Diseases of the musculoskeletal system and connective tissue,247,208,211,-0.157894737,0.014423077,-0.145748988,734,777,787,43,10,53
m889,m,Osteitis deformans of unspecified bone,Diseases of the musculoskeletal system and connective tissue,33,23,24,-0.303030303,0.043478261,-0.272727273,2170,2487,2497,317,10,327
m8949,m,"Other hypertrophic osteoarthropathy, multiple sites",Diseases of the musculoskeletal system and connective tissue,24,48,52,1,0.083333333,1.166666667,2527,1725,1707,-802,-18,-820
m8958,m,"Osteolysis, other site",Diseases of the musculoskeletal system and connective tissue,13,11,11,-0.153846154,0,-0.153846154,3164,3241,3246,77,5,82
m898x8,m,"Other specified disorders of bone, other site",Diseases of the musculoskeletal system and connective tissue,67,41,55,-0.388059701,0.341463415,-0.179104478,1534,1878,1654,344,-224,120
m898x9,m,"Other specified disorders of bone, unspecified site",Diseases of the musculoskeletal system and connective tissue,123,110,159,-0.105691057,0.445454545,0.292682927,1081,1096,904,15,-192,-177
m899,m,"Disorder of bone, unspecified",Diseases of the musculoskeletal system and connective tissue,218,164,187,-0.247706422,0.140243902,-0.142201835,790,872,839,82,-33,49
m940,m,Chondrocostal junction syndrome [Tietze],Diseases of the musculoskeletal system and connective tissue,172,153,168,-0.110465116,0.098039216,-0.023255814,884,913,883,29,-30,-1
m94211,m,"Chondromalacia, right shoulder",Diseases of the musculoskeletal system and connective tissue,12,10,10,-0.166666667,0,-0.166666667,3213,3305,3296,92,-9,83
m94262,m,"Chondromalacia, left knee",Diseases of the musculoskeletal system and connective tissue,14,12,10,-0.142857143,-0.166666667,-0.285714286,3093,3174,3296,81,122,203
m952,m,Other acquired deformity of head,Diseases of the musculoskeletal system and connective tissue,63,47,59,-0.253968254,0.255319149,-0.063492063,1593,1740,1583,147,-157,-10
m954,m,Acquired deformity of chest and rib,Diseases of the musculoskeletal system and connective tissue,30,24,24,-0.2,0,-0.2,2273,2430,2491,157,61,218
m960,m,Pseudarthrosis after fusion or arthrodesis,Diseases of the musculoskeletal system and connective tissue,335,295,294,-0.119402985,-0.003389831,-0.12238806,600,625,648,25,23,48
m961,m,"Postlaminectomy syndrome, not elsewhere classified",Diseases of the musculoskeletal system and connective tissue,316,259,283,-0.180379747,0.092664093,-0.10443038,626,679,663,53,-16,37
m96661,m,"Fracture of femur following insertion of orthopedic implant, joint prosthesis, or bone plate, right leg",Diseases of the musculoskeletal system and connective tissue,28,21,26,-0.25,0.238095238,-0.071428571,2351,2596,2388,245,-208,37
m96662,m,"Fracture of femur following insertion of orthopedic implant, joint prosthesis, or bone plate, left leg",Diseases of the musculoskeletal system and connective tissue,30,15,18,-0.5,0.2,-0.4,2271,2955,2773,684,-182,502
m96830,m,Postprocedural hemorrhage of a musculoskeletal structure following a musculoskeletal system procedure,Diseases of the musculoskeletal system and connective tissue,22,13,16,-0.409090909,0.230769231,-0.272727273,2611,3090,2891,479,-199,280
m96831,m,Postprocedural hemorrhage of a musculoskeletal structure following other procedure,Diseases of the musculoskeletal system and connective tissue,12,12,10,0,-0.166666667,-0.166666667,3205,3167,3289,-38,122,84
m96840,m,Postprocedural hematoma of a musculoskeletal structure following a musculoskeletal system procedure,Diseases of the musculoskeletal system and connective tissue,116,87,107,-0.25,0.229885057,-0.077586207,1127,1248,1145,121,-103,18
m96841,m,Postprocedural hematoma of a musculoskeletal structure following other procedure,Diseases of the musculoskeletal system and connective tissue,51,43,59,-0.156862745,0.372093023,0.156862745,1763,1816,1580,53,-236,-183
m96842,m,Postprocedural seroma of a musculoskeletal structure following a musculoskeletal system procedure,Diseases of the musculoskeletal system and connective tissue,66,47,64,-0.287878788,0.361702128,-0.03030303,1542,1737,1516,195,-221,-26
m96843,m,Postprocedural seroma of a musculoskeletal structure following other procedure,Diseases of the musculoskeletal system and connective tissue,33,10,14,-0.696969697,0.4,-0.575757576,2160,3293,3024,1133,-269,864
m9689,m,Other intraoperative and postprocedural complications and disorders of the musculoskeletal system,Diseases of the musculoskeletal system and connective tissue,44,22,38,-0.5,0.727272727,-0.136363636,1890,2530,1995,640,-535,105
m9701xa,m,"Periprosthetic fracture around internal prosthetic right hip joint, initial encounter",Diseases of the musculoskeletal system and connective tissue,179,178,208,-0.005586592,0.168539326,0.162011173,858,832,790,-26,-42,-68
m9701xd,m,"Periprosthetic fracture around internal prosthetic right hip joint, subsequent encounter",Diseases of the musculoskeletal system and connective tissue,38,31,45,-0.184210526,0.451612903,0.184210526,2029,2134,1833,105,-301,-196
m9702xa,m,"Periprosthetic fracture around internal prosthetic left hip joint, initial encounter",Diseases of the musculoskeletal system and connective tissue,155,160,172,0.032258065,0.075,0.109677419,941,884,868,-57,-16,-73
m9702xd,m,"Periprosthetic fracture around internal prosthetic left hip joint, subsequent encounter",Diseases of the musculoskeletal system and connective tissue,29,30,36,0.034482759,0.2,0.24137931,2305,2169,2027,-136,-142,-278
m9711xa,m,"Periprosthetic fracture around internal prosthetic right knee joint, initial encounter",Diseases of the musculoskeletal system and connective tissue,91,104,130,0.142857143,0.25,0.428571429,1275,1124,1009,-151,-115,-266
m9711xd,m,"Periprosthetic fracture around internal prosthetic right knee joint, subsequent encounter",Diseases of the musculoskeletal system and connective tissue,15,16,22,0.066666667,0.375,0.466666667,3017,2895,2561,-122,-334,-456
m9712xa,m,"Periprosthetic fracture around internal prosthetic left knee joint, initial encounter",Diseases of the musculoskeletal system and connective tissue,77,97,93,0.25974026,-0.041237113,0.207792208,1405,1170,1244,-235,74,-161
m9712xd,m,"Periprosthetic fracture around internal prosthetic left knee joint, subsequent encounter",Diseases of the musculoskeletal system and connective tissue,18,15,12,-0.166666667,-0.2,-0.333333333,2829,2944,3153,115,209,324
m9731xa,m,"Periprosthetic fracture around internal prosthetic right shoulder joint, initial encounter",Diseases of the musculoskeletal system and connective tissue,12,10,11,-0.166666667,0.1,-0.083333333,3192,3284,3222,92,-62,30
m978xxa,m,"Periprosthetic fracture around other internal prosthetic joint, initial encounter",Diseases of the musculoskeletal system and connective tissue,23,19,22,-0.173913043,0.157894737,-0.043478261,2548,2696,2560,148,-136,12
m979xxa,m,"Periprosthetic fracture around unspecified internal prosthetic joint, initial encounter",Diseases of the musculoskeletal system and connective tissue,16,17,12,0.0625,-0.294117647,-0.25,2943,2827,3152,-116,325,209
n009,n,Acute nephritic syndrome with unspecified morphologic changes,Diseases of the genitourinary system,20,24,12,0.2,-0.5,-0.4,2703,2419,3152,-284,733,449
n022,n,Recurrent and persistent hematuria with diffuse membranous glomerulonephritis,Diseases of the genitourinary system,16,16,14,0,-0.125,-0.125,2942,2891,3015,-51,124,73
n028,n,Recurrent and persistent hematuria with other morphologic changes,Diseases of the genitourinary system,113,141,131,0.247787611,-0.070921986,0.159292035,1141,949,1004,-192,55,-137
n029,n,Recurrent and persistent hematuria with unspecified morphologic changes,Diseases of the genitourinary system,141,136,100,-0.035460993,-0.264705882,-0.290780142,987,968,1187,-19,219,200
n040,n,Nephrotic syndrome with minor glomerular abnormality,Diseases of the genitourinary system,40,23,21,-0.425,-0.086956522,-0.475,1969,2466,2596,497,130,627
n041,n,Nephrotic syndrome with focal and segmental glomerular lesions,Diseases of the genitourinary system,32,18,23,-0.4375,0.277777778,-0.28125,2187,2746,2512,559,-234,325
n049,n,Nephrotic syndrome with unspecified morphologic changes,Diseases of the genitourinary system,243,225,225,-0.074074074,0,-0.074074074,737,744,758,7,14,21
n051,n,Unspecified nephritic syndrome with focal and segmental glomerular lesions,Diseases of the genitourinary system,18,27,32,0.5,0.185185185,0.777777778,2822,2280,2162,-542,-118,-660
n057,n,Unspecified nephritic syndrome with diffuse crescentic glomerulonephritis,Diseases of the genitourinary system,10,14,14,0.4,0,0.4,3290,3006,3009,-284,3,-281
n058,n,Unspecified nephritic syndrome with other morphologic changes,Diseases of the genitourinary system,23,20,21,-0.130434783,0.05,-0.086956522,2543,2636,2593,93,-43,50
n059,n,Unspecified nephritic syndrome with unspecified morphologic changes,Diseases of the genitourinary system,72,69,68,-0.041666667,-0.014492754,-0.055555556,1460,1419,1459,-41,40,-1
n08,n,Glomerular disorders in diseases classified elsewhere,Diseases of the genitourinary system,25,25,17,0,-0.32,-0.32,2459,2364,2812,-95,448,353
n10,n,Acute pyelonephritis,Diseases of the genitourinary system,2426,1964,1919,-0.190436933,-0.022912424,-0.208985985,144,164,182,20,18,38
n111,n,Chronic obstructive pyelonephritis,Diseases of the genitourinary system,28,32,30,0.142857143,-0.0625,0.071428571,2332,2093,2229,-239,136,-103
n119,n,"Chronic tubulo-interstitial nephritis, unspecified",Diseases of the genitourinary system,44,39,42,-0.113636364,0.076923077,-0.045454545,1881,1907,1894,26,-13,13
n12,n,"Tubulo-interstitial nephritis, not specified as acute or chronic",Diseases of the genitourinary system,1670,1498,1490,-0.102994012,-0.005340454,-0.107784431,202,214,220,12,6,18
n130,n,Hydronephrosis with ureteropelvic junction obstruction,Diseases of the genitourinary system,43,46,56,0.069767442,0.217391304,0.302325581,1901,1745,1612,-156,-133,-289
n131,n,"Hydronephrosis with ureteral stricture, not elsewhere classified",Diseases of the genitourinary system,361,349,305,-0.033240997,-0.126074499,-0.155124654,571,555,630,-16,75,59
n132,n,Hydronephrosis with renal and ureteral calculous obstruction,Diseases of the genitourinary system,999,842,911,-0.157157157,0.081947743,-0.088088088,286,314,311,28,-3,25
n1330,n,Unspecified hydronephrosis,Diseases of the genitourinary system,1553,1460,1468,-0.059884095,0.005479452,-0.054732775,211,218,222,7,4,11
n1339,n,Other hydronephrosis,Diseases of the genitourinary system,160,140,166,-0.125,0.185714286,0.0375,908,943,876,35,-67,-32
n134,n,Hydroureter,Diseases of the genitourinary system,102,118,118,0.156862745,0,0.156862745,1191,1043,1072,-148,29,-119
n135,n,Crossing vessel and stricture of ureter without hydronephrosis,Diseases of the genitourinary system,116,137,119,0.181034483,-0.131386861,0.025862069,1117,957,1065,-160,108,-52
n136,n,Pyonephrosis,Diseases of the genitourinary system,2942,2869,2912,-0.024813052,0.014987801,-0.010197145,123,124,125,1,1,2
n1370,n,"Vesicoureteral-reflux, unspecified",Diseases of the genitourinary system,128,105,117,-0.1796875,0.114285714,-0.0859375,1037,1105,1074,68,-31,37
n13729,n,"Vesicoureteral-reflux with reflux nephropathy without hydroureter, unspecified",Diseases of the genitourinary system,21,20,13,-0.047619048,-0.35,-0.380952381,2628,2621,3062,-7,441,434
n138,n,Other obstructive and reflux uropathy,Diseases of the genitourinary system,1423,1292,1284,-0.09205903,-0.00619195,-0.097680956,225,237,244,12,7,19
n139,n,"Obstructive and reflux uropathy, unspecified",Diseases of the genitourinary system,633,533,619,-0.157977883,0.161350844,-0.022116904,398,423,399,25,-24,1
n140,n,Analgesic nephropathy,Diseases of the genitourinary system,46,33,26,-0.282608696,-0.212121212,-0.434782609,1830,2046,2358,216,312,528
n141,n,"Nephropathy induced by other drugs, medicaments and biological substances",Diseases of the genitourinary system,559,575,514,0.02862254,-0.106086957,-0.080500894,429,408,455,-21,47,26
n142,n,"Nephropathy induced by unspecified drug, medicament or biological substance",Diseases of the genitourinary system,16,20,13,0.25,-0.35,-0.1875,2915,2617,3058,-298,441,143
n151,n,Renal and perinephric abscess,Diseases of the genitourinary system,180,177,174,-0.016666667,-0.016949153,-0.033333333,845,823,851,-22,28,6
n159,n,"Renal tubulo-interstitial disease, unspecified",Diseases of the genitourinary system,24,31,19,0.291666667,-0.387096774,-0.208333333,2481,2109,2678,-372,569,197
n16,n,Renal tubulo-interstitial disorders in diseases classified elsewhere,Diseases of the genitourinary system,170,139,105,-0.182352941,-0.244604317,-0.382352941,877,943,1135,66,192,258
n170,n,Acute kidney failure with tubular necrosis,Diseases of the genitourinary system,5805,6311,7267,0.087166236,0.15148154,0.251851852,65,56,50,-9,-6,-15
n171,n,Acute kidney failure with acute cortical necrosis,Diseases of the genitourinary system,13,29,26,1.230769231,-0.103448276,1,3103,2175,2354,-928,179,-749
n178,n,Other acute kidney failure,Diseases of the genitourinary system,376,325,302,-0.135638298,-0.070769231,-0.196808511,546,577,627,31,50,81
n179,n,"Acute kidney failure, unspecified",Diseases of the genitourinary system,43250,42852,47086,-0.009202312,0.09880519,0.088693642,5,4,6,-1,2,1
n181,n,"Chronic kidney disease, stage 1",Diseases of the genitourinary system,242,193,209,-0.202479339,0.082901554,-0.136363636,727,793,776,66,-17,49
n182,n,"Chronic kidney disease, stage 2 (mild)",Diseases of the genitourinary system,2247,2141,2356,-0.04717401,0.100420364,0.048509123,152,151,145,-1,-6,-7
n184,n,"Chronic kidney disease, stage 4 (severe)",Diseases of the genitourinary system,4595,4371,4400,-0.04874864,0.006634637,-0.042437432,86,87,93,1,6,7
n185,n,"Chronic kidney disease, stage 5",Diseases of the genitourinary system,508,517,455,0.017716535,-0.119922631,-0.104330709,456,431,484,-25,53,28
n186,n,End stage renal disease,Diseases of the genitourinary system,11130,11113,11507,-0.001527403,0.035453973,0.033872417,27,27,25,0,-2,-2
n189,n,"Chronic kidney disease, unspecified",Diseases of the genitourinary system,10439,10121,10108,-0.030462688,-0.001284458,-0.031708018,28,29,32,1,3,4
n19,n,Unspecified kidney failure,Diseases of the genitourinary system,156,135,162,-0.134615385,0.2,0.038461538,914,946,871,32,-75,-43
n200,n,Calculus of kidney,Diseases of the genitourinary system,2489,2098,2107,-0.157091201,0.0042898,-0.153475291,132,151,162,19,11,30
n201,n,Calculus of ureter,Diseases of the genitourinary system,306,260,246,-0.150326797,-0.053846154,-0.196078431,624,660,705,36,45,81
n202,n,Calculus of kidney with calculus of ureter,Diseases of the genitourinary system,301,308,286,0.023255814,-0.071428571,-0.049833887,634,592,641,-42,49,7
n209,n,"Urinary calculus, unspecified",Diseases of the genitourinary system,26,17,23,-0.346153846,0.352941176,-0.115384615,2381,2781,2476,400,-305,95
n210,n,Calculus in bladder,Diseases of the genitourinary system,292,272,233,-0.068493151,-0.143382353,-0.202054795,646,640,725,-6,85,79
n23,n,Unspecified renal colic,Diseases of the genitourinary system,68,79,66,0.161764706,-0.164556962,-0.029411765,1473,1274,1454,-199,180,-19
n250,n,Renal osteodystrophy,Diseases of the genitourinary system,284,191,212,-0.327464789,0.109947644,-0.253521127,655,791,758,136,-33,103
n251,n,Nephrogenic diabetes insipidus,Diseases of the genitourinary system,26,25,19,-0.038461538,-0.24,-0.269230769,2378,2327,2659,-51,332,281
n2581,n,Secondary hyperparathyroidism of renal origin,Diseases of the genitourinary system,1739,1695,1852,-0.025301898,0.092625369,0.064979873,187,185,179,-2,-6,-8
n2589,n,Other disorders resulting from impaired renal tubular function,Diseases of the genitourinary system,185,196,190,0.059459459,-0.030612245,0.027027027,815,776,802,-39,26,-13
n261,n,Atrophy of kidney (terminal),Diseases of the genitourinary system,253,233,233,-0.079051383,0,-0.079051383,697,702,724,5,22,27
n269,n,"Renal sclerosis, unspecified",Diseases of the genitourinary system,59,59,55,0,-0.06779661,-0.06779661,1600,1511,1602,-89,91,2
n270,n,"Small kidney, unilateral",Diseases of the genitourinary system,31,21,28,-0.322580645,0.333333333,-0.096774194,2177,2536,2260,359,-276,83
n271,n,"Small kidney, bilateral",Diseases of the genitourinary system,36,31,20,-0.138888889,-0.35483871,-0.444444444,2023,2088,2599,65,511,576
n280,n,Ischemia and infarction of kidney,Diseases of the genitourinary system,159,165,188,0.037735849,0.139393939,0.182389937,888,840,806,-48,-34,-82
n281,n,"Cyst of kidney, acquired",Diseases of the genitourinary system,2486,2166,1887,-0.128720837,-0.128808864,-0.240949316,132,146,175,14,29,43
n2881,n,Hypertrophy of kidney,Diseases of the genitourinary system,24,18,20,-0.25,0.111111111,-0.166666667,2454,2693,2597,239,-96,143
n2882,n,Megaloureter,Diseases of the genitourinary system,35,25,26,-0.285714286,0.04,-0.257142857,2049,2320,2332,271,12,283
n2889,n,Other specified disorders of kidney and ureter,Diseases of the genitourinary system,1086,1046,1028,-0.036832413,-0.017208413,-0.053406998,260,263,273,3,10,13
n289,n,"Disorder of kidney and ureter, unspecified",Diseases of the genitourinary system,1775,1578,1611,-0.110985915,0.020912548,-0.092394366,184,200,205,16,5,21
n29,n,Other disorders of kidney and ureter in diseases classified elsewhere,Diseases of the genitourinary system,47,37,36,-0.212765957,-0.027027027,-0.234042553,1782,1916,1980,134,64,198
n3000,n,Acute cystitis without hematuria,Diseases of the genitourinary system,1897,1647,1706,-0.131787032,0.035822708,-0.100685293,173,189,189,16,0,16
n3001,n,Acute cystitis with hematuria,Diseases of the genitourinary system,548,475,442,-0.133211679,-0.069473684,-0.193430657,423,446,485,23,39,62
n3010,n,Interstitial cystitis (chronic) without hematuria,Diseases of the genitourinary system,128,122,110,-0.046875,-0.098360656,-0.140625,1008,992,1092,-16,100,84
n3020,n,Other chronic cystitis without hematuria,Diseases of the genitourinary system,60,70,66,0.166666667,-0.057142857,0.1,1572,1360,1443,-212,83,-129
n3021,n,Other chronic cystitis with hematuria,Diseases of the genitourinary system,20,20,24,0,0.2,0.2,2639,2580,2422,-59,-158,-217
n3040,n,Irradiation cystitis without hematuria,Diseases of the genitourinary system,37,33,31,-0.108108108,-0.060606061,-0.162162162,1990,2014,2152,24,138,162
n3041,n,Irradiation cystitis with hematuria,Diseases of the genitourinary system,69,63,55,-0.086956522,-0.126984127,-0.202898551,1452,1449,1594,-3,145,142
n3080,n,Other cystitis without hematuria,Diseases of the genitourinary system,74,74,75,0,0.013513514,0.013513514,1397,1312,1344,-85,32,-53
n3081,n,Other cystitis with hematuria,Diseases of the genitourinary system,36,40,25,0.111111111,-0.375,-0.305555556,2011,1839,2363,-172,524,352
n3090,n,"Cystitis, unspecified without hematuria",Diseases of the genitourinary system,666,706,719,0.06006006,0.018413598,0.07957958,377,351,357,-26,6,-20
n3091,n,"Cystitis, unspecified with hematuria",Diseases of the genitourinary system,178,172,157,-0.033707865,-0.087209302,-0.117977528,828,810,867,-18,57,39
n312,n,"Flaccid neuropathic bladder, not elsewhere classified",Diseases of the genitourinary system,123,112,100,-0.089430894,-0.107142857,-0.18699187,1033,1037,1144,4,107,111
n318,n,Other neuromuscular dysfunction of bladder,Diseases of the genitourinary system,94,79,92,-0.159574468,0.164556962,-0.021276596,1203,1260,1206,57,-54,3
n319,n,"Neuromuscular dysfunction of bladder, unspecified",Diseases of the genitourinary system,2548,2200,2183,-0.136577708,-0.007727273,-0.143249608,130,143,154,13,11,24
n320,n,Bladder-neck obstruction,Diseases of the genitourinary system,588,599,637,0.018707483,0.063439065,0.083333333,395,386,379,-9,-7,-16
n321,n,Vesicointestinal fistula,Diseases of the genitourinary system,237,205,283,-0.135021097,0.380487805,0.194092827,715,751,635,36,-116,-80
n322,n,"Vesical fistula, not elsewhere classified",Diseases of the genitourinary system,31,28,22,-0.096774194,-0.214285714,-0.290322581,2155,2178,2490,23,312,335
n323,n,Diverticulum of bladder,Diseases of the genitourinary system,158,137,145,-0.132911392,0.058394161,-0.082278481,881,923,898,42,-25,17
n3281,n,Overactive bladder,Diseases of the genitourinary system,860,782,788,-0.090697674,0.007672634,-0.08372093,307,314,327,7,13,20
n3289,n,Other specified disorders of bladder,Diseases of the genitourinary system,982,937,912,-0.045824847,-0.026680896,-0.071283096,274,275,293,1,18,19
n329,n,"Bladder disorder, unspecified",Diseases of the genitourinary system,166,129,131,-0.222891566,0.015503876,-0.210843373,856,952,960,96,8,104
n342,n,Other urethritis,Diseases of the genitourinary system,34,22,29,-0.352941176,0.318181818,-0.147058824,2051,2447,2191,396,-256,140
n35819,n,"Other urethral stricture, male, unspecified site",Diseases of the genitourinary system,37,26,23,-0.297297297,-0.115384615,-0.378378378,1977,2260,2441,283,181,464
n35911,n,"Unspecified urethral stricture, male, meatal",Diseases of the genitourinary system,38,39,45,0.026315789,0.153846154,0.184210526,1961,1850,1769,-111,-81,-192
n35912,n,"Unspecified bulbous urethral stricture, male",Diseases of the genitourinary system,34,58,48,0.705882353,-0.172413793,0.411764706,2049,1502,1707,-547,205,-342
n35919,n,"Unspecified urethral stricture, male, unspecified site",Diseases of the genitourinary system,219,233,200,0.063926941,-0.141630901,-0.086757991,747,692,772,-55,80,25
n3592,n,"Unspecified urethral stricture, female",Diseases of the genitourinary system,32,38,40,0.1875,0.052631579,0.25,2116,1871,1879,-245,8,-237
n360,n,Urethral fistula,Diseases of the genitourinary system,23,39,32,0.695652174,-0.179487179,0.391304348,2464,1848,2098,-616,250,-366
n365,n,Urethral false passage,Diseases of the genitourinary system,30,40,42,0.333333333,0.05,0.4,2183,1826,1835,-357,9,-348
n368,n,Other specified disorders of urethra,Diseases of the genitourinary system,101,86,102,-0.148514851,0.186046512,0.00990099,1152,1197,1120,45,-77,-32
n390,n,"Urinary tract infection, site not specified",Diseases of the genitourinary system,22536,20716,22154,-0.080759673,0.069414945,-0.016950657,12,12,12,0,0,0
n393,n,Stress incontinence (female) (male),Diseases of the genitourinary system,546,462,383,-0.153846154,-0.170995671,-0.298534799,420,454,526,34,72,106
n3941,n,Urge incontinence,Diseases of the genitourinary system,336,282,267,-0.160714286,-0.053191489,-0.205357143,567,612,655,45,43,88
n3942,n,Incontinence without sensory awareness,Diseases of the genitourinary system,15,12,10,-0.2,-0.166666667,-0.333333333,2916,3054,3174,138,120,258
n3943,n,Post-void dribbling,Diseases of the genitourinary system,18,27,24,0.5,-0.111111111,0.333333333,2734,2202,2396,-532,194,-338
n3944,n,Nocturnal enuresis,Diseases of the genitourinary system,63,60,62,-0.047619048,0.033333333,-0.015873016,1522,1471,1473,-51,2,-49
n3946,n,Mixed incontinence,Diseases of the genitourinary system,131,115,105,-0.122137405,-0.086956522,-0.198473282,976,1012,1097,36,85,121
n39490,n,Overflow incontinence,Diseases of the genitourinary system,120,98,120,-0.183333333,0.224489796,0,1039,1101,1012,62,-89,-27
n39498,n,Other specified urinary incontinence,Diseases of the genitourinary system,302,256,249,-0.152317881,-0.02734375,-0.175496689,618,647,683,29,36,65
n400,n,Benign prostatic hyperplasia without lower urinary tract symptoms,Diseases of the genitourinary system,13789,13389,13627,-0.02900863,0.017775786,-0.011748495,17,18,19,1,1,2
n401,n,Benign prostatic hyperplasia with lower urinary tract symptoms,Diseases of the genitourinary system,5280,4814,4611,-0.088257576,-0.042168675,-0.126704545,70,70,86,0,16,16
n402,n,Nodular prostate without lower urinary tract symptoms,Diseases of the genitourinary system,21,11,12,-0.476190476,0.090909091,-0.428571429,2552,3107,3047,555,-60,495
n410,n,Acute prostatitis,Diseases of the genitourinary system,120,88,104,-0.266666667,0.181818182,-0.133333333,1036,1170,1098,134,-72,62
n411,n,Chronic prostatitis,Diseases of the genitourinary system,49,27,43,-0.448979592,0.592592593,-0.12244898,1719,2195,1802,476,-393,83
n412,n,Abscess of prostate,Diseases of the genitourinary system,68,47,85,-0.308823529,0.808510638,0.25,1438,1660,1235,222,-425,-203
n419,n,"Inflammatory disease of prostate, unspecified",Diseases of the genitourinary system,141,121,139,-0.141843972,0.148760331,-0.014184397,934,977,912,43,-65,-22
n4289,n,Other specified disorders of prostate,Diseases of the genitourinary system,17,17,14,0,-0.176470588,-0.176470588,2777,2720,2910,-57,190,133
n429,n,"Disorder of prostate, unspecified",Diseases of the genitourinary system,27,28,35,0.037037037,0.25,0.296296296,2289,2155,1982,-134,-173,-307
n432,n,Other hydrocele,Diseases of the genitourinary system,27,30,17,0.111111111,-0.433333333,-0.37037037,2289,2079,2715,-210,636,426
n433,n,"Hydrocele, unspecified",Diseases of the genitourinary system,357,337,361,-0.056022409,0.071216617,0.011204482,544,536,544,-8,8,0
n4400,n,"Torsion of testis, unspecified",Diseases of the genitourinary system,22,20,22,-0.090909091,0.1,0,2495,2538,2461,43,-77,-34
n451,n,Epididymitis,Diseases of the genitourinary system,124,95,97,-0.233870968,0.021052632,-0.217741935,1008,1118,1147,110,29,139
n452,n,Orchitis,Diseases of the genitourinary system,31,28,31,-0.096774194,0.107142857,0,2129,2152,2116,23,-36,-13
n453,n,Epididymo-orchitis,Diseases of the genitourinary system,129,121,130,-0.062015504,0.074380165,0.007751938,981,976,954,-5,-22,-27
n454,n,Abscess of epididymis or testis,Diseases of the genitourinary system,17,13,23,-0.235294118,0.769230769,0.352941176,2770,2958,2415,188,-543,-355
n471,n,Phimosis,Diseases of the genitourinary system,186,139,158,-0.252688172,0.136690647,-0.150537634,794,905,849,111,-56,55
n472,n,Paraphimosis,Diseases of the genitourinary system,28,36,37,0.285714286,0.027777778,0.321428571,2241,1897,1922,-344,25,-319
n481,n,Balanitis,Diseases of the genitourinary system,44,64,51,0.454545455,-0.203125,0.159090909,1805,1407,1632,-398,225,-173
n4822,n,Cellulitis of corpus cavernosum and penis,Diseases of the genitourinary system,30,23,25,-0.233333333,0.086956522,-0.166666667,2163,2362,2323,199,-39,160
n4830,n,"Priapism, unspecified",Diseases of the genitourinary system,27,24,31,-0.111111111,0.291666667,0.148148148,2281,2313,2112,32,-201,-169
n485,n,Ulcer of penis,Diseases of the genitourinary system,39,33,37,-0.153846154,0.121212121,-0.051282051,1916,1975,1921,59,-54,5
n4889,n,Other specified disorders of penis,Diseases of the genitourinary system,158,144,127,-0.088607595,-0.118055556,-0.196202532,869,886,969,17,83,100
n492,n,Inflammatory disorders of scrotum,Diseases of the genitourinary system,358,293,305,-0.181564246,0.040955631,-0.148044693,542,595,600,53,5,58
n493,n,Fournier gangrene,Diseases of the genitourinary system,75,76,140,0.013333333,0.842105263,0.866666667,1350,1266,903,-84,-363,-447
n501,n,Vascular disorders of male genital organs,Diseases of the genitourinary system,32,22,26,-0.3125,0.181818182,-0.1875,2093,2410,2277,317,-133,184
n503,n,Cyst of epididymis,Diseases of the genitourinary system,35,22,25,-0.371428571,0.136363636,-0.285714286,2001,2410,2317,409,-93,316
n50811,n,Right testicular pain,Diseases of the genitourinary system,49,29,43,-0.408163265,0.482758621,-0.12244898,1710,2101,1792,391,-309,82
n50812,n,Left testicular pain,Diseases of the genitourinary system,39,31,25,-0.205128205,-0.193548387,-0.358974359,1912,2035,2316,123,281,404
n50819,n,"Testicular pain, unspecified",Diseases of the genitourinary system,75,54,62,-0.28,0.148148148,-0.173333333,1350,1529,1458,179,-71,108
n5082,n,Scrotal pain,Diseases of the genitourinary system,136,75,94,-0.448529412,0.253333333,-0.308823529,951,1272,1163,321,-109,212
n5089,n,Other specified disorders of the male genital organs,Diseases of the genitourinary system,648,625,554,-0.035493827,-0.1136,-0.145061728,376,373,413,-3,40,37
n509,n,"Disorder of male genital organs, unspecified",Diseases of the genitourinary system,18,14,22,-0.222222222,0.571428571,0.222222222,2700,2881,2441,181,-440,-259
n529,n,"Male erectile dysfunction, unspecified",Diseases of the genitourinary system,347,251,247,-0.276657061,-0.015936255,-0.288184438,553,647,681,94,34,128
n6019,n,Diffuse cystic mastopathy of unspecified breast,Diseases of the genitourinary system,20,22,11,0.1,-0.5,-0.45,2576,2404,3082,-172,678,506
n610,n,Mastitis without abscess,Diseases of the genitourinary system,195,142,149,-0.271794872,0.049295775,-0.235897436,777,891,871,114,-20,94
n611,n,Abscess of the breast and nipple,Diseases of the genitourinary system,178,166,134,-0.06741573,-0.192771084,-0.247191011,810,813,928,3,115,118
n62,n,Hypertrophy of breast,Diseases of the genitourinary system,85,84,67,-0.011764706,-0.202380952,-0.211764706,1249,1190,1390,-59,200,141
n630,n,Unspecified lump in unspecified breast,Diseases of the genitourinary system,67,59,59,-0.119402985,0,-0.119402985,1439,1463,1489,24,26,50
n6310,n,"Unspecified lump in the right breast, unspecified quadrant",Diseases of the genitourinary system,65,73,55,0.123076923,-0.246575342,-0.153846154,1467,1291,1553,-176,262,86
n6320,n,"Unspecified lump in the left breast, unspecified quadrant",Diseases of the genitourinary system,87,63,61,-0.275862069,-0.031746032,-0.298850575,1228,1410,1462,182,52,234
n644,n,Mastodynia,Diseases of the genitourinary system,97,69,73,-0.288659794,0.057971014,-0.24742268,1155,1339,1330,184,-9,175
n6459,n,Other signs and symptoms in breast,Diseases of the genitourinary system,11,15,17,0.363636364,0.133333333,0.545454545,3095,2800,2684,-295,-116,-411
n6489,n,Other specified disorders of breast,Diseases of the genitourinary system,37,22,23,-0.405405405,0.045454545,-0.378378378,1939,2397,2391,458,-6,452
n649,n,"Disorder of breast, unspecified",Diseases of the genitourinary system,14,15,17,0.071428571,0.133333333,0.214285714,2925,2799,2683,-126,-116,-242
n7011,n,Chronic salpingitis,Diseases of the genitourinary system,47,42,42,-0.106382979,0,-0.106382979,1731,1738,1801,7,63,70
n7093,n,"Salpingitis and oophoritis, unspecified",Diseases of the genitourinary system,106,100,117,-0.056603774,0.17,0.103773585,1103,1074,1018,-29,-56,-85
n719,n,"Inflammatory disease of uterus, unspecified",Diseases of the genitourinary system,40,28,31,-0.3,0.107142857,-0.225,1870,2129,2094,259,-35,224
n72,n,Inflammatory disease of cervix uteri,Diseases of the genitourinary system,20,17,22,-0.15,0.294117647,0.1,2565,2684,2429,119,-255,-136
n730,n,Acute parametritis and pelvic cellulitis,Diseases of the genitourinary system,67,29,30,-0.567164179,0.034482759,-0.552238806,1436,2087,2122,651,35,686
n736,n,Female pelvic peritoneal adhesions (postinfective),Diseases of the genitourinary system,574,452,511,-0.212543554,0.130530973,-0.109756098,396,459,436,63,-23,40
n738,n,Other specified female pelvic inflammatory diseases,Diseases of the genitourinary system,15,13,20,-0.133333333,0.538461538,0.333333333,2862,2923,2510,61,-413,-352
n739,n,"Female pelvic inflammatory disease, unspecified",Diseases of the genitourinary system,258,232,274,-0.100775194,0.181034483,0.062015504,667,685,638,18,-47,-29
n750,n,Cyst of Bartholin's gland,Diseases of the genitourinary system,24,32,28,0.333333333,-0.125,0.166666667,2372,1988,2185,-384,197,-187
n751,n,Abscess of Bartholin's gland,Diseases of the genitourinary system,11,12,11,0.090909091,-0.083333333,0,3084,2996,3063,-88,67,-21
n760,n,Acute vaginitis,Diseases of the genitourinary system,318,278,317,-0.125786164,0.14028777,-0.003144654,583,610,585,27,-25,2
n762,n,Acute vulvitis,Diseases of the genitourinary system,68,88,74,0.294117647,-0.159090909,0.088235294,1417,1155,1312,-262,157,-105
n764,n,Abscess of vulva,Diseases of the genitourinary system,123,94,119,-0.235772358,0.265957447,-0.032520325,1003,1115,1005,112,-110,2
n766,n,Ulceration of vulva,Diseases of the genitourinary system,16,18,11,0.125,-0.388888889,-0.3125,2789,2602,3060,-187,458,271
n7689,n,Other specified inflammation of vagina and vulva,Diseases of the genitourinary system,17,21,29,0.235294118,0.380952381,0.705882353,2732,2444,2137,-288,-307,-595
n800,n,Endometriosis of uterus,Diseases of the genitourinary system,104,70,102,-0.326923077,0.457142857,-0.019230769,1107,1316,1095,209,-221,-12
n801,n,Endometriosis of ovary,Diseases of the genitourinary system,81,59,71,-0.271604938,0.203389831,-0.12345679,1281,1453,1351,172,-102,70
n803,n,Endometriosis of pelvic peritoneum,Diseases of the genitourinary system,51,50,60,-0.019607843,0.2,0.176470588,1657,1568,1465,-89,-103,-192
n805,n,Endometriosis of intestine,Diseases of the genitourinary system,19,11,10,-0.421052632,-0.090909091,-0.473684211,2610,3047,3106,437,59,496
n809,n,"Endometriosis, unspecified",Diseases of the genitourinary system,295,233,239,-0.210169492,0.025751073,-0.189830508,620,680,690,60,10,70
n8110,n,"Cystocele, unspecified",Diseases of the genitourinary system,179,134,127,-0.251396648,-0.052238806,-0.290502793,802,908,959,106,51,157
n812,n,Incomplete uterovaginal prolapse,Diseases of the genitourinary system,28,18,24,-0.357142857,0.333333333,-0.142857143,2205,2596,2341,391,-255,136
n813,n,Complete uterovaginal prolapse,Diseases of the genitourinary system,45,44,23,-0.022222222,-0.477272727,-0.488888889,1761,1689,2374,-72,685,613
n814,n,"Uterovaginal prolapse, unspecified",Diseases of the genitourinary system,120,84,76,-0.3,-0.095238095,-0.366666667,1018,1182,1291,164,109,273
n816,n,Rectocele,Diseases of the genitourinary system,80,58,65,-0.275,0.120689655,-0.1875,1291,1460,1404,169,-56,113
n8189,n,Other female genital prolapse,Diseases of the genitourinary system,27,18,15,-0.333333333,-0.166666667,-0.444444444,2243,2593,2785,350,192,542
n820,n,Vesicovaginal fistula,Diseases of the genitourinary system,29,30,42,0.034482759,0.4,0.448275862,2166,2041,1788,-125,-253,-378
n823,n,Fistula of vagina to large intestine,Diseases of the genitourinary system,153,130,143,-0.150326797,0.1,-0.065359477,880,929,885,49,-44,5
n824,n,Other female intestinal-genital tract fistulae,Diseases of the genitourinary system,24,16,17,-0.333333333,0.0625,-0.291666667,2357,2725,2659,368,-66,302
n828,n,Other female genital tract fistulae,Diseases of the genitourinary system,20,17,13,-0.15,-0.235294118,-0.35,2545,2663,2916,118,253,371
n8311,n,Corpus luteum cyst of right ovary,Diseases of the genitourinary system,20,16,20,-0.2,0.25,0,2545,2724,2493,179,-231,-52
n83201,n,"Unspecified ovarian cyst, right side",Diseases of the genitourinary system,372,334,333,-0.102150538,-0.002994012,-0.10483871,527,539,566,12,27,39
n83202,n,"Unspecified ovarian cyst, left side",Diseases of the genitourinary system,401,320,377,-0.201995012,0.178125,-0.059850374,503,556,528,53,-28,25
n83209,n,"Unspecified ovarian cyst, unspecified side",Diseases of the genitourinary system,235,174,171,-0.259574468,-0.017241379,-0.272340426,702,781,814,79,33,112
n83291,n,"Other ovarian cyst, right side",Diseases of the genitourinary system,69,58,58,-0.15942029,0,-0.15942029,1397,1456,1479,59,23,82
n83292,n,"Other ovarian cyst, left side",Diseases of the genitourinary system,66,60,75,-0.090909091,0.25,0.136363636,1432,1433,1295,1,-138,-137
n83511,n,Torsion of right ovary and ovarian pedicle,Diseases of the genitourinary system,20,27,24,0.35,-0.111111111,0.2,2540,2142,2332,-398,190,-208
n83512,n,Torsion of left ovary and ovarian pedicle,Diseases of the genitourinary system,24,11,13,-0.541666667,0.181818182,-0.458333333,2352,3029,2909,677,-120,557
n838,n,"Other noninflammatory disorders of ovary, fallopian tube and broad ligament",Diseases of the genitourinary system,182,196,203,0.076923077,0.035714286,0.115384615,792,747,743,-45,-4,-49
n839,n,"Noninflammatory disorder of ovary, fallopian tube and broad ligament, unspecified",Diseases of the genitourinary system,84,82,55,-0.023809524,-0.329268293,-0.345238095,1242,1199,1531,-43,332,289
n840,n,Polyp of corpus uteri,Diseases of the genitourinary system,54,46,46,-0.148148148,0,-0.148148148,1598,1636,1694,38,58,96
n841,n,Polyp of cervix uteri,Diseases of the genitourinary system,23,17,25,-0.260869565,0.470588235,0.086956522,2386,2654,2277,268,-377,-109
n8500,n,"Endometrial hyperplasia, unspecified",Diseases of the genitourinary system,16,19,16,0.1875,-0.157894737,0,2761,2528,2702,-233,174,-59
n852,n,Hypertrophy of uterus,Diseases of the genitourinary system,70,52,64,-0.257142857,0.230769231,-0.085714286,1383,1529,1409,146,-120,26
n854,n,Malposition of uterus,Diseases of the genitourinary system,30,37,16,0.233333333,-0.567567568,-0.466666667,2116,1835,2701,-281,866,585
n858,n,Other specified noninflammatory disorders of uterus,Diseases of the genitourinary system,1261,1009,1181,-0.199841396,0.170465808,-0.063441713,231,263,237,32,-26,6
n859,n,"Noninflammatory disorder of uterus, unspecified",Diseases of the genitourinary system,17,22,21,0.294117647,-0.045454545,0.235294118,2702,2365,2432,-337,67,-270
n879,n,"Dysplasia of cervix uteri, unspecified",Diseases of the genitourinary system,28,21,18,-0.25,-0.142857143,-0.357142857,2189,2421,2586,232,165,397
n882,n,Stricture and stenosis of cervix uteri,Diseases of the genitourinary system,12,13,12,0.083333333,-0.076923077,0,2995,2885,2961,-110,76,-34
n888,n,Other specified noninflammatory disorders of cervix uteri,Diseases of the genitourinary system,39,48,42,0.230769231,-0.125,0.076923077,1873,1599,1777,-274,178,-96
n898,n,Other specified noninflammatory disorders of vagina,Diseases of the genitourinary system,202,164,174,-0.188118812,0.06097561,-0.138613861,759,807,803,48,-4,44
n9089,n,Other specified noninflammatory disorders of vulva and perineum,Diseases of the genitourinary system,60,33,43,-0.45,0.303030303,-0.283333333,1503,1932,1756,429,-176,253
n911,n,Secondary amenorrhea,Diseases of the genitourinary system,12,10,11,-0.166666667,0.1,-0.083333333,2992,3080,3023,88,-57,31
n912,n,"Amenorrhea, unspecified",Diseases of the genitourinary system,34,23,26,-0.323529412,0.130434783,-0.235294118,1979,2309,2232,330,-77,253
n920,n,Excessive and frequent menstruation with regular cycle,Diseases of the genitourinary system,696,520,623,-0.252873563,0.198076923,-0.104885057,365,411,377,46,-34,12
n921,n,Excessive and frequent menstruation with irregular cycle,Diseases of the genitourinary system,117,102,121,-0.128205128,0.18627451,0.034188034,1031,1047,978,16,-69,-53
n926,n,"Irregular menstruation, unspecified",Diseases of the genitourinary system,109,96,92,-0.119266055,-0.041666667,-0.155963303,1069,1090,1158,21,68,89
n930,n,Postcoital and contact bleeding,Diseases of the genitourinary system,21,12,15,-0.428571429,0.25,-0.285714286,2472,2952,2758,480,-194,286
n938,n,Other specified abnormal uterine and vaginal bleeding,Diseases of the genitourinary system,228,153,197,-0.328947368,0.287581699,-0.135964912,709,845,756,136,-89,47
n939,n,"Abnormal uterine and vaginal bleeding, unspecified",Diseases of the genitourinary system,474,340,507,-0.282700422,0.491176471,0.069620253,454,530,435,76,-95,-19
n9410,n,Unspecified dyspareunia,Diseases of the genitourinary system,58,20,35,-0.655172414,0.75,-0.396551724,1536,2465,1926,929,-539,390
n946,n,"Dysmenorrhea, unspecified",Diseases of the genitourinary system,205,159,201,-0.224390244,0.264150943,-0.019512195,751,821,748,70,-73,-3
n9489,n,Other specified conditions associated with female genital organs and menstrual cycle,Diseases of the genitourinary system,91,96,87,0.054945055,-0.09375,-0.043956044,1175,1087,1183,-88,96,8
n950,n,Postmenopausal bleeding,Diseases of the genitourinary system,202,161,203,-0.202970297,0.260869565,0.004950495,755,814,740,59,-74,-15
n951,n,Menopausal and female climacteric states,Diseases of the genitourinary system,87,70,70,-0.195402299,0,-0.195402299,1203,1297,1342,94,45,139
n952,n,Postmenopausal atrophic vaginitis,Diseases of the genitourinary system,60,48,45,-0.2,-0.0625,-0.25,1494,1589,1701,95,112,207
n959,n,Unspecified menopausal and perimenopausal disorder,Diseases of the genitourinary system,23,18,23,-0.217391304,0.277777778,0,2367,2561,2343,194,-218,-24
n96,n,Recurrent pregnancy loss,Diseases of the genitourinary system,16,13,14,-0.1875,0.076923077,-0.125,2739,2869,2814,130,-55,75
n979,n,"Female infertility, unspecified",Diseases of the genitourinary system,13,11,16,-0.153846154,0.454545455,0.230769231,2925,3000,2682,75,-318,-243
n990,n,Postprocedural (acute) (chronic) kidney failure,Diseases of the genitourinary system,73,69,73,-0.054794521,0.057971014,0,1342,1312,1304,-30,-8,-38
n993,n,Prolapse of vaginal vault after hysterectomy,Diseases of the genitourinary system,62,50,53,-0.193548387,0.06,-0.14516129,1473,1543,1547,70,4,74
n994,n,Postprocedural pelvic peritoneal adhesions,Diseases of the genitourinary system,28,16,20,-0.428571429,0.25,-0.285714286,2172,2690,2462,518,-228,290
n99521,n,Infection of incontinent external stoma of urinary tract,Diseases of the genitourinary system,31,20,15,-0.35483871,-0.25,-0.516129032,2061,2458,2745,397,287,684
n99522,n,Malfunction of incontinent external stoma of urinary tract,Diseases of the genitourinary system,27,24,19,-0.111111111,-0.208333333,-0.296296296,2210,2249,2512,39,263,302
n99528,n,Other complication of incontinent external stoma of urinary tract,Diseases of the genitourinary system,22,18,11,-0.181818182,-0.388888889,-0.5,2409,2557,3002,148,445,593
n9961,n,Intraoperative hemorrhage and hematoma of a genitourinary system organ or structure complicating a genitourinary system procedure,Diseases of the genitourinary system,22,12,13,-0.454545455,0.083333333,-0.409090909,2409,2936,2875,527,-61,466
n9971,n,Accidental puncture and laceration of a genitourinary system organ or structure during a genitourinary system procedure,Diseases of the genitourinary system,58,49,63,-0.155172414,0.285714286,0.086206897,1529,1564,1412,35,-152,-117
n9972,n,Accidental puncture and laceration of a genitourinary system organ or structure during other procedure,Diseases of the genitourinary system,29,17,25,-0.413793103,0.470588235,-0.137931034,2135,2626,2257,491,-369,122
n99820,n,Postprocedural hemorrhage of a genitourinary system organ or structure following a genitourinary system procedure,Diseases of the genitourinary system,77,68,74,-0.116883117,0.088235294,-0.038961039,1297,1323,1291,26,-32,-6
n99840,n,Postprocedural hematoma of a genitourinary system organ or structure following a genitourinary system procedure,Diseases of the genitourinary system,81,69,67,-0.148148148,-0.028985507,-0.172839506,1261,1312,1359,51,47,98
n99841,n,Postprocedural hematoma of a genitourinary system organ or structure following other procedure,Diseases of the genitourinary system,13,13,16,0,0.230769231,0.230769231,2914,2859,2674,-55,-185,-240
n9989,n,Other postprocedural complications and disorders of genitourinary system,Diseases of the genitourinary system,83,67,47,-0.192771084,-0.298507463,-0.43373494,1242,1332,1656,90,324,414
o00101,o,Right tubal pregnancy without intrauterine pregnancy,"Pregnancy, childbirth and the puerperium",10,17,15,0.7,-0.117647059,0.5,3067,2623,2738,-444,115,-329
o0090,o,Unspecified ectopic pregnancy without intrauterine pregnancy,"Pregnancy, childbirth and the puerperium",18,20,16,0.111111111,-0.2,-0.111111111,2619,2453,2673,-166,220,54
o021,o,Missed abortion,"Pregnancy, childbirth and the puerperium",107,137,132,0.280373832,-0.03649635,0.23364486,1078,891,921,-187,30,-157
o034,o,Incomplete spontaneous abortion without complication,"Pregnancy, childbirth and the puerperium",33,32,25,-0.03030303,-0.21875,-0.242424242,1992,1945,2253,-47,308,261
o039,o,Complete or unspecified spontaneous abortion without complication,"Pregnancy, childbirth and the puerperium",40,26,32,-0.35,0.230769231,-0.2,1825,2160,2013,335,-147,188
o081,o,Delayed or excessive hemorrhage following ectopic and molar pregnancy,"Pregnancy, childbirth and the puerperium",17,15,10,-0.117647059,-0.333333333,-0.411764706,2668,2723,3038,55,315,370
o09213,o,"Supervision of pregnancy with history of pre-term labor, third trimester","Pregnancy, childbirth and the puerperium",65,21,41,-0.676923077,0.952380952,-0.369230769,1427,2397,1778,970,-619,351
o09293,o,"Supervision of pregnancy with other poor reproductive or obstetric history, third trimester","Pregnancy, childbirth and the puerperium",115,73,74,-0.365217391,0.01369863,-0.356521739,1036,1265,1290,229,25,254
o0932,o,"Supervision of pregnancy with insufficient antenatal care, second trimester","Pregnancy, childbirth and the puerperium",15,12,16,-0.2,0.333333333,0.066666667,2785,2922,2668,137,-254,-117
o0933,o,"Supervision of pregnancy with insufficient antenatal care, third trimester","Pregnancy, childbirth and the puerperium",130,101,117,-0.223076923,0.158415842,-0.1,950,1050,998,100,-52,48
o0943,o,"Supervision of pregnancy with grand multiparity, third trimester","Pregnancy, childbirth and the puerperium",80,59,72,-0.2625,0.220338983,-0.1,1269,1425,1307,156,-118,38
o09513,o,"Supervision of elderly primigravida, third trimester","Pregnancy, childbirth and the puerperium",77,53,52,-0.311688312,-0.018867925,-0.324675325,1291,1493,1558,202,65,267
o09522,o,"Supervision of elderly multigravida, second trimester","Pregnancy, childbirth and the puerperium",41,43,32,0.048780488,-0.255813953,-0.219512195,1798,1668,2008,-130,340,210
o09523,o,"Supervision of elderly multigravida, third trimester","Pregnancy, childbirth and the puerperium",486,344,394,-0.29218107,0.145348837,-0.189300412,445,525,506,80,-19,61
o09813,o,"Supervision of pregnancy resulting from assisted reproductive technology, third trimester","Pregnancy, childbirth and the puerperium",20,33,10,0.65,-0.696969697,-0.5,2492,1909,3030,-583,1121,538
o09893,o,"Supervision of other high risk pregnancies, third trimester","Pregnancy, childbirth and the puerperium",172,84,118,-0.511627907,0.404761905,-0.313953488,810,1164,993,354,-171,183
o10013,o,"Pre-existing essential hypertension complicating pregnancy, third trimester","Pregnancy, childbirth and the puerperium",53,34,30,-0.358490566,-0.117647059,-0.433962264,1579,1870,2068,291,198,489
o1002,o,Pre-existing essential hypertension complicating childbirth,"Pregnancy, childbirth and the puerperium",252,249,266,-0.011904762,0.068273092,0.055555556,669,642,643,-27,1,-26
o1022,o,Pre-existing hypertensive chronic kidney disease complicating childbirth,"Pregnancy, childbirth and the puerperium",14,18,15,0.285714286,-0.166666667,0.071428571,2831,2538,2723,-293,185,-108
o10912,o,"Unspecified pre-existing hypertension complicating pregnancy, second trimester","Pregnancy, childbirth and the puerperium",21,37,22,0.761904762,-0.405405405,0.047619048,2438,1807,2362,-631,555,-76
o10913,o,"Unspecified pre-existing hypertension complicating pregnancy, third trimester","Pregnancy, childbirth and the puerperium",93,75,103,-0.193548387,0.373333333,0.107526882,1150,1237,1067,87,-170,-83
o1092,o,Unspecified pre-existing hypertension complicating childbirth,"Pregnancy, childbirth and the puerperium",383,366,447,-0.044386423,0.221311475,0.167101828,509,509,467,0,-42,-42
o1093,o,Unspecified pre-existing hypertension complicating the puerperium,"Pregnancy, childbirth and the puerperium",23,13,16,-0.434782609,0.230769231,-0.304347826,2342,2837,2657,495,-180,315
o113,o,"Pre-existing hypertension with pre-eclampsia, third trimester","Pregnancy, childbirth and the puerperium",51,38,54,-0.254901961,0.421052632,0.058823529,1611,1782,1520,171,-262,-91
o114,o,"Pre-existing hypertension with pre-eclampsia, complicating childbirth","Pregnancy, childbirth and the puerperium",230,232,229,0.008695652,-0.012931034,-0.004347826,700,675,695,-25,20,-5
o115,o,"Pre-existing hypertension with pre-eclampsia, complicating the puerperium","Pregnancy, childbirth and the puerperium",20,21,20,0.05,-0.047619048,0,2483,2382,2439,-101,57,-44
o1203,o,"Gestational edema, third trimester","Pregnancy, childbirth and the puerperium",19,12,13,-0.368421053,0.083333333,-0.315789474,2533,2905,2845,372,-60,312
o1204,o,"Gestational edema, complicating childbirth","Pregnancy, childbirth and the puerperium",47,43,41,-0.085106383,-0.046511628,-0.127659574,1673,1662,1767,-11,105,94
o1205,o,"Gestational edema, complicating the puerperium","Pregnancy, childbirth and the puerperium",31,27,17,-0.129032258,-0.37037037,-0.451612903,2039,2099,2599,60,500,560
o1213,o,"Gestational proteinuria, third trimester","Pregnancy, childbirth and the puerperium",21,19,10,-0.095238095,-0.473684211,-0.523809524,2431,2477,3016,46,539,585
o1214,o,"Gestational proteinuria, complicating childbirth","Pregnancy, childbirth and the puerperium",88,91,72,0.034090909,-0.208791209,-0.181818182,1186,1110,1301,-76,191,115
o133,o,"Gestational [pregnancy-induced] hypertension without significant proteinuria, third trimester","Pregnancy, childbirth and the puerperium",260,220,410,-0.153846154,0.863636364,0.576923077,652,696,495,44,-201,-157
o134,o,"Gestational [pregnancy-induced] hypertension without significant proteinuria, complicating childbirth","Pregnancy, childbirth and the puerperium",1609,1588,1697,-0.013051585,0.068639798,0.054692356,188,191,185,3,-6,-3
o135,o,"Gestational [pregnancy-induced] hypertension without significant proteinuria, complicating the puerperium","Pregnancy, childbirth and the puerperium",81,70,66,-0.135802469,-0.057142857,-0.185185185,1248,1285,1360,37,75,112
o139,o,"Gestational [pregnancy-induced] hypertension without significant proteinuria, unspecified trimester","Pregnancy, childbirth and the puerperium",20,19,17,-0.05,-0.105263158,-0.15,2476,2473,2595,-3,122,119
o1403,o,"Mild to moderate pre-eclampsia, third trimester","Pregnancy, childbirth and the puerperium",74,84,67,0.135135135,-0.202380952,-0.094594595,1312,1158,1346,-154,188,34
o1404,o,"Mild to moderate pre-eclampsia, complicating childbirth","Pregnancy, childbirth and the puerperium",314,336,368,0.070063694,0.095238095,0.171974522,581,531,524,-50,-7,-57
o1405,o,"Mild to moderate pre-eclampsia, complicating the puerperium","Pregnancy, childbirth and the puerperium",13,17,22,0.307692308,0.294117647,0.692307692,2877,2591,2351,-286,-240,-526
o1413,o,"Severe pre-eclampsia, third trimester","Pregnancy, childbirth and the puerperium",103,79,82,-0.233009709,0.037974684,-0.203883495,1083,1193,1207,110,14,124
o1414,o,Severe pre-eclampsia complicating childbirth,"Pregnancy, childbirth and the puerperium",505,509,603,0.007920792,0.184675835,0.194059406,434,417,379,-17,-38,-55
o1415,o,"Severe pre-eclampsia, complicating the puerperium","Pregnancy, childbirth and the puerperium",115,90,120,-0.217391304,0.333333333,0.043478261,1026,1110,971,84,-139,-55
o1424,o,"HELLP syndrome, complicating childbirth","Pregnancy, childbirth and the puerperium",68,50,56,-0.264705882,0.12,-0.176470588,1367,1520,1474,153,-46,107
o1493,o,"Unspecified pre-eclampsia, third trimester","Pregnancy, childbirth and the puerperium",108,94,102,-0.12962963,0.085106383,-0.055555556,1057,1088,1067,31,-21,10
o1494,o,"Unspecified pre-eclampsia, complicating childbirth","Pregnancy, childbirth and the puerperium",410,378,321,-0.07804878,-0.150793651,-0.217073171,489,497,568,8,71,79
o1495,o,"Unspecified pre-eclampsia, complicating the puerperium","Pregnancy, childbirth and the puerperium",89,75,80,-0.157303371,0.066666667,-0.101123596,1169,1225,1221,56,-4,52
o151,o,Eclampsia complicating labor,"Pregnancy, childbirth and the puerperium",13,14,23,0.076923077,0.642857143,0.769230769,2870,2756,2305,-114,-451,-565
o163,o,"Unspecified maternal hypertension, third trimester","Pregnancy, childbirth and the puerperium",59,42,53,-0.288135593,0.261904762,-0.101694915,1482,1669,1520,187,-149,38
o164,o,"Unspecified maternal hypertension, complicating childbirth","Pregnancy, childbirth and the puerperium",197,183,208,-0.07106599,0.136612022,0.055837563,751,755,725,4,-30,-26
o165,o,"Unspecified maternal hypertension, complicating the puerperium","Pregnancy, childbirth and the puerperium",54,45,71,-0.166666667,0.577777778,0.314814815,1550,1605,1309,55,-296,-241
o208,o,Other hemorrhage in early pregnancy,"Pregnancy, childbirth and the puerperium",20,20,22,0,0.1,0.1,2464,2415,2340,-49,-75,-124
o209,o,"Hemorrhage in early pregnancy, unspecified","Pregnancy, childbirth and the puerperium",16,17,16,0.0625,-0.058823529,0,2682,2580,2632,-102,52,-50
o210,o,Mild hyperemesis gravidarum,"Pregnancy, childbirth and the puerperium",164,110,129,-0.329268293,0.172727273,-0.213414634,819,992,924,173,-68,105
o211,o,Hyperemesis gravidarum with metabolic disturbance,"Pregnancy, childbirth and the puerperium",68,70,77,0.029411765,0.1,0.132352941,1362,1275,1248,-87,-27,-114
o212,o,Late vomiting of pregnancy,"Pregnancy, childbirth and the puerperium",68,39,68,-0.426470588,0.743589744,0,1362,1740,1327,378,-413,-35
o219,o,"Vomiting of pregnancy, unspecified","Pregnancy, childbirth and the puerperium",40,34,57,-0.15,0.676470588,0.425,1791,1844,1450,53,-394,-341
o2243,o,"Hemorrhoids in pregnancy, third trimester","Pregnancy, childbirth and the puerperium",90,64,60,-0.288888889,-0.0625,-0.333333333,1162,1341,1412,179,71,250
o2301,o,"Infections of kidney in pregnancy, first trimester","Pregnancy, childbirth and the puerperium",14,17,16,0.214285714,-0.058823529,0.142857143,2796,2575,2627,-221,52,-169
o2302,o,"Infections of kidney in pregnancy, second trimester","Pregnancy, childbirth and the puerperium",81,77,96,-0.049382716,0.246753247,0.185185185,1238,1201,1106,-37,-95,-132
o2303,o,"Infections of kidney in pregnancy, third trimester","Pregnancy, childbirth and the puerperium",75,69,77,-0.08,0.115942029,0.026666667,1285,1287,1247,2,-40,-38
o2313,o,"Infections of bladder in pregnancy, third trimester","Pregnancy, childbirth and the puerperium",16,11,16,-0.3125,0.454545455,0,2675,2928,2625,253,-303,-50
o2341,o,"Unspecified infection of urinary tract in pregnancy, first trimester","Pregnancy, childbirth and the puerperium",33,22,28,-0.333333333,0.272727273,-0.151515152,1953,2301,2102,348,-199,149
o2342,o,"Unspecified infection of urinary tract in pregnancy, second trimester","Pregnancy, childbirth and the puerperium",58,53,55,-0.086206897,0.037735849,-0.051724138,1493,1469,1483,-24,14,-10
o2343,o,"Unspecified infection of urinary tract in pregnancy, third trimester","Pregnancy, childbirth and the puerperium",218,207,202,-0.050458716,-0.024154589,-0.073394495,720,714,733,-6,19,13
o23592,o,"Infection of other part of genital tract in pregnancy, second trimester","Pregnancy, childbirth and the puerperium",23,24,26,0.043478261,0.083333333,0.130434783,2312,2200,2172,-112,-28,-140
o23593,o,"Infection of other part of genital tract in pregnancy, third trimester","Pregnancy, childbirth and the puerperium",65,50,33,-0.230769231,-0.34,-0.492307692,1396,1509,1942,113,433,546
o24013,o,"Pre-existing type 1 diabetes mellitus, in pregnancy, third trimester","Pregnancy, childbirth and the puerperium",17,20,30,0.176470588,0.5,0.764705882,2616,2403,2036,-213,-367,-580
o2402,o,"Pre-existing type 1 diabetes mellitus, in childbirth","Pregnancy, childbirth and the puerperium",76,101,101,0.328947368,0,0.328947368,1273,1038,1069,-235,31,-204
o24112,o,"Pre-existing type 2 diabetes mellitus, in pregnancy, second trimester","Pregnancy, childbirth and the puerperium",16,18,25,0.125,0.388888889,0.5625,2668,2497,2207,-171,-290,-461
o24113,o,"Pre-existing type 2 diabetes mellitus, in pregnancy, third trimester","Pregnancy, childbirth and the puerperium",76,52,47,-0.315789474,-0.096153846,-0.381578947,1273,1482,1618,209,136,345
o2412,o,"Pre-existing type 2 diabetes mellitus, in childbirth","Pregnancy, childbirth and the puerperium",314,239,277,-0.238853503,0.158995816,-0.117834395,579,656,619,77,-37,40
o2432,o,Unspecified pre-existing diabetes mellitus in childbirth,"Pregnancy, childbirth and the puerperium",24,27,31,0.125,0.148148148,0.291666667,2271,2070,2005,-201,-65,-266
o24410,o,"Gestational diabetes mellitus in pregnancy, diet controlled","Pregnancy, childbirth and the puerperium",183,150,229,-0.180327869,0.526666667,0.25136612,772,834,689,62,-145,-83
o24414,o,"Gestational diabetes mellitus in pregnancy, insulin controlled","Pregnancy, childbirth and the puerperium",71,70,87,-0.014084507,0.242857143,0.225352113,1325,1270,1160,-55,-110,-165
o24415,o,"Gestational diabetes mellitus in pregnancy, controlled by oral hypoglycemic drugs","Pregnancy, childbirth and the puerperium",108,77,86,-0.287037037,0.116883117,-0.203703704,1051,1197,1163,146,-34,112
o24419,o,"Gestational diabetes mellitus in pregnancy, unspecified control","Pregnancy, childbirth and the puerperium",101,100,136,-0.00990099,0.36,0.346534653,1086,1039,889,-47,-150,-197
o24420,o,"Gestational diabetes mellitus in childbirth, diet controlled","Pregnancy, childbirth and the puerperium",1320,1174,1626,-0.110606061,0.385008518,0.231818182,221,230,196,9,-34,-25
o24424,o,"Gestational diabetes mellitus in childbirth, insulin controlled","Pregnancy, childbirth and the puerperium",501,475,547,-0.051896208,0.151578947,0.091816367,433,432,412,-1,-20,-21
o24425,o,"Gestational diabetes mellitus in childbirth, controlled by oral hypoglycemic drugs","Pregnancy, childbirth and the puerperium",542,456,568,-0.158671587,0.245614035,0.04797048,417,450,399,33,-51,-18
o24429,o,"Gestational diabetes mellitus in childbirth, unspecified control","Pregnancy, childbirth and the puerperium",574,560,641,-0.024390244,0.144642857,0.116724739,392,387,367,-5,-20,-25
o2492,o,Unspecified diabetes mellitus in childbirth,"Pregnancy, childbirth and the puerperium",39,72,76,0.846153846,0.055555556,0.948717949,1800,1248,1243,-552,-5,-557
o2603,o,"Excessive weight gain in pregnancy, third trimester","Pregnancy, childbirth and the puerperium",107,138,146,0.289719626,0.057971014,0.364485981,1054,870,848,-184,-22,-206
o2613,o,"Low weight gain in pregnancy, third trimester","Pregnancy, childbirth and the puerperium",17,14,15,-0.176470588,0.071428571,-0.117647059,2602,2722,2663,120,-59,61
o2623,o,"Pregnancy care for patient with recurrent pregnancy loss, third trimester","Pregnancy, childbirth and the puerperium",89,60,71,-0.325842697,0.183333333,-0.202247191,1156,1376,1292,220,-84,136
o2653,o,"Maternal hypotension syndrome, third trimester","Pregnancy, childbirth and the puerperium",19,28,29,0.473684211,0.035714286,0.526315789,2485,2024,2039,-461,15,-446
o26612,o,"Liver and biliary tract disorders in pregnancy, second trimester","Pregnancy, childbirth and the puerperium",24,13,24,-0.458333333,0.846153846,0,2260,2778,2240,518,-538,-20
o26613,o,"Liver and biliary tract disorders in pregnancy, third trimester","Pregnancy, childbirth and the puerperium",84,92,103,0.095238095,0.119565217,0.226190476,1198,1089,1048,-109,-41,-150
o2662,o,Liver and biliary tract disorders in childbirth,"Pregnancy, childbirth and the puerperium",399,416,449,0.042606516,0.079326923,0.125313283,494,468,459,-26,-9,-35
o26831,o,"Pregnancy related renal disease, first trimester","Pregnancy, childbirth and the puerperium",12,10,12,-0.166666667,0.2,0,2877,2964,2846,87,-118,-31
o26832,o,"Pregnancy related renal disease, second trimester","Pregnancy, childbirth and the puerperium",27,33,37,0.222222222,0.121212121,0.37037037,2143,1858,1806,-285,-52,-337
o26833,o,"Pregnancy related renal disease, third trimester","Pregnancy, childbirth and the puerperium",111,103,116,-0.072072072,0.126213592,0.045045045,1032,1017,981,-15,-36,-51
o26843,o,"Uterine size-date discrepancy, third trimester","Pregnancy, childbirth and the puerperium",33,11,17,-0.666666667,0.545454545,-0.484848485,1933,2899,2545,966,-354,612
o26853,o,"Spotting complicating pregnancy, third trimester","Pregnancy, childbirth and the puerperium",24,33,24,0.375,-0.272727273,0,2255,1857,2236,-398,379,-19
o2686,o,Pruritic urticarial papules and plaques of pregnancy (PUPPP),"Pregnancy, childbirth and the puerperium",61,40,62,-0.344262295,0.55,0.016393443,1431,1696,1371,265,-325,-60
o26872,o,"Cervical shortening, second trimester","Pregnancy, childbirth and the puerperium",88,89,120,0.011363636,0.348314607,0.363636364,1161,1100,958,-61,-142,-203
o26873,o,"Cervical shortening, third trimester","Pregnancy, childbirth and the puerperium",113,102,94,-0.097345133,-0.078431373,-0.168141593,1025,1021,1106,-4,85,81
o26891,o,"Other specified pregnancy related conditions, first trimester","Pregnancy, childbirth and the puerperium",45,34,47,-0.244444444,0.382352941,0.044444444,1670,1818,1600,148,-218,-70
o26892,o,"Other specified pregnancy related conditions, second trimester","Pregnancy, childbirth and the puerperium",95,99,93,0.042105263,-0.060606061,-0.021052632,1112,1036,1113,-76,77,1
o26893,o,"Other specified pregnancy related conditions, third trimester","Pregnancy, childbirth and the puerperium",1533,1474,1642,-0.038486628,0.113975577,0.071102414,197,198,191,1,-7,-6
o26899,o,"Other specified pregnancy related conditions, unspecified trimester","Pregnancy, childbirth and the puerperium",28,37,40,0.321428571,0.081081081,0.428571429,2096,1755,1737,-341,-18,-359
o282,o,Abnormal cytological finding on antenatal screening of mother,"Pregnancy, childbirth and the puerperium",18,13,13,-0.277777778,0,-0.277777778,2534,2766,2775,232,9,241
o283,o,Abnormal ultrasonic finding on antenatal screening of mother,"Pregnancy, childbirth and the puerperium",14,13,12,-0.071428571,-0.076923077,-0.142857143,2754,2766,2834,12,68,80
o288,o,Other abnormal findings on antenatal screening of mother,"Pregnancy, childbirth and the puerperium",19,24,14,0.263157895,-0.416666667,-0.263157895,2471,2171,2708,-300,537,237
o30003,o,"Twin pregnancy, unspecified number of placenta and unspecified number of amniotic sacs, third trimester","Pregnancy, childbirth and the puerperium",40,35,30,-0.125,-0.142857143,-0.25,1763,1795,2010,32,215,247
o30032,o,"Twin pregnancy, monochorionic/diamniotic, second trimester","Pregnancy, childbirth and the puerperium",21,15,11,-0.285714286,-0.266666667,-0.476190476,2373,2637,2895,264,258,522
o30033,o,"Twin pregnancy, monochorionic/diamniotic, third trimester","Pregnancy, childbirth and the puerperium",119,99,114,-0.168067227,0.151515152,-0.042016807,991,1035,990,44,-45,-1
o30042,o,"Twin pregnancy, dichorionic/diamniotic, second trimester","Pregnancy, childbirth and the puerperium",53,51,49,-0.037735849,-0.039215686,-0.075471698,1528,1473,1555,-55,82,27
o30043,o,"Twin pregnancy, dichorionic/diamniotic, third trimester","Pregnancy, childbirth and the puerperium",459,423,413,-0.078431373,-0.023640662,-0.100217865,453,463,485,10,22,32
o320xx0,o,"Maternal care for unstable lie, not applicable or unspecified","Pregnancy, childbirth and the puerperium",85,85,110,0,0.294117647,0.294117647,1181,1123,1014,-58,-109,-167
o321xx0,o,"Maternal care for breech presentation, not applicable or unspecified","Pregnancy, childbirth and the puerperium",1128,1087,1163,-0.036347518,0.069917203,0.031028369,243,241,236,-2,-5,-7
o321xx1,o,"Maternal care for breech presentation, fetus 1","Pregnancy, childbirth and the puerperium",93,104,121,0.11827957,0.163461538,0.301075269,1120,1012,949,-108,-63,-171
o321xx2,o,"Maternal care for breech presentation, fetus 2","Pregnancy, childbirth and the puerperium",143,109,143,-0.237762238,0.311926606,0,879,983,852,104,-131,-27
o322xx0,o,"Maternal care for transverse and oblique lie, not applicable or unspecified","Pregnancy, childbirth and the puerperium",166,147,187,-0.114457831,0.272108844,0.126506024,804,836,752,32,-84,-52
o322xx2,o,"Maternal care for transverse and oblique lie, fetus 2","Pregnancy, childbirth and the puerperium",42,44,56,0.047619048,0.272727273,0.333333333,1709,1595,1433,-114,-162,-276
o323xx0,o,"Maternal care for face, brow and chin presentation, not applicable or unspecified","Pregnancy, childbirth and the puerperium",25,29,34,0.16,0.172413793,0.36,2198,1961,1873,-237,-88,-325
o324xx0,o,"Maternal care for high head at term, not applicable or unspecified","Pregnancy, childbirth and the puerperium",302,227,238,-0.248344371,0.04845815,-0.21192053,590,670,669,80,-1,79
o326xx0,o,"Maternal care for compound presentation, not applicable or unspecified","Pregnancy, childbirth and the puerperium",95,108,141,0.136842105,0.305555556,0.484210526,1105,987,856,-118,-131,-249
o328xx0,o,"Maternal care for other malpresentation of fetus, not applicable or unspecified","Pregnancy, childbirth and the puerperium",207,199,260,-0.038647343,0.306532663,0.256038647,729,718,635,-11,-83,-94
o328xx1,o,"Maternal care for other malpresentation of fetus, fetus 1","Pregnancy, childbirth and the puerperium",12,11,18,-0.083333333,0.636363636,0.5,2848,2873,2465,25,-408,-383
o328xx2,o,"Maternal care for other malpresentation of fetus, fetus 2","Pregnancy, childbirth and the puerperium",42,23,36,-0.452380952,0.565217391,-0.142857143,1706,2202,1801,496,-401,95
o329xx0,o,"Maternal care for malpresentation of fetus, unspecified, not applicable or unspecified","Pregnancy, childbirth and the puerperium",30,29,56,-0.033333333,0.931034483,0.866666667,2009,1958,1430,-51,-528,-579
o339,o,"Maternal care for disproportion, unspecified","Pregnancy, childbirth and the puerperium",171,131,125,-0.233918129,-0.045801527,-0.269005848,792,890,925,98,35,133
o3403,o,"Maternal care for unspecified congenital malformation of uterus, third trimester","Pregnancy, childbirth and the puerperium",168,139,148,-0.172619048,0.064748201,-0.119047619,795,860,835,65,-25,40
o3412,o,"Maternal care for benign tumor of corpus uteri, second trimester","Pregnancy, childbirth and the puerperium",16,20,21,0.25,0.05,0.3125,2617,2356,2310,-261,-46,-307
o3413,o,"Maternal care for benign tumor of corpus uteri, third trimester","Pregnancy, childbirth and the puerperium",450,419,424,-0.068888889,0.011933174,-0.057777778,456,464,472,8,8,16
o34211,o,Maternal care for low transverse scar from previous cesarean delivery,"Pregnancy, childbirth and the puerperium",4382,4165,4800,-0.049520767,0.152460984,0.095390233,84,85,82,1,-3,-2
o34212,o,Maternal care for vertical scar from previous cesarean delivery,"Pregnancy, childbirth and the puerperium",74,69,97,-0.067567568,0.405797101,0.310810811,1266,1253,1071,-13,-182,-195
o34219,o,Maternal care for unspecified type scar from previous cesarean delivery,"Pregnancy, childbirth and the puerperium",1356,1100,829,-0.18879056,-0.246363636,-0.388643068,213,235,300,22,65,87
o3429,o,Maternal care due to uterine scar from other previous surgery,"Pregnancy, childbirth and the puerperium",107,99,111,-0.074766355,0.121212121,0.037383178,1038,1022,990,-16,-32,-48
o3432,o,"Maternal care for cervical incompetence, second trimester","Pregnancy, childbirth and the puerperium",85,77,86,-0.094117647,0.116883117,0.011764706,1168,1168,1133,0,-35,-35
o3433,o,"Maternal care for cervical incompetence, third trimester","Pregnancy, childbirth and the puerperium",129,127,143,-0.015503876,0.125984252,0.108527132,923,899,845,-24,-54,-78
o3443,o,"Maternal care for other abnormalities of cervix, third trimester","Pregnancy, childbirth and the puerperium",65,78,57,0.2,-0.269230769,-0.123076923,1357,1157,1406,-200,249,49
o34593,o,"Maternal care for other abnormalities of gravid uterus, third trimester","Pregnancy, childbirth and the puerperium",57,30,17,-0.473684211,-0.433333333,-0.701754386,1460,1917,2509,457,592,1049
o3463,o,"Maternal care for abnormality of vagina, third trimester","Pregnancy, childbirth and the puerperium",29,14,30,-0.517241379,1.142857143,0.034482759,2036,2678,1985,642,-693,-51
o3473,o,"Maternal care for abnormality of vulva and perineum, third trimester","Pregnancy, childbirth and the puerperium",19,13,18,-0.315789474,0.384615385,-0.052631579,2442,2735,2451,293,-284,9
o3483,o,"Maternal care for other abnormalities of pelvic organs, third trimester","Pregnancy, childbirth and the puerperium",228,236,227,0.035087719,-0.038135593,-0.004385965,686,651,678,-35,27,-8
o350xx0,o,"Maternal care for (suspected) central nervous system malformation in fetus, not applicable or unspecified","Pregnancy, childbirth and the puerperium",43,36,34,-0.162790698,-0.055555556,-0.209302326,1679,1751,1857,72,106,178
o351xx0,o,"Maternal care for (suspected) chromosomal abnormality in fetus, not applicable or unspecified","Pregnancy, childbirth and the puerperium",51,42,52,-0.176470588,0.238095238,0.019607843,1541,1615,1482,74,-133,-59
o358xx0,o,"Maternal care for other (suspected) fetal abnormality and damage, not applicable or unspecified","Pregnancy, childbirth and the puerperium",402,377,444,-0.062189055,0.177718833,0.104477612,485,488,456,3,-32,-29
o359xx0,o,"Maternal care for (suspected) fetal abnormality and damage, unspecified, not applicable or unspecified","Pregnancy, childbirth and the puerperium",39,30,36,-0.230769231,0.2,-0.076923077,1760,1913,1787,153,-126,27
o360130,o,"Maternal care for anti-D [Rh] antibodies, third trimester, not applicable or unspecified","Pregnancy, childbirth and the puerperium",33,21,24,-0.363636364,0.142857143,-0.272727273,1897,2291,2197,394,-94,300
o360930,o,"Maternal care for other rhesus isoimmunization, third trimester, not applicable or unspecified","Pregnancy, childbirth and the puerperium",174,106,103,-0.390804598,-0.028301887,-0.408045977,773,986,1025,213,39,252
o361930,o,"Maternal care for other isoimmunization, third trimester, not applicable or unspecified","Pregnancy, childbirth and the puerperium",25,21,26,-0.16,0.238095238,0.04,2174,2290,2110,116,-180,-64
o364xx0,o,"Maternal care for intrauterine death, not applicable or unspecified","Pregnancy, childbirth and the puerperium",174,157,172,-0.097701149,0.095541401,-0.011494253,773,800,774,27,-26,1
o365920,o,"Maternal care for other known or suspected poor fetal growth, second trimester, not applicable or unspecified","Pregnancy, childbirth and the puerperium",48,32,41,-0.333333333,0.28125,-0.145833333,1584,1848,1691,264,-157,107
o365930,o,"Maternal care for other known or suspected poor fetal growth, third trimester, not applicable or unspecified","Pregnancy, childbirth and the puerperium",1060,1050,1145,-0.009433962,0.09047619,0.080188679,249,248,240,-1,-8,-9
o365931,o,"Maternal care for other known or suspected poor fetal growth, third trimester, fetus 1","Pregnancy, childbirth and the puerperium",47,45,38,-0.042553191,-0.155555556,-0.191489362,1598,1550,1751,-48,201,153
o365932,o,"Maternal care for other known or suspected poor fetal growth, third trimester, fetus 2","Pregnancy, childbirth and the puerperium",28,38,36,0.357142857,-0.052631579,0.285714286,2058,1704,1782,-354,78,-276
o365990,o,"Maternal care for other known or suspected poor fetal growth, unspecified trimester, not applicable or unspecified","Pregnancy, childbirth and the puerperium",35,33,15,-0.057142857,-0.545454545,-0.571428571,1838,1818,2603,-20,785,765
o3660x0,o,"Maternal care for excessive fetal growth, unspecified trimester, not applicable or unspecified","Pregnancy, childbirth and the puerperium",32,19,26,-0.40625,0.368421053,-0.1875,1923,2376,2105,453,-271,182
o3663x0,o,"Maternal care for excessive fetal growth, third trimester, not applicable or unspecified","Pregnancy, childbirth and the puerperium",1015,1026,1129,0.010837438,0.100389864,0.112315271,257,253,242,-4,-11,-15
o368130,o,"Decreased fetal movements, third trimester, not applicable or unspecified","Pregnancy, childbirth and the puerperium",579,442,510,-0.236614853,0.153846154,-0.119170984,383,448,422,65,-26,39
o368190,o,"Decreased fetal movements, unspecified trimester, not applicable or unspecified","Pregnancy, childbirth and the puerperium",34,29,28,-0.147058824,-0.034482759,-0.176470588,1858,1933,2031,75,98,173
o368320,o,"Maternal care for abnormalities of the fetal heart rate or rhythm, second trimester, not applicable or unspecified","Pregnancy, childbirth and the puerperium",10,14,15,0.4,0.071428571,0.5,2916,2660,2599,-256,-61,-317
o368330,o,"Maternal care for abnormalities of the fetal heart rate or rhythm, third trimester, not applicable or unspecified","Pregnancy, childbirth and the puerperium",380,465,368,0.223684211,-0.208602151,-0.031578947,496,435,508,-61,73,12
o368930,o,"Maternal care for other specified fetal problems, third trimester, not applicable or unspecified","Pregnancy, childbirth and the puerperium",23,29,23,0.260869565,-0.206896552,0,2235,1932,2214,-303,282,-21
o403xx0,o,"Polyhydramnios, third trimester, not applicable or unspecified","Pregnancy, childbirth and the puerperium",590,542,595,-0.081355932,0.097785978,0.008474576,378,387,376,9,-11,-2
o4100x0,o,"Oligohydramnios, unspecified trimester, not applicable or unspecified","Pregnancy, childbirth and the puerperium",18,19,18,0.055555556,-0.052631579,0,2482,2370,2431,-112,61,-51
o4102x0,o,"Oligohydramnios, second trimester, not applicable or unspecified","Pregnancy, childbirth and the puerperium",29,40,35,0.379310345,-0.125,0.206896552,2018,1659,1813,-359,154,-205
o4103x0,o,"Oligohydramnios, third trimester, not applicable or unspecified","Pregnancy, childbirth and the puerperium",838,740,844,-0.116945107,0.140540541,0.007159905,301,318,294,17,-24,-7
o411030,o,"Infection of amniotic sac and membranes, unspecified, third trimester, not applicable or unspecified","Pregnancy, childbirth and the puerperium",17,15,16,-0.117647059,0.066666667,-0.058823529,2530,2586,2534,56,-52,4
o411220,o,"Chorioamnionitis, second trimester, not applicable or unspecified","Pregnancy, childbirth and the puerperium",43,54,35,0.255813953,-0.351851852,-0.186046512,1667,1405,1812,-262,407,145
o411230,o,"Chorioamnionitis, third trimester, not applicable or unspecified","Pregnancy, childbirth and the puerperium",859,689,840,-0.19790454,0.2191582,-0.022118743,294,342,295,48,-47,1
o4200,o,"Premature rupture of membranes, onset of labor within 24 hours of rupture, unspecified weeks of gestation","Pregnancy, childbirth and the puerperium",13,11,12,-0.153846154,0.090909091,-0.076923077,2757,2829,2774,72,-55,17
o42012,o,"Preterm premature rupture of membranes, onset of labor within 24 hours of rupture, second trimester","Pregnancy, childbirth and the puerperium",21,21,26,0,0.238095238,0.238095238,2321,2274,2096,-47,-178,-225
o42013,o,"Preterm premature rupture of membranes, onset of labor within 24 hours of rupture, third trimester","Pregnancy, childbirth and the puerperium",339,292,277,-0.138643068,-0.051369863,-0.182890855,526,564,600,38,36,74
o4202,o,"Full-term premature rupture of membranes, onset of labor within 24 hours of rupture","Pregnancy, childbirth and the puerperium",1563,1437,1315,-0.080614203,-0.084899095,-0.158669226,192,200,219,8,19,27
o42112,o,"Preterm premature rupture of membranes, onset of labor more than 24 hours following rupture, second trimester","Pregnancy, childbirth and the puerperium",32,27,39,-0.15625,0.444444444,0.21875,1913,1996,1717,83,-279,-196
o42113,o,"Preterm premature rupture of membranes, onset of labor more than 24 hours following rupture, third trimester","Pregnancy, childbirth and the puerperium",89,80,72,-0.101123596,-0.1,-0.191011236,1122,1137,1235,15,98,113
o4212,o,"Full-term premature rupture of membranes, onset of labor more than 24 hours following rupture","Pregnancy, childbirth and the puerperium",135,119,111,-0.118518519,-0.067226891,-0.177777778,888,920,977,32,57,89
o4290,o,"Premature rupture of membranes, unspecified as to length of time between rupture and onset of labor, unspecified weeks of gestation","Pregnancy, childbirth and the puerperium",55,51,49,-0.072727273,-0.039215686,-0.109090909,1470,1438,1518,-32,80,48
o42912,o,"Preterm premature rupture of membranes, unspecified as to length of time between rupture and onset of labor, second trimester","Pregnancy, childbirth and the puerperium",105,73,81,-0.304761905,0.109589041,-0.228571429,1031,1192,1154,161,-38,123
o42913,o,"Preterm premature rupture of membranes, unspecified as to length of time between rupture and onset of labor, third trimester","Pregnancy, childbirth and the puerperium",477,413,443,-0.134171908,0.072639225,-0.071278826,432,458,450,26,-8,18
o42919,o,"Preterm premature rupture of membranes, unspecified as to length of time between rupture and onset of labor, unspecified trimester","Pregnancy, childbirth and the puerperium",24,30,43,0.25,0.433333333,0.791666667,2188,1891,1638,-297,-253,-550
o4292,o,"Full-term premature rupture of membranes, unspecified as to length of time between rupture and onset of labor","Pregnancy, childbirth and the puerperium",1029,1082,1247,0.051506317,0.152495379,0.211856171,253,241,229,-12,-12,-24
o43113,o,"Circumvallate placenta, third trimester","Pregnancy, childbirth and the puerperium",29,18,24,-0.379310345,0.333333333,-0.172413793,2006,2404,2169,398,-235,163
o43123,o,"Velamentous insertion of umbilical cord, third trimester","Pregnancy, childbirth and the puerperium",131,142,133,0.083969466,-0.063380282,0.015267176,898,834,868,-64,34,-30
o43193,o,"Other malformation of placenta, third trimester","Pregnancy, childbirth and the puerperium",130,124,163,-0.046153846,0.314516129,0.253846154,901,895,782,-6,-113,-119
o43213,o,"Placenta accreta, third trimester","Pregnancy, childbirth and the puerperium",47,34,34,-0.276595745,0,-0.276595745,1582,1765,1828,183,63,246
o43893,o,"Other placental disorders, third trimester","Pregnancy, childbirth and the puerperium",35,45,43,0.285714286,-0.044444444,0.228571429,1820,1533,1635,-287,102,-185
o4403,o,"Complete placenta previa NOS or without hemorrhage, third trimester","Pregnancy, childbirth and the puerperium",100,82,71,-0.18,-0.134146341,-0.29,1048,1119,1246,71,127,198
o4412,o,"Complete placenta previa with hemorrhage, second trimester","Pregnancy, childbirth and the puerperium",16,13,17,-0.1875,0.307692308,0.0625,2562,2690,2465,128,-225,-97
o4413,o,"Complete placenta previa with hemorrhage, third trimester","Pregnancy, childbirth and the puerperium",62,55,61,-0.112903226,0.109090909,-0.016129032,1375,1380,1336,5,-44,-39
o4423,o,"Partial placenta previa NOS or without hemorrhage, third trimester","Pregnancy, childbirth and the puerperium",25,20,14,-0.2,-0.3,-0.44,2142,2306,2630,164,324,488
o4443,o,"Low lying placenta NOS or without hemorrhage, third trimester","Pregnancy, childbirth and the puerperium",52,50,57,-0.038461538,0.14,0.096153846,1500,1443,1384,-57,-59,-116
o458x3,o,"Other premature separation of placenta, third trimester","Pregnancy, childbirth and the puerperium",15,15,18,0,0.2,0.2,2619,2564,2408,-55,-156,-211
o4592,o,"Premature separation of placenta, unspecified, second trimester","Pregnancy, childbirth and the puerperium",30,35,48,0.166666667,0.371428571,0.6,1961,1742,1530,-219,-212,-431
o4593,o,"Premature separation of placenta, unspecified, third trimester","Pregnancy, childbirth and the puerperium",304,294,346,-0.032894737,0.176870748,0.138157895,572,556,517,-16,-39,-55
o4692,o,"Antepartum hemorrhage, unspecified, second trimester","Pregnancy, childbirth and the puerperium",40,39,38,-0.025,-0.025641026,-0.05,1708,1660,1727,-48,67,19
o4693,o,"Antepartum hemorrhage, unspecified, third trimester","Pregnancy, childbirth and the puerperium",127,88,117,-0.307086614,0.329545455,-0.078740157,913,1069,942,156,-127,29
o4703,o,"False labor before 37 completed weeks of gestation, third trimester","Pregnancy, childbirth and the puerperium",49,35,50,-0.285714286,0.428571429,0.020408163,1546,1739,1491,193,-248,-55
o471,o,False labor at or after 37 completed weeks of gestation,"Pregnancy, childbirth and the puerperium",161,49,66,-0.695652174,0.346938776,-0.590062112,790,1459,1282,669,-177,492
o480,o,Post-term pregnancy,"Pregnancy, childbirth and the puerperium",3109,3193,3610,0.027018334,0.130598184,0.161145063,108,107,102,-1,-5,-6
o6000,o,"Preterm labor without delivery, unspecified trimester","Pregnancy, childbirth and the puerperium",26,13,16,-0.5,0.230769231,-0.384615385,2090,2679,2504,589,-175,414
o6002,o,"Preterm labor without delivery, second trimester","Pregnancy, childbirth and the puerperium",70,66,65,-0.057142857,-0.015151515,-0.071428571,1275,1255,1290,-20,35,15
o6003,o,"Preterm labor without delivery, third trimester","Pregnancy, childbirth and the puerperium",480,384,434,-0.2,0.130208333,-0.095833333,427,472,452,45,-20,25
o6012x0,o,"Preterm labor second trimester with preterm delivery second trimester, not applicable or unspecified","Pregnancy, childbirth and the puerperium",74,97,91,0.310810811,-0.06185567,0.22972973,1236,1014,1086,-222,72,-150
o6013x0,o,"Preterm labor second trimester with preterm delivery third trimester, not applicable or unspecified","Pregnancy, childbirth and the puerperium",27,29,30,0.074074074,0.034482759,0.111111111,2057,1901,1939,-156,38,-118
o6014x0,o,"Preterm labor third trimester with preterm delivery third trimester, not applicable or unspecified","Pregnancy, childbirth and the puerperium",989,895,1017,-0.095045501,0.136312849,0.028311426,258,265,257,7,-8,-1
o6014x1,o,"Preterm labor third trimester with preterm delivery third trimester, fetus 1","Pregnancy, childbirth and the puerperium",34,27,30,-0.205882353,0.111111111,-0.117647059,1828,1970,1938,142,-32,110
o6014x2,o,"Preterm labor third trimester with preterm delivery third trimester, fetus 2","Pregnancy, childbirth and the puerperium",43,34,35,-0.209302326,0.029411765,-0.186046512,1643,1750,1784,107,34,141
o6020x0,o,"Term delivery with preterm labor, unspecified trimester, not applicable or unspecified","Pregnancy, childbirth and the puerperium",13,14,21,0.076923077,0.5,0.615384615,2720,2616,2244,-104,-372,-476
o6023x0,o,"Term delivery with preterm labor, third trimester, not applicable or unspecified","Pregnancy, childbirth and the puerperium",47,44,43,-0.063829787,-0.022727273,-0.085106383,1570,1547,1622,-23,75,52
o610,o,Failed medical induction of labor,"Pregnancy, childbirth and the puerperium",363,373,386,0.027548209,0.034852547,0.063360882,502,476,486,-26,10,-16
o619,o,"Failed induction of labor, unspecified","Pregnancy, childbirth and the puerperium",81,88,72,0.086419753,-0.181818182,-0.111111111,1174,1064,1222,-110,158,48
o620,o,Primary inadequate contractions,"Pregnancy, childbirth and the puerperium",553,481,563,-0.130198915,0.17047817,0.018083183,389,414,386,25,-28,-3
o621,o,Secondary uterine inertia,"Pregnancy, childbirth and the puerperium",797,731,773,-0.08281054,0.05745554,-0.030112923,308,320,312,12,-8,4
o622,o,Other uterine inertia,"Pregnancy, childbirth and the puerperium",466,401,523,-0.139484979,0.304239401,0.122317597,432,460,404,28,-56,-28
o623,o,Precipitate labor,"Pregnancy, childbirth and the puerperium",771,703,928,-0.088197147,0.320056899,0.203631647,316,332,273,16,-59,-43
o624,o,"Hypertonic, incoordinate, and prolonged uterine contractions","Pregnancy, childbirth and the puerperium",12,10,15,-0.166666667,0.5,0.25,2759,2844,2546,85,-298,-213
o629,o,"Abnormality of forces of labor, unspecified","Pregnancy, childbirth and the puerperium",274,33,21,-0.879562044,-0.363636364,-0.923357664,602,1776,2237,1174,461,1635
o630,o,Prolonged first stage (of labor),"Pregnancy, childbirth and the puerperium",79,61,120,-0.227848101,0.967213115,0.518987342,1183,1303,918,120,-385,-265
o631,o,Prolonged second stage (of labor),"Pregnancy, childbirth and the puerperium",131,115,131,-0.122137405,0.139130435,0,887,924,869,37,-55,-18
o639,o,"Long labor, unspecified","Pregnancy, childbirth and the puerperium",156,167,270,0.070512821,0.616766467,0.730769231,803,749,594,-54,-155,-209
o640xx0,o,"Obstructed labor due to incomplete rotation of fetal head, not applicable or unspecified","Pregnancy, childbirth and the puerperium",145,148,203,0.020689655,0.371621622,0.4,838,800,692,-38,-108,-146
o641xx0,o,"Obstructed labor due to breech presentation, not applicable or unspecified","Pregnancy, childbirth and the puerperium",64,58,40,-0.09375,-0.310344828,-0.375,1331,1331,1665,0,334,334
o648xx0,o,"Obstructed labor due to other malposition and malpresentation, not applicable or unspecified","Pregnancy, childbirth and the puerperium",73,65,59,-0.109589041,-0.092307692,-0.191780822,1233,1251,1341,18,90,108
o654,o,"Obstructed labor due to fetopelvic disproportion, unspecified","Pregnancy, childbirth and the puerperium",13,18,30,0.384615385,0.666666667,1.307692308,2706,2368,1924,-338,-444,-782
o655,o,Obstructed labor due to abnormality of maternal pelvic organs,"Pregnancy, childbirth and the puerperium",22,33,72,0.5,1.181818182,2.272727273,2226,1770,1214,-456,-556,-1012
o659,o,"Obstructed labor due to maternal pelvic abnormality, unspecified","Pregnancy, childbirth and the puerperium",37,29,26,-0.216216216,-0.103448276,-0.297297297,1744,1884,2050,140,166,306
o660,o,Obstructed labor due to shoulder dystocia,"Pregnancy, childbirth and the puerperium",583,574,631,-0.015437393,0.099303136,0.082332762,371,370,357,-1,-13,-14
o6640,o,"Failed trial of labor, unspecified","Pregnancy, childbirth and the puerperium",16,19,13,0.1875,-0.315789474,-0.1875,2527,2316,2658,-211,342,131
o6641,o,Failed attempted vaginal birth after previous cesarean delivery,"Pregnancy, childbirth and the puerperium",65,70,105,0.076923077,0.5,0.615384615,1315,1199,985,-116,-214,-330
o665,o,Attempted application of vacuum extractor and forceps,"Pregnancy, childbirth and the puerperium",255,192,118,-0.247058824,-0.385416667,-0.537254902,620,705,926,85,221,306
o669,o,"Obstructed labor, unspecified","Pregnancy, childbirth and the puerperium",16,10,13,-0.375,0.3,-0.1875,2525,2830,2656,305,-174,131
o678,o,Other intrapartum hemorrhage,"Pregnancy, childbirth and the puerperium",36,18,28,-0.5,0.555555556,-0.222222222,1761,2362,1976,601,-386,215
o679,o,"Intrapartum hemorrhage, unspecified","Pregnancy, childbirth and the puerperium",48,45,52,-0.0625,0.155555556,0.083333333,1539,1507,1437,-32,-70,-102
o690xx0,o,"Labor and delivery complicated by prolapse of cord, not applicable or unspecified","Pregnancy, childbirth and the puerperium",61,59,62,-0.032786885,0.050847458,0.016393443,1361,1318,1305,-43,-13,-56
o691xx0,o,"Labor and delivery complicated by cord around neck, with compression, not applicable or unspecified","Pregnancy, childbirth and the puerperium",975,871,1094,-0.106666667,0.256027555,0.122051282,259,268,244,9,-24,-15
o692xx0,o,"Labor and delivery complicated by other cord entanglement, with compression, not applicable or unspecified","Pregnancy, childbirth and the puerperium",323,337,294,0.043343653,-0.127596439,-0.089783282,531,494,565,-37,71,34
o693xx0,o,"Labor and delivery complicated by short cord, not applicable or unspecified","Pregnancy, childbirth and the puerperium",213,226,242,0.061032864,0.07079646,0.136150235,689,644,632,-45,-12,-57
o694xx0,o,"Labor and delivery complicated by vasa previa, not applicable or unspecified","Pregnancy, childbirth and the puerperium",14,16,11,0.142857143,-0.3125,-0.214285714,2631,2477,2769,-154,292,138
o6981x0,o,"Labor and delivery complicated by cord around neck, without compression, not applicable or unspecified","Pregnancy, childbirth and the puerperium",5683,5388,5965,-0.051909203,0.107089829,0.049621679,63,62,57,-1,-5,-6
o6981x1,o,"Labor and delivery complicated by cord around neck, without compression, fetus 1","Pregnancy, childbirth and the puerperium",35,20,33,-0.428571429,0.65,-0.057142857,1781,2266,1821,485,-445,40
o6981x2,o,"Labor and delivery complicated by cord around neck, without compression, fetus 2","Pregnancy, childbirth and the puerperium",23,13,14,-0.434782609,0.076923077,-0.391304348,2170,2641,2583,471,-58,413
o6982x0,o,"Labor and delivery complicated by other cord entanglement, without compression, not applicable or unspecified","Pregnancy, childbirth and the puerperium",120,148,191,0.233333333,0.290540541,0.591666667,933,794,708,-139,-86,-225
o6989x0,o,"Labor and delivery complicated by other cord complications, not applicable or unspecified","Pregnancy, childbirth and the puerperium",182,208,217,0.142857143,0.043269231,0.192307692,730,672,665,-58,-7,-65
o700,o,First degree perineal laceration during delivery,"Pregnancy, childbirth and the puerperium",4985,4788,5202,-0.039518556,0.086466165,0.043530592,74,71,71,-3,0,-3
o701,o,Second degree perineal laceration during delivery,"Pregnancy, childbirth and the puerperium",6065,5795,6329,-0.044517725,0.092148404,0.043528442,54,56,53,2,-3,-1
o7020,o,"Third degree perineal laceration during delivery, unspecified","Pregnancy, childbirth and the puerperium",305,321,296,0.052459016,-0.07788162,-0.029508197,554,510,559,-44,49,5
o7021,o,"Third degree perineal laceration during delivery, IIIa","Pregnancy, childbirth and the puerperium",78,84,72,0.076923077,-0.142857143,-0.076923077,1175,1073,1202,-102,129,27
o7022,o,"Third degree perineal laceration during delivery, IIIb","Pregnancy, childbirth and the puerperium",25,20,33,-0.2,0.65,0.32,2094,2260,1815,166,-445,-279
o703,o,Fourth degree perineal laceration during delivery,"Pregnancy, childbirth and the puerperium",76,66,66,-0.131578947,0,-0.131578947,1188,1230,1254,42,24,66
o709,o,"Perineal laceration during delivery, unspecified","Pregnancy, childbirth and the puerperium",103,69,96,-0.330097087,0.391304348,-0.067961165,1005,1199,1029,194,-170,24
o711,o,Rupture of uterus during labor,"Pregnancy, childbirth and the puerperium",31,33,28,0.064516129,-0.151515152,-0.096774194,1880,1753,1960,-127,207,80
o712,o,Postpartum inversion of uterus,"Pregnancy, childbirth and the puerperium",14,11,11,-0.214285714,0,-0.214285714,2618,2750,2756,132,6,138
o713,o,Obstetric laceration of cervix,"Pregnancy, childbirth and the puerperium",69,66,67,-0.043478261,0.015151515,-0.028985507,1256,1229,1240,-27,11,-16
o714,o,Obstetric high vaginal laceration alone,"Pregnancy, childbirth and the puerperium",919,752,898,-0.18171926,0.194148936,-0.022850925,264,303,275,39,-28,11
o715,o,Other obstetric injury to pelvic organs,"Pregnancy, childbirth and the puerperium",32,42,41,0.3125,-0.023809524,0.28125,1852,1549,1627,-303,78,-225
o717,o,Obstetric hematoma of pelvis,"Pregnancy, childbirth and the puerperium",53,62,61,0.169811321,-0.016129032,0.150943396,1446,1272,1299,-174,27,-147
o7182,o,Other specified trauma to perineum and vulva,"Pregnancy, childbirth and the puerperium",1315,1273,1452,-0.031939163,0.140612726,0.10418251,213,214,200,1,-14,-13
o7189,o,Other specified obstetric trauma,"Pregnancy, childbirth and the puerperium",75,96,74,0.28,-0.229166667,-0.013333333,1193,998,1181,-195,183,-12
o720,o,Third-stage hemorrhage,"Pregnancy, childbirth and the puerperium",172,139,185,-0.191860465,0.330935252,0.075581395,748,818,717,70,-101,-31
o721,o,Other immediate postpartum hemorrhage,"Pregnancy, childbirth and the puerperium",1193,1084,1284,-0.091366303,0.184501845,0.07627829,223,234,219,11,-15,-4
o722,o,Delayed and secondary postpartum hemorrhage,"Pregnancy, childbirth and the puerperium",201,179,155,-0.109452736,-0.134078212,-0.228855721,696,712,772,16,60,76
o723,o,Postpartum coagulation defects,"Pregnancy, childbirth and the puerperium",46,34,35,-0.260869565,0.029411765,-0.239130435,1547,1711,1744,164,33,197
o730,o,Retained placenta without hemorrhage,"Pregnancy, childbirth and the puerperium",158,129,129,-0.183544304,0,-0.183544304,776,847,858,71,11,82
o731,o,"Retained portions of placenta and membranes, without hemorrhage","Pregnancy, childbirth and the puerperium",87,93,92,0.068965517,-0.010752688,0.057471264,1094,1010,1050,-84,40,-44
o745,o,Spinal and epidural anesthesia-induced headache during labor and delivery,"Pregnancy, childbirth and the puerperium",18,14,14,-0.222222222,0,-0.222222222,2393,2564,2561,171,-3,168
o751,o,Shock during or following labor and delivery,"Pregnancy, childbirth and the puerperium",29,13,11,-0.551724138,-0.153846154,-0.620689655,1939,2618,2743,679,125,804
o752,o,"Pyrexia during labor, not elsewhere classified","Pregnancy, childbirth and the puerperium",243,213,250,-0.12345679,0.17370892,0.028806584,630,660,616,30,-44,-14
o753,o,Other infection during labor,"Pregnancy, childbirth and the puerperium",157,148,162,-0.057324841,0.094594595,0.031847134,781,785,757,4,-28,-24
o754,o,Other complications of obstetric surgery and procedures,"Pregnancy, childbirth and the puerperium",17,15,15,-0.117647059,0,-0.117647059,2439,2496,2501,57,5,62
o7581,o,Maternal exhaustion complicating labor and delivery,"Pregnancy, childbirth and the puerperium",316,337,354,0.066455696,0.050445104,0.120253165,536,488,497,-48,9,-39
o7582,o,"Onset (spontaneous) of labor after 37 completed weeks of gestation but before 39 completed weeks gestation, with delivery by (planned) cesarean section","Pregnancy, childbirth and the puerperium",93,54,81,-0.419354839,0.5,-0.129032258,1052,1345,1112,293,-233,60
o7589,o,Other specified complications of labor and delivery,"Pregnancy, childbirth and the puerperium",772,709,694,-0.081606218,-0.021156559,-0.101036269,308,320,331,12,11,23
o759,o,"Complication of labor and delivery, unspecified","Pregnancy, childbirth and the puerperium",724,649,713,-0.10359116,0.098613251,-0.01519337,328,341,329,13,-12,1
o76,o,Abnormality in fetal heart rate and rhythm complicating labor and delivery,"Pregnancy, childbirth and the puerperium",5365,4821,5739,-0.10139795,0.190416926,0.06971109,66,67,57,1,-10,-9
o770,o,Labor and delivery complicated by meconium in amniotic fluid,"Pregnancy, childbirth and the puerperium",3199,3064,3551,-0.042200688,0.158942559,0.110034386,103,104,98,1,-6,-5
o779,o,"Labor and delivery complicated by fetal stress, unspecified","Pregnancy, childbirth and the puerperium",173,170,188,-0.01734104,0.105882353,0.086705202,736,720,702,-16,-18,-34
o80,o,Encounter for full-term uncomplicated delivery,"Pregnancy, childbirth and the puerperium",5954,4701,3790,-0.210446758,-0.193788556,-0.363453141,55,71,94,16,23,39
o82,o,Encounter for cesarean delivery without indication,"Pregnancy, childbirth and the puerperium",110,84,93,-0.236363636,0.107142857,-0.154545455,963,1056,1034,93,-22,71
o85,o,Puerperal sepsis,"Pregnancy, childbirth and the puerperium",49,40,49,-0.183673469,0.225,0,1490,1582,1451,92,-131,-39
o8601,o,"Infection of obstetric surgical wound, superficial incisional site","Pregnancy, childbirth and the puerperium",36,21,23,-0.416666667,0.095238095,-0.361111111,1724,2185,2115,461,-70,391
o8604,o,Sepsis following an obstetrical procedure,"Pregnancy, childbirth and the puerperium",20,14,22,-0.3,0.571428571,0.1,2270,2550,2151,280,-399,-119
o8612,o,Endometritis following delivery,"Pregnancy, childbirth and the puerperium",172,160,145,-0.069767442,-0.09375,-0.156976744,738,748,789,10,41,51
o8620,o,"Urinary tract infection following delivery, unspecified","Pregnancy, childbirth and the puerperium",59,46,46,-0.220338983,0,-0.220338983,1352,1458,1506,106,48,154
o8621,o,Infection of kidney following delivery,"Pregnancy, childbirth and the puerperium",21,17,13,-0.19047619,-0.235294118,-0.380952381,2221,2383,2607,162,224,386
o864,o,Pyrexia of unknown origin following delivery,"Pregnancy, childbirth and the puerperium",141,126,138,-0.106382979,0.095238095,-0.021276596,823,853,812,30,-41,-11
o871,o,Deep phlebothrombosis in the puerperium,"Pregnancy, childbirth and the puerperium",11,11,12,0,0.090909091,0.090909091,2736,2717,2662,-19,-55,-74
o872,o,Hemorrhoids in the puerperium,"Pregnancy, childbirth and the puerperium",25,31,34,0.24,0.096774194,0.36,2062,1778,1754,-284,-24,-308
o874,o,Varicose veins of lower extremity in the puerperium,"Pregnancy, childbirth and the puerperium",23,24,14,0.043478261,-0.416666667,-0.391304348,2130,2030,2542,-100,512,412
o894,o,Spinal and epidural anesthesia-induced headache during the puerperium,"Pregnancy, childbirth and the puerperium",31,30,33,-0.032258065,0.1,0.064516129,1852,1810,1785,-42,-25,-67
o900,o,Disruption of cesarean delivery wound,"Pregnancy, childbirth and the puerperium",42,34,39,-0.19047619,0.147058824,-0.071428571,1598,1694,1637,96,-57,39
o902,o,Hematoma of obstetric wound,"Pregnancy, childbirth and the puerperium",31,48,41,0.548387097,-0.145833333,0.322580645,1851,1424,1604,-427,180,-247
o903,o,Peripartum cardiomyopathy,"Pregnancy, childbirth and the puerperium",32,37,57,0.15625,0.540540541,0.78125,1826,1637,1325,-189,-312,-501
o904,o,Postpartum acute kidney failure,"Pregnancy, childbirth and the puerperium",41,29,28,-0.292682927,-0.034482759,-0.317073171,1620,1834,1928,214,94,308
o9081,o,Anemia of the puerperium,"Pregnancy, childbirth and the puerperium",1516,1354,1300,-0.106860158,-0.039881832,-0.142480211,188,205,214,17,9,26
o9089,o,"Other complications of the puerperium, not elsewhere classified","Pregnancy, childbirth and the puerperium",297,252,336,-0.151515152,0.333333333,0.131313131,555,583,508,28,-75,-47
o9229,o,Other disorders of breast associated with pregnancy and the puerperium,"Pregnancy, childbirth and the puerperium",30,14,10,-0.533333333,-0.285714286,-0.666666667,1879,2537,2758,658,221,879
o9812,o,Syphilis complicating childbirth,"Pregnancy, childbirth and the puerperium",59,67,91,0.13559322,0.358208955,0.542372881,1349,1194,1042,-155,-152,-307
o9822,o,Gonorrhea complicating childbirth,"Pregnancy, childbirth and the puerperium",22,20,36,-0.090909091,0.8,0.636363636,2163,2219,1686,56,-533,-477
o98312,o,"Other infections with a predominantly sexual mode of transmission complicating pregnancy, second trimester","Pregnancy, childbirth and the puerperium",12,19,20,0.583333333,0.052631579,0.666666667,2678,2258,2213,-420,-45,-465
o98313,o,"Other infections with a predominantly sexual mode of transmission complicating pregnancy, third trimester","Pregnancy, childbirth and the puerperium",66,35,67,-0.46969697,0.914285714,0.015151515,1264,1672,1216,408,-456,-48
o98319,o,"Other infections with a predominantly sexual mode of transmission complicating pregnancy, unspecified trimester","Pregnancy, childbirth and the puerperium",21,16,24,-0.238095238,0.5,0.142857143,2207,2423,2073,216,-350,-134
o9832,o,Other infections with a predominantly sexual mode of transmission complicating childbirth,"Pregnancy, childbirth and the puerperium",566,591,626,0.044169611,0.059221658,0.106007067,365,350,345,-15,-5,-20
o98413,o,"Viral hepatitis complicating pregnancy, third trimester","Pregnancy, childbirth and the puerperium",36,15,20,-0.583333333,0.333333333,-0.444444444,1714,2466,2210,752,-256,496
o9842,o,Viral hepatitis complicating childbirth,"Pregnancy, childbirth and the puerperium",185,134,151,-0.275675676,0.126865672,-0.183783784,705,812,773,107,-39,68
o98513,o,"Other viral diseases complicating pregnancy, third trimester","Pregnancy, childbirth and the puerperium",30,75,187,1.5,1.493333333,5.233333333,1874,1114,699,-760,-415,-1175
o9852,o,Other viral diseases complicating childbirth,"Pregnancy, childbirth and the puerperium",382,409,823,0.070680628,1.012224939,1.154450262,465,438,283,-27,-155,-182
o9872,o,Human immunodeficiency virus [HIV] disease complicating childbirth,"Pregnancy, childbirth and the puerperium",11,19,16,0.727272727,-0.157894737,0.454545455,2716,2253,2411,-463,158,-305
o98812,o,"Other maternal infectious and parasitic diseases complicating pregnancy, second trimester","Pregnancy, childbirth and the puerperium",34,31,39,-0.088235294,0.258064516,0.147058824,1756,1767,1627,11,-140,-129
o98813,o,"Other maternal infectious and parasitic diseases complicating pregnancy, third trimester","Pregnancy, childbirth and the puerperium",37,50,38,0.351351351,-0.24,0.027027027,1692,1378,1650,-314,272,-42
o9882,o,Other maternal infectious and parasitic diseases complicating childbirth,"Pregnancy, childbirth and the puerperium",152,188,213,0.236842105,0.132978723,0.401315789,783,688,655,-95,-33,-128
o99011,o,"Anemia complicating pregnancy, first trimester","Pregnancy, childbirth and the puerperium",66,43,65,-0.348484848,0.511627907,-0.015151515,1260,1497,1230,237,-267,-30
o99012,o,"Anemia complicating pregnancy, second trimester","Pregnancy, childbirth and the puerperium",126,128,132,0.015873016,0.03125,0.047619048,873,834,828,-39,-6,-45
o99013,o,"Anemia complicating pregnancy, third trimester","Pregnancy, childbirth and the puerperium",330,294,338,-0.109090909,0.149659864,0.024242424,508,529,503,21,-26,-5
o99019,o,"Anemia complicating pregnancy, unspecified trimester","Pregnancy, childbirth and the puerperium",126,90,94,-0.285714286,0.044444444,-0.253968254,872,1005,1016,133,11,144
o9902,o,Anemia complicating childbirth,"Pregnancy, childbirth and the puerperium",3921,3624,3963,-0.075745983,0.093543046,0.010711553,87,91,90,4,-1,3
o9903,o,Anemia complicating the puerperium,"Pregnancy, childbirth and the puerperium",72,90,100,0.25,0.111111111,0.388888889,1196,1004,974,-192,-30,-222
o99111,o,"Other diseases of the blood and blood-forming organs and certain disorders involving the immune mechanism complicating pregnancy, first trimester","Pregnancy, childbirth and the puerperium",17,20,14,0.176470588,-0.3,-0.176470588,2395,2205,2515,-190,310,120
o99112,o,"Other diseases of the blood and blood-forming organs and certain disorders involving the immune mechanism complicating pregnancy, second trimester","Pregnancy, childbirth and the puerperium",42,29,34,-0.30952381,0.172413793,-0.19047619,1584,1817,1733,233,-84,149
o99113,o,"Other diseases of the blood and blood-forming organs and certain disorders involving the immune mechanism complicating pregnancy, third trimester","Pregnancy, childbirth and the puerperium",71,56,74,-0.211267606,0.321428571,0.042253521,1205,1301,1150,96,-151,-55
o9912,o,Other diseases of the blood and blood-forming organs and certain disorders involving the immune mechanism complicating childbirth,"Pregnancy, childbirth and the puerperium",668,641,636,-0.040419162,-0.007800312,-0.047904192,338,338,341,0,3,3
o9913,o,Other diseases of the blood and blood-forming organs and certain disorders involving the immune mechanism complicating the puerperium,"Pregnancy, childbirth and the puerperium",40,32,33,-0.2,0.03125,-0.175,1623,1728,1761,105,33,138
o99210,o,"Obesity complicating pregnancy, unspecified trimester","Pregnancy, childbirth and the puerperium",40,33,59,-0.175,0.787878788,0.475,1623,1705,1284,82,-421,-339
o99211,o,"Obesity complicating pregnancy, first trimester","Pregnancy, childbirth and the puerperium",24,20,35,-0.166666667,0.75,0.458333333,2068,2200,1703,132,-497,-365
o99212,o,"Obesity complicating pregnancy, second trimester","Pregnancy, childbirth and the puerperium",90,105,97,0.166666667,-0.076190476,0.077777778,1054,927,995,-127,68,-59
o99213,o,"Obesity complicating pregnancy, third trimester","Pregnancy, childbirth and the puerperium",320,275,386,-0.140625,0.403636364,0.20625,519,551,464,32,-87,-55
o99214,o,Obesity complicating childbirth,"Pregnancy, childbirth and the puerperium",4946,4307,4900,-0.129195309,0.137682842,-0.009300445,71,79,74,8,-5,3
o99215,o,Obesity complicating the puerperium,"Pregnancy, childbirth and the puerperium",82,62,109,-0.243902439,0.758064516,0.329268293,1110,1236,932,126,-304,-178
o99280,o,"Endocrine, nutritional and metabolic diseases complicating pregnancy, unspecified trimester","Pregnancy, childbirth and the puerperium",50,26,44,-0.48,0.692307692,-0.12,1449,1917,1522,468,-395,73
o99281,o,"Endocrine, nutritional and metabolic diseases complicating pregnancy, first trimester","Pregnancy, childbirth and the puerperium",86,83,102,-0.034883721,0.228915663,0.186046512,1074,1048,958,-26,-90,-116
o99282,o,"Endocrine, nutritional and metabolic diseases complicating pregnancy, second trimester","Pregnancy, childbirth and the puerperium",142,148,169,0.042253521,0.141891892,0.190140845,809,767,724,-42,-43,-85
o99283,o,"Endocrine, nutritional and metabolic diseases complicating pregnancy, third trimester","Pregnancy, childbirth and the puerperium",236,206,266,-0.127118644,0.291262136,0.127118644,627,652,578,25,-74,-49
o99284,o,"Endocrine, nutritional and metabolic diseases complicating childbirth","Pregnancy, childbirth and the puerperium",2266,2169,2356,-0.042806708,0.086214846,0.039717564,131,131,129,0,-2,-2
o99285,o,"Endocrine, nutritional and metabolic diseases complicating the puerperium","Pregnancy, childbirth and the puerperium",143,115,120,-0.195804196,0.043478261,-0.160839161,804,879,872,75,-7,68
o99314,o,Alcohol use complicating childbirth,"Pregnancy, childbirth and the puerperium",42,39,45,-0.071428571,0.153846154,0.071428571,1572,1570,1495,-2,-75,-77
o99321,o,"Drug use complicating pregnancy, first trimester","Pregnancy, childbirth and the puerperium",65,49,56,-0.246153846,0.142857143,-0.138461538,1256,1378,1310,122,-68,54
o99322,o,"Drug use complicating pregnancy, second trimester","Pregnancy, childbirth and the puerperium",78,87,82,0.115384615,-0.057471264,0.051282051,1134,1016,1074,-118,58,-60
o99323,o,"Drug use complicating pregnancy, third trimester","Pregnancy, childbirth and the puerperium",157,135,166,-0.140127389,0.22962963,0.057324841,761,799,728,38,-71,-33
o99324,o,Drug use complicating childbirth,"Pregnancy, childbirth and the puerperium",1061,933,1048,-0.120640905,0.123258307,-0.012252592,234,249,241,15,-8,7
o99325,o,Drug use complicating the puerperium,"Pregnancy, childbirth and the puerperium",66,51,74,-0.227272727,0.450980392,0.121212121,1241,1346,1137,105,-209,-104
o99331,o,"Smoking (tobacco) complicating pregnancy, first trimester","Pregnancy, childbirth and the puerperium",52,58,53,0.115384615,-0.086206897,0.019230769,1409,1266,1351,-143,85,-58
o99332,o,"Smoking (tobacco) complicating pregnancy, second trimester","Pregnancy, childbirth and the puerperium",72,89,65,0.236111111,-0.269662921,-0.097222222,1183,999,1210,-184,211,27
o99333,o,"Smoking (tobacco) complicating pregnancy, third trimester","Pregnancy, childbirth and the puerperium",141,121,143,-0.141843972,0.181818182,0.014184397,806,848,777,42,-71,-29
o99334,o,Smoking (tobacco) complicating childbirth,"Pregnancy, childbirth and the puerperium",1534,1175,1323,-0.234028683,0.125957447,-0.137548892,184,214,205,30,-9,21
o99335,o,Smoking (tobacco) complicating the puerperium,"Pregnancy, childbirth and the puerperium",63,42,64,-0.333333333,0.523809524,0.015873016,1274,1491,1216,217,-275,-58
o99340,o,"Other mental disorders complicating pregnancy, unspecified trimester","Pregnancy, childbirth and the puerperium",111,65,99,-0.414414414,0.523076923,-0.108108108,935,1187,970,252,-217,35
o99341,o,"Other mental disorders complicating pregnancy, first trimester","Pregnancy, childbirth and the puerperium",74,52,65,-0.297297297,0.25,-0.121621622,1163,1330,1207,167,-123,44
o99342,o,"Other mental disorders complicating pregnancy, second trimester","Pregnancy, childbirth and the puerperium",122,114,116,-0.06557377,0.01754386,-0.049180328,877,879,886,2,7,9
o99343,o,"Other mental disorders complicating pregnancy, third trimester","Pregnancy, childbirth and the puerperium",292,208,288,-0.287671233,0.384615385,-0.01369863,549,647,547,98,-100,-2
o99344,o,Other mental disorders complicating childbirth,"Pregnancy, childbirth and the puerperium",2908,2754,3207,-0.052957359,0.164488017,0.102819807,105,110,99,5,-11,-6
o99345,o,Other mental disorders complicating the puerperium,"Pregnancy, childbirth and the puerperium",156,146,165,-0.064102564,0.130136986,0.057692308,760,766,726,6,-40,-34
o99350,o,"Diseases of the nervous system complicating pregnancy, unspecified trimester","Pregnancy, childbirth and the puerperium",30,22,13,-0.266666667,-0.409090909,-0.566666667,1832,2071,2543,239,472,711
o99351,o,"Diseases of the nervous system complicating pregnancy, first trimester","Pregnancy, childbirth and the puerperium",28,24,24,-0.142857143,0,-0.142857143,1896,1976,2027,80,51,131
o99352,o,"Diseases of the nervous system complicating pregnancy, second trimester","Pregnancy, childbirth and the puerperium",51,34,38,-0.333333333,0.117647059,-0.254901961,1416,1648,1613,232,-35,197
o99353,o,"Diseases of the nervous system complicating pregnancy, third trimester","Pregnancy, childbirth and the puerperium",123,74,106,-0.398373984,0.432432432,-0.138211382,871,1094,929,223,-165,58
o99354,o,Diseases of the nervous system complicating childbirth,"Pregnancy, childbirth and the puerperium",896,819,856,-0.0859375,0.045177045,-0.044642857,258,271,270,13,-1,12
o99355,o,Diseases of the nervous system complicating the puerperium,"Pregnancy, childbirth and the puerperium",72,46,78,-0.361111111,0.695652174,0.083333333,1173,1414,1101,241,-313,-72
o99411,o,"Diseases of the circulatory system complicating pregnancy, first trimester","Pregnancy, childbirth and the puerperium",18,15,20,-0.166666667,0.333333333,0.111111111,2307,2413,2160,106,-253,-147
o99412,o,"Diseases of the circulatory system complicating pregnancy, second trimester","Pregnancy, childbirth and the puerperium",29,17,25,-0.413793103,0.470588235,-0.137931034,1862,2315,1975,453,-340,113
o99413,o,"Diseases of the circulatory system complicating pregnancy, third trimester","Pregnancy, childbirth and the puerperium",43,48,66,0.11627907,0.375,0.534883721,1540,1382,1192,-158,-190,-348
o9942,o,Diseases of the circulatory system complicating childbirth,"Pregnancy, childbirth and the puerperium",309,276,333,-0.106796117,0.206521739,0.077669903,524,543,497,19,-46,-27
o9943,o,Diseases of the circulatory system complicating the puerperium,"Pregnancy, childbirth and the puerperium",99,65,104,-0.343434343,0.6,0.050505051,977,1180,933,203,-247,-44
o99511,o,"Diseases of the respiratory system complicating pregnancy, first trimester","Pregnancy, childbirth and the puerperium",36,48,39,0.333333333,-0.1875,0.083333333,1665,1380,1584,-285,204,-81
o99512,o,"Diseases of the respiratory system complicating pregnancy, second trimester","Pregnancy, childbirth and the puerperium",86,116,116,0.348837209,0,0.348837209,1057,866,881,-191,15,-176
o99513,o,"Diseases of the respiratory system complicating pregnancy, third trimester","Pregnancy, childbirth and the puerperium",244,225,292,-0.077868852,0.297777778,0.196721311,604,616,540,12,-76,-64
o99519,o,"Diseases of the respiratory system complicating pregnancy, unspecified trimester","Pregnancy, childbirth and the puerperium",88,57,50,-0.352272727,-0.122807018,-0.431818182,1043,1262,1381,219,119,338
o9952,o,Diseases of the respiratory system complicating childbirth,"Pregnancy, childbirth and the puerperium",2100,1981,2183,-0.056666667,0.101968703,0.03952381,138,138,139,0,1,1
o9953,o,Diseases of the respiratory system complicating the puerperium,"Pregnancy, childbirth and the puerperium",125,129,142,0.032,0.100775194,0.136,856,813,772,-43,-41,-84
o99611,o,"Diseases of the digestive system complicating pregnancy, first trimester","Pregnancy, childbirth and the puerperium",45,47,55,0.044444444,0.170212766,0.222222222,1499,1388,1304,-111,-84,-195
o99612,o,"Diseases of the digestive system complicating pregnancy, second trimester","Pregnancy, childbirth and the puerperium",71,53,52,-0.253521127,-0.018867925,-0.267605634,1173,1302,1346,129,44,173
o99613,o,"Diseases of the digestive system complicating pregnancy, third trimester","Pregnancy, childbirth and the puerperium",129,106,127,-0.178294574,0.198113208,-0.015503876,838,901,829,63,-72,-9
o99619,o,"Diseases of the digestive system complicating pregnancy, unspecified trimester","Pregnancy, childbirth and the puerperium",80,50,57,-0.375,0.14,-0.2875,1104,1336,1273,232,-63,169
o9962,o,Diseases of the digestive system complicating childbirth,"Pregnancy, childbirth and the puerperium",890,846,882,-0.049438202,0.042553191,-0.008988764,260,261,265,1,4,5
o9963,o,Diseases of the digestive system complicating the puerperium,"Pregnancy, childbirth and the puerperium",102,84,91,-0.176470588,0.083333333,-0.107843137,960,1017,1003,57,-14,43
o99712,o,"Diseases of the skin and subcutaneous tissue complicating pregnancy, second trimester","Pregnancy, childbirth and the puerperium",15,14,12,-0.066666667,-0.142857143,-0.2,2446,2460,2576,14,116,130
o99713,o,"Diseases of the skin and subcutaneous tissue complicating pregnancy, third trimester","Pregnancy, childbirth and the puerperium",26,19,19,-0.269230769,0,-0.269230769,1941,2189,2190,248,1,249
o9972,o,Diseases of the skin and subcutaneous tissue complicating childbirth,"Pregnancy, childbirth and the puerperium",259,220,252,-0.150579151,0.145454545,-0.027027027,581,622,586,41,-36,5
o9973,o,Diseases of the skin and subcutaneous tissue complicating the puerperium,"Pregnancy, childbirth and the puerperium",54,18,30,-0.666666667,0.666666667,-0.444444444,1360,2233,1801,873,-432,441
o99810,o,Abnormal glucose complicating pregnancy,"Pregnancy, childbirth and the puerperium",44,46,42,0.045454545,-0.086956522,-0.045454545,1505,1398,1520,-107,122,15
o99814,o,Abnormal glucose complicating childbirth,"Pregnancy, childbirth and the puerperium",267,214,318,-0.198501873,0.485981308,0.191011236,574,632,509,58,-123,-65
o99820,o,Streptococcus B carrier state complicating pregnancy,"Pregnancy, childbirth and the puerperium",275,248,495,-0.098181818,0.995967742,0.8,565,573,389,8,-184,-176
o99824,o,Streptococcus B carrier state complicating childbirth,"Pregnancy, childbirth and the puerperium",5127,4725,4963,-0.078408426,0.05037037,-0.031987517,70,70,72,0,2,2
o99834,o,Other infection carrier state complicating childbirth,"Pregnancy, childbirth and the puerperium",27,18,19,-0.333333333,0.055555556,-0.296296296,1906,2229,2184,323,-45,278
o99844,o,Bariatric surgery status complicating childbirth,"Pregnancy, childbirth and the puerperium",120,114,143,-0.05,0.254385965,0.191666667,875,865,764,-10,-101,-111
o9a12,o,Malignant neoplasm complicating childbirth,"Pregnancy, childbirth and the puerperium",19,11,13,-0.421052632,0.181818182,-0.315789474,2221,2620,2512,399,-108,291
o9a211,o,"Injury, poisoning and certain other consequences of external causes complicating pregnancy, first trimester","Pregnancy, childbirth and the puerperium",16,12,12,-0.25,0,-0.25,2378,2565,2566,187,1,188
o9a213,o,"Injury, poisoning and certain other consequences of external causes complicating pregnancy, third trimester","Pregnancy, childbirth and the puerperium",24,25,25,0.041666667,0,0.041666667,2010,1904,1953,-106,49,-57
o9a22,o,"Injury, poisoning and certain other consequences of external causes complicating childbirth","Pregnancy, childbirth and the puerperium",63,53,44,-0.158730159,-0.169811321,-0.301587302,1248,1294,1478,46,184,230
o9a23,o,"Injury, poisoning and certain other consequences of external causes complicating the puerperium","Pregnancy, childbirth and the puerperium",27,24,18,-0.111111111,-0.25,-0.333333333,1904,1949,2233,45,284,329
p000,p,Newborn affected by maternal hypertensive disorders,Certain conditions originating in the perinatal period,230,153,248,-0.334782609,0.620915033,0.07826087,618,745,587,127,-158,-31
p002,p,Newborn affected by maternal infectious and parasitic diseases,Certain conditions originating in the perinatal period,492,335,387,-0.319105691,0.155223881,-0.213414634,393,470,452,77,-18,59
p0089,p,Newborn affected by other maternal conditions,Certain conditions originating in the perinatal period,144,131,249,-0.090277778,0.900763359,0.729166667,782,803,585,21,-218,-197
p010,p,Newborn affected by incompetent cervix,Certain conditions originating in the perinatal period,18,11,28,-0.388888889,1.545454545,0.555555556,2275,2613,1847,338,-766,-428
p011,p,Newborn affected by premature rupture of membranes,Certain conditions originating in the perinatal period,405,395,385,-0.024691358,-0.025316456,-0.049382716,437,433,453,-4,20,16
p012,p,Newborn affected by oligohydramnios,Certain conditions originating in the perinatal period,106,91,89,-0.141509434,-0.021978022,-0.160377358,933,967,1004,34,37,71
p013,p,Newborn affected by polyhydramnios,Certain conditions originating in the perinatal period,102,78,94,-0.235294118,0.205128205,-0.078431373,950,1041,976,91,-65,26
p015,p,Newborn affected by multiple pregnancy,Certain conditions originating in the perinatal period,45,23,25,-0.488888889,0.086956522,-0.444444444,1481,1985,1945,504,-40,464
p017,p,Newborn affected by malpresentation before labor,Certain conditions originating in the perinatal period,151,134,163,-0.112582781,0.21641791,0.079470199,763,784,716,21,-68,-47
p020,p,Newborn affected by placenta previa,Certain conditions originating in the perinatal period,50,34,46,-0.32,0.352941176,-0.08,1398,1616,1432,218,-184,34
p021,p,Newborn affected by other forms of placental separation and hemorrhage,Certain conditions originating in the perinatal period,70,46,56,-0.342857143,0.217391304,-0.2,1164,1386,1270,222,-116,106
p023,p,Newborn affected by placental transfusion syndromes,Certain conditions originating in the perinatal period,15,18,19,0.2,0.055555556,0.266666667,2421,2215,2170,-206,-45,-251
p024,p,Newborn affected by prolapsed cord,Certain conditions originating in the perinatal period,31,20,19,-0.35483871,-0.05,-0.387096774,1763,2133,2170,370,37,407
p025,p,Newborn affected by other compression of umbilical cord,Certain conditions originating in the perinatal period,1335,1018,1015,-0.237453184,-0.002946955,-0.239700375,199,234,239,35,5,40
p0269,p,Newborn affected by other conditions of umbilical cord,Certain conditions originating in the perinatal period,31,26,85,-0.161290323,2.269230769,1.741935484,1762,1859,1022,97,-837,-740
p0278,p,Newborn affected by other conditions from chorioamnionitis,Certain conditions originating in the perinatal period,338,237,248,-0.298816568,0.046413502,-0.266272189,486,590,583,104,-7,97
p030,p,Newborn affected by breech delivery and extraction,Certain conditions originating in the perinatal period,316,261,289,-0.174050633,0.107279693,-0.085443038,511,555,534,44,-21,23
p031,p,"Newborn affected by other malpresentation, malposition and disproportion during labor and delivery",Certain conditions originating in the perinatal period,240,209,258,-0.129166667,0.234449761,0.075,598,631,567,33,-64,-31
p032,p,Newborn affected by forceps delivery,Certain conditions originating in the perinatal period,12,10,14,-0.166666667,0.4,0.166666667,2572,2655,2430,83,-225,-142
p033,p,Newborn affected by delivery by vacuum extractor [ventouse],Certain conditions originating in the perinatal period,73,72,101,-0.01369863,0.402777778,0.383561644,1138,1096,927,-42,-169,-211
p035,p,Newborn affected by precipitate delivery,Certain conditions originating in the perinatal period,60,41,62,-0.316666667,0.512195122,0.033333333,1260,1474,1200,214,-274,-60
p036,p,Newborn affected by abnormal uterine contractions,Certain conditions originating in the perinatal period,37,39,51,0.054054054,0.307692308,0.378378378,1611,1515,1336,-96,-179,-275
p03811,p,Newborn affected by abnormality in fetal (intrauterine) heart rate or rhythm during labor,Certain conditions originating in the perinatal period,21,21,17,0,-0.19047619,-0.19047619,2107,2078,2265,-29,187,158
p0382,p,Meconium passage during delivery,Certain conditions originating in the perinatal period,276,279,308,0.010869565,0.103942652,0.115942029,557,531,512,-26,-19,-45
p0389,p,Newborn affected by other specified complications of labor and delivery,Certain conditions originating in the perinatal period,21,19,28,-0.095238095,0.473684211,0.333333333,2106,2159,1832,53,-327,-274
p039,p,"Newborn affected by complication of labor and delivery, unspecified",Certain conditions originating in the perinatal period,30,27,39,-0.1,0.444444444,0.3,1785,1811,1548,26,-263,-237
p0414,p,Newborn affected by maternal use of opiates,Certain conditions originating in the perinatal period,129,99,180,-0.23255814,0.818181818,0.395348837,823,915,676,92,-239,-147
p0415,p,Newborn affected by maternal use of antidepressants,Certain conditions originating in the perinatal period,15,10,13,-0.333333333,0.3,-0.133333333,2407,2647,2482,240,-165,75
p0416,p,Newborn affected by maternal use of amphetamines,Certain conditions originating in the perinatal period,69,60,111,-0.130434783,0.85,0.608695652,1166,1209,882,43,-327,-284
p0418,p,Newborn affected by other maternal medication,Certain conditions originating in the perinatal period,44,29,29,-0.340909091,0,-0.340909091,1481,1742,1786,261,44,305
p042,p,Newborn affected by maternal use of tobacco,Certain conditions originating in the perinatal period,144,102,112,-0.291666667,0.098039216,-0.222222222,775,900,880,125,-20,105
p043,p,Newborn affected by maternal use of alcohol,Certain conditions originating in the perinatal period,20,14,16,-0.3,0.142857143,-0.2,2144,2420,2306,276,-114,162
p0440,p,Newborn affected by maternal use of unspecified drugs of addiction,Certain conditions originating in the perinatal period,72,74,66,0.027777778,-0.108108108,-0.083333333,1142,1066,1161,-76,95,19
p0441,p,Newborn affected by maternal use of cocaine,Certain conditions originating in the perinatal period,25,22,22,-0.12,0,-0.12,1947,2017,2033,70,16,86
p0449,p,Newborn affected by maternal use of other drugs of addiction,Certain conditions originating in the perinatal period,546,500,565,-0.084249084,0.13,0.034798535,367,376,355,9,-21,-12
p0481,p,Newborn affected by maternal use of cannabis,Certain conditions originating in the perinatal period,287,223,363,-0.222996516,0.627802691,0.264808362,544,608,466,64,-142,-78
p049,p,"Newborn affected by maternal noxious substance, unspecified",Certain conditions originating in the perinatal period,238,171,212,-0.281512605,0.239766082,-0.109243697,599,681,624,82,-57,25
p0508,p,"Newborn light for gestational age, 2000-2499 grams",Certain conditions originating in the perinatal period,15,16,12,0.066666667,-0.25,-0.2,2398,2308,2526,-90,218,128
p0509,p,"Newborn light for gestational age, 2500 grams and over",Certain conditions originating in the perinatal period,71,75,57,0.056338028,-0.24,-0.197183099,1145,1057,1244,-88,187,99
p0510,p,"Newborn small for gestational age, unspecified weight",Certain conditions originating in the perinatal period,118,139,127,0.177966102,-0.086330935,0.076271186,870,768,809,-102,41,-61
p0514,p,"Newborn small for gestational age, 1000-1249 grams",Certain conditions originating in the perinatal period,12,10,10,-0.166666667,0,-0.166666667,2551,2635,2626,84,-9,75
p0515,p,"Newborn small for gestational age, 1250-1499 grams",Certain conditions originating in the perinatal period,12,23,24,0.916666667,0.043478261,1,2551,1962,1966,-589,4,-585
p0516,p,"Newborn small for gestational age, 1500-1749 grams",Certain conditions originating in the perinatal period,52,37,35,-0.288461538,-0.054054054,-0.326923077,1353,1544,1622,191,78,269
p0517,p,"Newborn small for gestational age, 1750-1999 grams",Certain conditions originating in the perinatal period,86,74,84,-0.139534884,0.135135135,-0.023255814,1027,1061,1013,34,-48,-14
p0518,p,"Newborn small for gestational age, 2000-2499 grams",Certain conditions originating in the perinatal period,581,512,519,-0.118760757,0.013671875,-0.106712565,346,370,377,24,7,31
p0519,p,"Newborn small for gestational age, other",Certain conditions originating in the perinatal period,510,533,550,0.045098039,0.031894934,0.078431373,383,355,361,-28,6,-22
p059,p,"Newborn affected by slow intrauterine growth, unspecified",Certain conditions originating in the perinatal period,228,184,215,-0.192982456,0.168478261,-0.057017544,609,661,617,52,-44,8
p0701,p,"Extremely low birth weight newborn, less than 500 grams",Certain conditions originating in the perinatal period,30,37,36,0.233333333,-0.027027027,0.2,1770,1540,1584,-230,44,-186
p0702,p,"Extremely low birth weight newborn, 500-749 grams",Certain conditions originating in the perinatal period,59,61,81,0.033898305,0.327868852,0.372881356,1263,1187,1029,-76,-158,-234
p0703,p,"Extremely low birth weight newborn, 750-999 grams",Certain conditions originating in the perinatal period,88,96,95,0.090909091,-0.010416667,0.079545455,1012,926,955,-86,29,-57
p0714,p,"Other low birth weight newborn, 1000-1249 grams",Certain conditions originating in the perinatal period,90,78,81,-0.133333333,0.038461538,-0.1,1003,1025,1028,22,3,25
p0715,p,"Other low birth weight newborn, 1250-1499 grams",Certain conditions originating in the perinatal period,133,107,105,-0.195488722,-0.018691589,-0.210526316,803,875,898,72,23,95
p0716,p,"Other low birth weight newborn, 1500-1749 grams",Certain conditions originating in the perinatal period,160,171,128,0.06875,-0.251461988,-0.2,722,678,800,-44,122,78
p0717,p,"Other low birth weight newborn, 1750-1999 grams",Certain conditions originating in the perinatal period,254,232,258,-0.086614173,0.112068966,0.015748031,573,593,562,20,-31,-11
p0718,p,"Other low birth weight newborn, 2000-2499 grams",Certain conditions originating in the perinatal period,999,894,993,-0.105105105,0.110738255,-0.006006006,237,247,241,10,-6,4
p0721,p,"Extreme immaturity of newborn, gestational age less than 23 completed weeks",Certain conditions originating in the perinatal period,36,46,41,0.277777778,-0.108695652,0.138888889,1606,1360,1496,-246,136,-110
p0722,p,"Extreme immaturity of newborn, gestational age 23 completed weeks",Certain conditions originating in the perinatal period,22,25,32,0.136363636,0.28,0.454545455,2035,1860,1692,-175,-168,-343
p0723,p,"Extreme immaturity of newborn, gestational age 24 completed weeks",Certain conditions originating in the perinatal period,34,39,42,0.147058824,0.076923077,0.235294118,1648,1493,1477,-155,-16,-171
p0724,p,"Extreme immaturity of newborn, gestational age 25 completed weeks",Certain conditions originating in the perinatal period,47,46,49,-0.021276596,0.065217391,0.042553191,1413,1360,1346,-53,-14,-67
p0725,p,"Extreme immaturity of newborn, gestational age 26 completed weeks",Certain conditions originating in the perinatal period,67,48,55,-0.28358209,0.145833333,-0.179104478,1167,1331,1259,164,-72,92
p0726,p,"Extreme immaturity of newborn, gestational age 27 completed weeks",Certain conditions originating in the perinatal period,67,41,54,-0.388059701,0.317073171,-0.194029851,1167,1450,1270,283,-180,103
p0730,p,"Preterm newborn, unspecified weeks of gestation",Certain conditions originating in the perinatal period,39,31,29,-0.205128205,-0.064516129,-0.256410256,1550,1659,1760,109,101,210
p0731,p,"Preterm newborn, gestational age 28 completed weeks",Certain conditions originating in the perinatal period,66,73,46,0.106060606,-0.369863014,-0.303030303,1177,1064,1399,-113,335,222
p0732,p,"Preterm newborn, gestational age 29 completed weeks",Certain conditions originating in the perinatal period,85,67,54,-0.211764706,-0.194029851,-0.364705882,1026,1118,1270,92,152,244
p0733,p,"Preterm newborn, gestational age 30 completed weeks",Certain conditions originating in the perinatal period,94,88,75,-0.063829787,-0.147727273,-0.20212766,970,961,1074,-9,113,104
p0734,p,"Preterm newborn, gestational age 31 completed weeks",Certain conditions originating in the perinatal period,127,124,113,-0.023622047,-0.088709677,-0.11023622,819,805,864,-14,59,45
p0735,p,"Preterm newborn, gestational age 32 completed weeks",Certain conditions originating in the perinatal period,185,173,196,-0.064864865,0.132947977,0.059459459,668,673,642,5,-31,-26
p0736,p,"Preterm newborn, gestational age 33 completed weeks",Certain conditions originating in the perinatal period,272,248,253,-0.088235294,0.02016129,-0.069852941,556,563,570,7,7,14
p0737,p,"Preterm newborn, gestational age 34 completed weeks",Certain conditions originating in the perinatal period,544,505,572,-0.071691176,0.132673267,0.051470588,368,371,353,3,-18,-15
p0738,p,"Preterm newborn, gestational age 35 completed weeks",Certain conditions originating in the perinatal period,766,704,731,-0.080939948,0.038352273,-0.045691906,296,307,299,11,-8,3
p0739,p,"Preterm newborn, gestational age 36 completed weeks",Certain conditions originating in the perinatal period,1420,1236,1306,-0.129577465,0.056634304,-0.08028169,192,205,206,13,1,14
p080,p,Exceptionally large newborn baby,Certain conditions originating in the perinatal period,200,202,232,0.01,0.148514851,0.16,648,627,589,-21,-38,-59
p081,p,Other heavy for gestational age newborn,Certain conditions originating in the perinatal period,1901,1762,1913,-0.073119411,0.08569807,0.006312467,154,160,156,6,-4,2
p0821,p,Post-term newborn,Certain conditions originating in the perinatal period,1620,1413,1484,-0.127777778,0.0502477,-0.083950617,172,187,187,15,0,15
p09,p,Abnormal findings on neonatal screening,Certain conditions originating in the perinatal period,205,192,177,-0.063414634,-0.078125,-0.136585366,639,643,663,4,20,24
p120,p,Cephalhematoma due to birth injury,Certain conditions originating in the perinatal period,365,331,317,-0.093150685,-0.042296073,-0.131506849,457,462,495,5,33,38
p122,p,Epicranial subaponeurotic hemorrhage due to birth injury,Certain conditions originating in the perinatal period,17,17,11,0,-0.352941176,-0.352941176,2256,2218,2547,-38,329,291
p123,p,Bruising of scalp due to birth injury,Certain conditions originating in the perinatal period,52,49,58,-0.057692308,0.183673469,0.115384615,1326,1297,1204,-29,-93,-122
p1281,p,Caput succedaneum,Certain conditions originating in the perinatal period,412,334,341,-0.189320388,0.020958084,-0.172330097,423,459,473,36,14,50
p1289,p,Other birth injuries to scalp,Certain conditions originating in the perinatal period,37,41,34,0.108108108,-0.170731707,-0.081081081,1568,1434,1614,-134,180,46
p134,p,Fracture of clavicle due to birth injury,Certain conditions originating in the perinatal period,79,92,96,0.164556962,0.043478261,0.215189873,1059,933,930,-126,-3,-129
p140,p,Erb's paralysis due to birth injury,Certain conditions originating in the perinatal period,24,25,18,0.041666667,-0.28,-0.25,1939,1837,2159,-102,322,220
p143,p,Other brachial plexus birth injuries,Certain conditions originating in the perinatal period,20,26,17,0.3,-0.346153846,-0.15,2098,1804,2211,-294,407,113
p154,p,Birth injury to face,Certain conditions originating in the perinatal period,46,44,75,-0.043478261,0.704545455,0.630434783,1408,1374,1061,-34,-313,-347
p158,p,Other specified birth injuries,Certain conditions originating in the perinatal period,33,27,44,-0.181818182,0.62962963,0.333333333,1652,1763,1419,111,-344,-233
p220,p,Respiratory distress syndrome of newborn,Certain conditions originating in the perinatal period,816,870,894,0.066176471,0.027586207,0.095588235,273,246,256,-27,10,-17
p221,p,Transient tachypnea of newborn,Certain conditions originating in the perinatal period,1187,1083,1236,-0.087615838,0.141274238,0.041280539,208,220,209,12,-11,1
p228,p,Other respiratory distress of newborn,Certain conditions originating in the perinatal period,67,51,34,-0.23880597,-0.333333333,-0.492537313,1150,1266,1609,116,343,459
p229,p,"Respiratory distress of newborn, unspecified",Certain conditions originating in the perinatal period,728,639,730,-0.122252747,0.142410016,0.002747253,304,321,294,17,-27,-10
p239,p,"Congenital pneumonia, unspecified",Certain conditions originating in the perinatal period,16,18,12,0.125,-0.333333333,-0.25,2292,2144,2477,-148,333,185
p2400,p,Meconium aspiration without respiratory symptoms,Certain conditions originating in the perinatal period,32,22,31,-0.3125,0.409090909,-0.03125,1679,1965,1697,286,-268,18
p2401,p,Meconium aspiration with respiratory symptoms,Certain conditions originating in the perinatal period,85,87,80,0.023529412,-0.08045977,-0.058823529,1010,952,1016,-58,64,6
p2411,p,Neonatal aspiration of (clear) amniotic fluid and mucus with respiratory symptoms,Certain conditions originating in the perinatal period,35,22,18,-0.371428571,-0.181818182,-0.485714286,1600,1964,2151,364,187,551
p250,p,Interstitial emphysema originating in the perinatal period,Certain conditions originating in the perinatal period,12,13,13,0.083333333,0,0.083333333,2500,2410,2421,-90,11,-79
p251,p,Pneumothorax originating in the perinatal period,Certain conditions originating in the perinatal period,118,110,110,-0.06779661,0,-0.06779661,848,843,865,-5,22,17
p252,p,Pneumomediastinum originating in the perinatal period,Certain conditions originating in the perinatal period,25,24,26,-0.04,0.083333333,0.04,1895,1872,1840,-23,-32,-55
p269,p,Unspecified pulmonary hemorrhage originating in the perinatal period,Certain conditions originating in the perinatal period,21,22,16,0.047619048,-0.272727273,-0.238095238,2044,1962,2247,-82,285,203
p271,p,Bronchopulmonary dysplasia originating in the perinatal period,Certain conditions originating in the perinatal period,179,182,125,0.016759777,-0.313186813,-0.301675978,666,646,795,-20,149,129
p279,p,Unspecified chronic respiratory disease originating in the perinatal period,Certain conditions originating in the perinatal period,69,72,74,0.043478261,0.027777778,0.072463768,1128,1056,1060,-72,4,-68
p280,p,Primary atelectasis of newborn,Certain conditions originating in the perinatal period,15,16,24,0.066666667,0.5,0.6,2340,2249,1916,-91,-333,-424
p2810,p,Unspecified atelectasis of newborn,Certain conditions originating in the perinatal period,91,90,80,-0.010989011,-0.111111111,-0.120879121,974,932,1014,-42,82,40
p282,p,Cyanotic attacks of newborn,Certain conditions originating in the perinatal period,197,177,186,-0.101522843,0.050847458,-0.055837563,640,653,648,13,-5,8
p284,p,Other apnea of newborn,Certain conditions originating in the perinatal period,1047,937,992,-0.105062082,0.058697972,-0.052531041,227,239,237,12,-2,10
p285,p,Respiratory failure of newborn,Certain conditions originating in the perinatal period,492,493,379,0.00203252,-0.231237323,-0.229674797,379,368,442,-11,74,63
p2889,p,Other specified respiratory conditions of newborn,Certain conditions originating in the perinatal period,119,130,133,0.092436975,0.023076923,0.117647059,839,768,761,-71,-7,-78
p289,p,"Respiratory condition of newborn, unspecified",Certain conditions originating in the perinatal period,55,43,41,-0.218181818,-0.046511628,-0.254545455,1276,1373,1461,97,88,185
p2911,p,Neonatal tachycardia,Certain conditions originating in the perinatal period,146,127,127,-0.130136986,0,-0.130136986,745,776,785,31,9,40
p2912,p,Neonatal bradycardia,Certain conditions originating in the perinatal period,462,423,470,-0.084415584,0.111111111,0.017316017,389,405,387,16,-18,-2
p2930,p,Pulmonary hypertension of newborn,Certain conditions originating in the perinatal period,97,109,107,0.12371134,-0.018348624,0.103092784,932,838,864,-94,26,-68
p2981,p,Cardiac arrest of newborn,Certain conditions originating in the perinatal period,19,11,10,-0.421052632,-0.090909091,-0.473684211,2120,2511,2558,391,47,438
p2989,p,Other cardiovascular disorders originating in the perinatal period,Certain conditions originating in the perinatal period,673,638,517,-0.052005944,-0.189655172,-0.23179792,318,321,367,3,46,49
p364,p,Sepsis of newborn due to Escherichia coli,Certain conditions originating in the perinatal period,10,22,13,1.2,-0.409090909,0.3,2577,1950,2405,-627,455,-172
p369,p,"Bacterial sepsis of newborn, unspecified",Certain conditions originating in the perinatal period,432,355,353,-0.178240741,-0.005633803,-0.18287037,400,436,456,36,20,56
p375,p,Neonatal candidiasis,Certain conditions originating in the perinatal period,207,185,220,-0.106280193,0.189189189,0.062801932,628,639,591,11,-48,-37
p391,p,Neonatal conjunctivitis and dacryocystitis,Certain conditions originating in the perinatal period,53,43,61,-0.188679245,0.418604651,0.150943396,1290,1367,1154,77,-213,-136
p393,p,Neonatal urinary tract infection,Certain conditions originating in the perinatal period,95,102,111,0.073684211,0.088235294,0.168421053,939,862,846,-77,-16,-93
p398,p,Other specified infections specific to the perinatal period,Certain conditions originating in the perinatal period,70,83,43,0.185714286,-0.481927711,-0.385714286,1107,963,1419,-144,456,312
p520,p,"Intraventricular (nontraumatic) hemorrhage, grade 1, of newborn",Certain conditions originating in the perinatal period,72,61,82,-0.152777778,0.344262295,0.138888889,1095,1145,990,50,-155,-105
p521,p,"Intraventricular (nontraumatic) hemorrhage, grade 2, of newborn",Certain conditions originating in the perinatal period,32,25,40,-0.21875,0.6,0.25,1658,1810,1464,152,-346,-194
p5221,p,"Intraventricular (nontraumatic) hemorrhage, grade 3, of newborn",Certain conditions originating in the perinatal period,11,14,13,0.272727273,-0.071428571,0.181818182,2517,2336,2398,-181,62,-119
p5222,p,"Intraventricular (nontraumatic) hemorrhage, grade 4, of newborn",Certain conditions originating in the perinatal period,22,17,24,-0.227272727,0.411764706,0.090909091,1981,2179,1899,198,-280,-82
p541,p,Neonatal melena,Certain conditions originating in the perinatal period,27,15,26,-0.444444444,0.733333333,-0.037037037,1807,2272,1821,465,-451,14
p545,p,Neonatal cutaneous hemorrhage,Certain conditions originating in the perinatal period,546,459,454,-0.159340659,-0.010893246,-0.168498168,356,388,395,32,7,39
p548,p,Other specified neonatal hemorrhages,Certain conditions originating in the perinatal period,18,18,15,0,-0.166666667,-0.166666667,2168,2117,2278,-51,161,110
p550,p,Rh isoimmunization of newborn,Certain conditions originating in the perinatal period,109,95,96,-0.128440367,0.010526316,-0.119266055,875,894,913,19,19,38
p551,p,ABO isoimmunization of newborn,Certain conditions originating in the perinatal period,914,923,977,0.009846827,0.058504875,0.06892779,245,241,240,-4,-1,-5
p559,p,"Hemolytic disease of newborn, unspecified",Certain conditions originating in the perinatal period,10,15,14,0.5,-0.066666667,0.4,2563,2268,2332,-295,64,-231
p590,p,Neonatal jaundice associated with preterm delivery,Certain conditions originating in the perinatal period,1831,1583,1674,-0.135445112,0.057485786,-0.085745494,158,178,171,20,-7,13
p593,p,Neonatal jaundice from breast milk inhibitor,Certain conditions originating in the perinatal period,85,73,96,-0.141176471,0.315068493,0.129411765,992,1027,911,35,-116,-81
p598,p,Neonatal jaundice from other specified causes,Certain conditions originating in the perinatal period,21,36,31,0.714285714,-0.138888889,0.476190476,2018,1496,1671,-522,175,-347
p599,p,"Neonatal jaundice, unspecified",Certain conditions originating in the perinatal period,5741,4537,4369,-0.209719561,-0.037028874,-0.238982756,60,73,81,13,8,21
p60,p,Disseminated intravascular coagulation of newborn,Certain conditions originating in the perinatal period,39,23,32,-0.41025641,0.391304348,-0.179487179,1502,1887,1637,385,-250,135
p610,p,Transient neonatal thrombocytopenia,Certain conditions originating in the perinatal period,309,249,293,-0.194174757,0.176706827,-0.051779935,493,543,506,50,-37,13
p611,p,Polycythemia neonatorum,Certain conditions originating in the perinatal period,68,53,48,-0.220588235,-0.094339623,-0.294117647,1112,1217,1317,105,100,205
p612,p,Anemia of prematurity,Certain conditions originating in the perinatal period,641,579,660,-0.096723869,0.139896373,0.029641186,320,330,310,10,-20,-10
p614,p,"Other congenital anemias, not elsewhere classified",Certain conditions originating in the perinatal period,92,87,99,-0.054347826,0.137931034,0.076086957,948,931,892,-17,-39,-56
p615,p,Transient neonatal neutropenia,Certain conditions originating in the perinatal period,55,68,59,0.236363636,-0.132352941,0.072727273,1257,1065,1164,-192,99,-93
p616,p,Other transient neonatal disorders of coagulation,Certain conditions originating in the perinatal period,14,12,16,-0.142857143,0.333333333,0.142857143,2355,2430,2212,75,-218,-143
p618,p,Other specified perinatal hematological disorders,Certain conditions originating in the perinatal period,19,24,31,0.263157895,0.291666667,0.631578947,2097,1841,1664,-256,-177,-433
p700,p,Syndrome of infant of mother with gestational diabetes,Certain conditions originating in the perinatal period,890,727,984,-0.183146067,0.353507565,0.105617978,249,288,237,39,-51,-12
p701,p,Syndrome of infant of a diabetic mother,Certain conditions originating in the perinatal period,707,667,650,-0.056577086,-0.025487256,-0.080622348,307,306,311,-1,5,4
p704,p,Other neonatal hypoglycemia,Certain conditions originating in the perinatal period,1694,1660,1851,-0.020070838,0.115060241,0.092680047,167,166,158,-1,-8,-9
p711,p,Other neonatal hypocalcemia,Certain conditions originating in the perinatal period,133,102,128,-0.233082707,0.254901961,-0.037593985,768,853,767,85,-86,-1
p712,p,Neonatal hypomagnesemia,Certain conditions originating in the perinatal period,12,15,19,0.25,0.266666667,0.583333333,2454,2253,2059,-201,-194,-395
p718,p,Other transitory neonatal disorders of calcium and magnesium metabolism,Certain conditions originating in the perinatal period,37,49,56,0.324324324,0.142857143,0.513513514,1526,1258,1191,-268,-67,-335
p722,p,"Other transitory neonatal disorders of thyroid function, not elsewhere classified",Certain conditions originating in the perinatal period,13,11,11,-0.153846154,0,-0.153846154,2408,2476,2480,68,4,72
p740,p,Late metabolic acidosis of newborn,Certain conditions originating in the perinatal period,36,32,40,-0.111111111,0.25,0.111111111,1542,1571,1448,29,-123,-94
p741,p,Dehydration of newborn,Certain conditions originating in the perinatal period,157,144,153,-0.082802548,0.0625,-0.025477707,700,715,688,15,-27,-12
p7421,p,Hypernatremia of newborn,Certain conditions originating in the perinatal period,94,71,99,-0.244680851,0.394366197,0.053191489,930,1036,887,106,-149,-43
p7422,p,Hyponatremia of newborn,Certain conditions originating in the perinatal period,227,225,268,-0.008810573,0.191111111,0.18061674,585,576,526,-9,-50,-59
p7431,p,Hyperkalemia of newborn,Certain conditions originating in the perinatal period,50,51,61,0.02,0.196078431,0.22,1308,1229,1136,-79,-93,-172
p7432,p,Hypokalemia of newborn,Certain conditions originating in the perinatal period,75,50,62,-0.333333333,0.24,-0.173333333,1050,1238,1129,188,-109,79
p7441,p,Alkalosis of newborn,Certain conditions originating in the perinatal period,45,39,38,-0.133333333,-0.025641026,-0.155555556,1385,1426,1479,41,53,94
p74421,p,Hyperchloremia of newborn,Certain conditions originating in the perinatal period,34,35,33,0.029411765,-0.057142857,-0.029411765,1576,1498,1592,-78,94,16
p74422,p,Hypochloremia of newborn,Certain conditions originating in the perinatal period,18,30,15,0.666666667,-0.5,-0.166666667,2142,1621,2250,-521,629,108
p7449,p,Other transitory electrolyte disturbance of newborn,Certain conditions originating in the perinatal period,12,15,17,0.25,0.133333333,0.416666667,2443,2243,2150,-200,-93,-293
p760,p,Meconium plug syndrome,Certain conditions originating in the perinatal period,22,12,16,-0.454545455,0.333333333,-0.272727273,1955,2413,2196,458,-217,241
p761,p,Transitory ileus of newborn,Certain conditions originating in the perinatal period,48,22,36,-0.541666667,0.636363636,-0.25,1336,1915,1506,579,-409,170
p772,p,Stage 2 necrotizing enterocolitis in newborn,Certain conditions originating in the perinatal period,13,17,16,0.307692308,-0.058823529,0.230769231,2397,2149,2195,-248,46,-202
p779,p,"Necrotizing enterocolitis in newborn, unspecified",Certain conditions originating in the perinatal period,19,23,25,0.210526316,0.086956522,0.315789474,2082,1867,1825,-215,-42,-257
p783,p,Noninfective neonatal diarrhea,Certain conditions originating in the perinatal period,33,20,14,-0.393939394,-0.3,-0.575757576,1601,2008,2300,407,292,699
p7883,p,Newborn esophageal reflux,Certain conditions originating in the perinatal period,177,174,201,-0.016949153,0.155172414,0.13559322,652,639,608,-13,-31,-44
p808,p,Other hypothermia of newborn,Certain conditions originating in the perinatal period,19,29,26,0.526315789,-0.103448276,0.368421053,2080,1646,1792,-434,146,-288
p809,p,"Hypothermia of newborn, unspecified",Certain conditions originating in the perinatal period,170,161,219,-0.052941176,0.360248447,0.288235294,667,670,582,3,-88,-85
p819,p,"Disturbance of temperature regulation of newborn, unspecified",Certain conditions originating in the perinatal period,475,355,417,-0.252631579,0.174647887,-0.122105263,375,428,407,53,-21,32
p831,p,Neonatal erythema toxicum,Certain conditions originating in the perinatal period,385,267,267,-0.306493506,0,-0.306493506,421,517,527,96,10,106
p8330,p,Unspecified edema specific to newborn,Certain conditions originating in the perinatal period,94,76,71,-0.191489362,-0.065789474,-0.244680851,925,990,1055,65,65,130
p8339,p,Other edema specific to newborn,Certain conditions originating in the perinatal period,22,23,21,0.045454545,-0.086956522,-0.045454545,1948,1861,1951,-87,90,3
p835,p,Congenital hydrocele,Certain conditions originating in the perinatal period,262,233,224,-0.110687023,-0.038626609,-0.145038168,537,562,574,25,12,37
p8381,p,Umbilical granuloma,Certain conditions originating in the perinatal period,11,12,14,0.090909091,0.166666667,0.272727273,2469,2401,2292,-68,-109,-177
p8388,p,Other specified conditions of integument specific to newborn,Certain conditions originating in the perinatal period,342,284,313,-0.169590643,0.102112676,-0.084795322,455,499,479,44,-20,24
p84,p,Other problems with newborn,Certain conditions originating in the perinatal period,729,777,765,0.065843621,-0.015444015,0.049382716,297,267,277,-30,10,-20
p90,p,Convulsions of newborn,Certain conditions originating in the perinatal period,108,88,100,-0.185185185,0.136363636,-0.074074074,860,911,870,51,-41,10
p911,p,Acquired periventricular cysts of newborn,Certain conditions originating in the perinatal period,29,21,27,-0.275862069,0.285714286,-0.068965517,1706,1951,1747,245,-204,41
p912,p,Neonatal cerebral leukomalacia,Certain conditions originating in the perinatal period,15,11,19,-0.266666667,0.727272727,0.266666667,2275,2448,2036,173,-412,-239
p9160,p,"Hypoxic ischemic encephalopathy [HIE], unspecified",Certain conditions originating in the perinatal period,43,41,67,-0.046511628,0.634146341,0.558139535,1404,1378,1075,-26,-303,-329
p9162,p,Moderate hypoxic ischemic encephalopathy [HIE],Certain conditions originating in the perinatal period,16,15,11,-0.0625,-0.266666667,-0.3125,2218,2226,2450,8,224,232
p9163,p,Severe hypoxic ischemic encephalopathy [HIE],Certain conditions originating in the perinatal period,27,17,23,-0.37037037,0.352941176,-0.148148148,1769,2134,1880,365,-254,111
p9201,p,Bilious vomiting of newborn,Certain conditions originating in the perinatal period,44,42,64,-0.045454545,0.523809524,0.454545455,1386,1351,1098,-35,-253,-288
p9209,p,Other vomiting of newborn,Certain conditions originating in the perinatal period,321,284,418,-0.115264798,0.471830986,0.302180685,474,498,405,24,-93,-69
p921,p,Regurgitation and rumination of newborn,Certain conditions originating in the perinatal period,21,19,42,-0.095238095,1.210526316,1,1980,2028,1400,48,-628,-580
p922,p,Slow feeding of newborn,Certain conditions originating in the perinatal period,354,305,324,-0.138418079,0.062295082,-0.084745763,444,475,467,31,-8,23
p923,p,Underfeeding of newborn,Certain conditions originating in the perinatal period,20,35,18,0.75,-0.485714286,-0.1,2019,1485,2078,-534,593,59
p925,p,Neonatal difficulty in feeding at breast,Certain conditions originating in the perinatal period,327,312,252,-0.04587156,-0.192307692,-0.229357798,465,464,539,-1,75,74
p926,p,Failure to thrive in newborn,Certain conditions originating in the perinatal period,58,61,51,0.051724138,-0.163934426,-0.120689655,1202,1116,1241,-86,125,39
p928,p,Other feeding problems of newborn,Certain conditions originating in the perinatal period,216,206,284,-0.046296296,0.378640777,0.314814815,595,591,503,-4,-88,-92
p929,p,"Feeding problem of newborn, unspecified",Certain conditions originating in the perinatal period,1278,1060,1229,-0.17057903,0.159433962,-0.038341158,197,220,206,23,-14,9
p941,p,Congenital hypertonia,Certain conditions originating in the perinatal period,21,22,13,0.047619048,-0.409090909,-0.380952381,1975,1894,2333,-81,439,358
p942,p,Congenital hypotonia,Certain conditions originating in the perinatal period,170,170,136,0,-0.2,-0.2,657,635,722,-22,87,65
p960,p,Congenital renal failure,Certain conditions originating in the perinatal period,21,18,19,-0.142857143,0.055555556,-0.095238095,1974,2063,2025,89,-38,51
p961,p,Neonatal withdrawal symptoms from maternal use of drugs of addiction,Certain conditions originating in the perinatal period,420,361,485,-0.14047619,0.343490305,0.154761905,396,423,369,27,-54,-27
p9681,p,Exposure to (parental) (environmental) tobacco smoke in the perinatal period,Certain conditions originating in the perinatal period,35,24,19,-0.314285714,-0.208333333,-0.457142857,1537,1806,2024,269,218,487
p9683,p,Meconium staining,Certain conditions originating in the perinatal period,2238,1864,2198,-0.167113494,0.179184549,-0.017873101,129,150,136,21,-14,7
p9689,p,Other specified conditions originating in the perinatal period,Certain conditions originating in the perinatal period,737,643,728,-0.127544098,0.132192846,-0.012211669,292,310,286,18,-24,-6
q019,q,"Encephalocele, unspecified",Congenital and chromosomal abnormalities,13,10,12,-0.230769231,0.2,-0.076923077,2363,2482,2376,119,-106,13
q02,q,Microcephaly,Congenital and chromosomal abnormalities,135,127,139,-0.059259259,0.094488189,0.02962963,745,745,707,0,-38,-38
q030,q,Malformations of aqueduct of Sylvius,Congenital and chromosomal abnormalities,16,15,18,-0.0625,0.2,0.125,2200,2208,2067,8,-141,-133
q031,q,Atresia of foramina of Magendie and Luschka,Congenital and chromosomal abnormalities,38,31,19,-0.184210526,-0.387096774,-0.5,1482,1568,2021,86,453,539
q039,q,"Congenital hydrocephalus, unspecified",Congenital and chromosomal abnormalities,92,88,91,-0.043478261,0.034090909,-0.010869565,922,901,908,-21,7,-14
q040,q,Congenital malformations of corpus callosum,Congenital and chromosomal abnormalities,96,78,67,-0.1875,-0.141025641,-0.302083333,902,955,1064,53,109,162
q043,q,Other reduction deformities of brain,Congenital and chromosomal abnormalities,42,37,24,-0.119047619,-0.351351351,-0.428571429,1400,1439,1842,39,403,442
q044,q,Septo-optic dysplasia of brain,Congenital and chromosomal abnormalities,35,45,29,0.285714286,-0.355555556,-0.171428571,1530,1285,1661,-245,376,131
q046,q,Congenital cerebral cysts,Congenital and chromosomal abnormalities,82,54,66,-0.341463415,0.222222222,-0.195121951,982,1174,1073,192,-101,91
q048,q,Other specified congenital malformations of brain,Congenital and chromosomal abnormalities,41,42,54,0.024390244,0.285714286,0.317073171,1418,1336,1189,-82,-147,-229
q049,q,"Congenital malformation of brain, unspecified",Congenital and chromosomal abnormalities,13,14,17,0.076923077,0.214285714,0.307692308,2354,2258,2109,-96,-149,-245
q052,q,Lumbar spina bifida with hydrocephalus,Congenital and chromosomal abnormalities,16,18,23,0.125,0.277777778,0.4375,2193,2051,1861,-142,-190,-332
q054,q,Unspecified spina bifida with hydrocephalus,Congenital and chromosomal abnormalities,55,55,60,0,0.090909091,0.090909091,1226,1161,1119,-65,-42,-107
q057,q,Lumbar spina bifida without hydrocephalus,Congenital and chromosomal abnormalities,23,21,27,-0.086956522,0.285714286,0.173913043,1878,1927,1727,49,-200,-151
q059,q,"Spina bifida, unspecified",Congenital and chromosomal abnormalities,238,215,208,-0.096638655,-0.03255814,-0.12605042,558,578,584,20,6,26
q068,q,Other specified congenital malformations of spinal cord,Congenital and chromosomal abnormalities,86,63,84,-0.26744186,0.333333333,-0.023255814,951,1082,940,131,-142,-11
q0700,q,Arnold-Chiari syndrome without spina bifida or hydrocephalus,Congenital and chromosomal abnormalities,27,32,30,0.185185185,-0.0625,0.111111111,1746,1532,1644,-214,112,-102
q0701,q,Arnold-Chiari syndrome with spina bifida,Congenital and chromosomal abnormalities,17,18,18,0.058823529,0,0.058823529,2140,2046,2054,-94,8,-86
q0703,q,Arnold-Chiari syndrome with spina bifida and hydrocephalus,Congenital and chromosomal abnormalities,40,33,33,-0.175,0,-0.175,1434,1510,1561,76,51,127
q105,q,Congenital stenosis and stricture of lacrimal duct,Congenital and chromosomal abnormalities,29,25,24,-0.137931034,-0.04,-0.172413793,1681,1748,1833,67,85,152
q170,q,Accessory auricle,Congenital and chromosomal abnormalities,77,67,66,-0.12987013,-0.014925373,-0.142857143,1014,1045,1071,31,26,57
q172,q,Microtia,Congenital and chromosomal abnormalities,34,17,19,-0.5,0.117647059,-0.441176471,1540,2100,2006,560,-94,466
q174,q,Misplaced ear,Congenital and chromosomal abnormalities,32,16,18,-0.5,0.125,-0.4375,1595,2148,2050,553,-98,455
q180,q,"Sinus, fistula and cyst of branchial cleft",Congenital and chromosomal abnormalities,20,15,10,-0.25,-0.333333333,-0.5,1990,2189,2451,199,262,461
q181,q,Preauricular sinus and cyst,Congenital and chromosomal abnormalities,27,10,19,-0.62962963,0.9,-0.296296296,1741,2459,2006,718,-453,265
q201,q,Double outlet right ventricle,Congenital and chromosomal abnormalities,41,27,42,-0.341463415,0.555555556,0.024390244,1414,1676,1382,262,-294,-32
q203,q,Discordant ventriculoarterial connection,Congenital and chromosomal abnormalities,31,42,55,0.35483871,0.30952381,0.774193548,1615,1332,1174,-283,-158,-441
q204,q,Double inlet ventricle,Congenital and chromosomal abnormalities,57,39,58,-0.315789474,0.487179487,0.01754386,1198,1394,1133,196,-261,-65
q210,q,Ventricular septal defect,Congenital and chromosomal abnormalities,548,510,557,-0.069343066,0.092156863,0.016423358,342,349,336,7,-13,-6
q211,q,Atrial septal defect,Congenital and chromosomal abnormalities,2371,2205,2141,-0.070012653,-0.029024943,-0.097005483,123,126,140,3,14,17
q212,q,Atrioventricular septal defect,Congenital and chromosomal abnormalities,64,65,53,0.015625,-0.184615385,-0.171875,1117,1059,1192,-58,133,75
q213,q,Tetralogy of Fallot,Congenital and chromosomal abnormalities,74,69,52,-0.067567568,-0.246376812,-0.297297297,1036,1027,1207,-9,180,171
q220,q,Pulmonary valve atresia,Congenital and chromosomal abnormalities,16,21,19,0.3125,-0.095238095,0.1875,2173,1914,1999,-259,85,-174
q221,q,Congenital pulmonary valve stenosis,Congenital and chromosomal abnormalities,57,45,46,-0.210526316,0.022222222,-0.192982456,1194,1276,1304,82,28,110
q224,q,Congenital tricuspid stenosis,Congenital and chromosomal abnormalities,28,19,26,-0.321428571,0.368421053,-0.071428571,1697,1991,1749,294,-242,52
q225,q,Ebstein's anomaly,Congenital and chromosomal abnormalities,19,11,15,-0.421052632,0.363636364,-0.210526316,2023,2396,2182,373,-214,159
q228,q,Other congenital malformations of tricuspid valve,Congenital and chromosomal abnormalities,74,57,60,-0.22972973,0.052631579,-0.189189189,1036,1136,1114,100,-22,78
q230,q,Congenital stenosis of aortic valve,Congenital and chromosomal abnormalities,21,27,19,0.285714286,-0.296296296,-0.095238095,1941,1668,1996,-273,328,55
q231,q,Congenital insufficiency of aortic valve,Congenital and chromosomal abnormalities,297,329,322,0.107744108,-0.021276596,0.084175084,493,440,461,-53,21,-32
q232,q,Congenital mitral stenosis,Congenital and chromosomal abnormalities,18,13,16,-0.277777778,0.230769231,-0.111111111,2075,2280,2128,205,-152,53
q233,q,Congenital mitral insufficiency,Congenital and chromosomal abnormalities,30,26,23,-0.133333333,-0.115384615,-0.233333333,1636,1704,1842,68,138,206
q234,q,Hypoplastic left heart syndrome,Congenital and chromosomal abnormalities,58,40,45,-0.310344828,0.125,-0.224137931,1183,1369,1317,186,-52,134
q240,q,Dextrocardia,Congenital and chromosomal abnormalities,30,36,31,0.2,-0.138888889,0.033333333,1635,1437,1607,-198,170,-28
q241,q,Levocardia,Congenital and chromosomal abnormalities,13,13,10,0,-0.230769231,-0.230769231,2322,2277,2432,-45,155,110
q244,q,Congenital subaortic stenosis,Congenital and chromosomal abnormalities,13,19,14,0.461538462,-0.263157895,0.076923077,2322,1985,2229,-337,244,-93
q245,q,Malformation of coronary vessels,Congenital and chromosomal abnormalities,114,106,124,-0.070175439,0.169811321,0.087719298,825,815,757,-10,-58,-68
q248,q,Other specified congenital malformations of heart,Congenital and chromosomal abnormalities,53,50,44,-0.056603774,-0.12,-0.169811321,1231,1204,1336,-27,132,105
q249,q,"Congenital malformation of heart, unspecified",Congenital and chromosomal abnormalities,42,32,38,-0.238095238,0.1875,-0.095238095,1384,1517,1435,133,-82,51
q250,q,Patent ductus arteriosus,Congenital and chromosomal abnormalities,793,703,725,-0.113493064,0.031294452,-0.085750315,274,292,288,18,-4,14
q251,q,Coarctation of aorta,Congenital and chromosomal abnormalities,59,58,76,-0.016949153,0.310344828,0.288135593,1166,1123,993,-43,-130,-173
q2542,q,Hypoplasia of aorta,Congenital and chromosomal abnormalities,24,22,27,-0.083333333,0.227272727,0.125,1820,1855,1705,35,-150,-115
q2543,q,Congenital aneurysm of aorta,Congenital and chromosomal abnormalities,19,21,21,0.105263158,0,0.105263158,2011,1901,1896,-110,-5,-115
q2545,q,Double aortic arch,Congenital and chromosomal abnormalities,13,10,15,-0.230769231,0.5,0.153846154,2315,2432,2168,117,-264,-147
q2547,q,Right aortic arch,Congenital and chromosomal abnormalities,33,29,32,-0.121212121,0.103448276,-0.03030303,1550,1595,1570,45,-25,20
q2549,q,Other congenital malformations of aorta,Congenital and chromosomal abnormalities,19,24,21,0.263157895,-0.125,0.105263158,2010,1769,1895,-241,126,-115
q255,q,Atresia of pulmonary artery,Congenital and chromosomal abnormalities,25,23,29,-0.08,0.260869565,0.16,1786,1807,1635,21,-172,-151
q256,q,Stenosis of pulmonary artery,Congenital and chromosomal abnormalities,98,109,122,0.112244898,0.119266055,0.244897959,888,802,762,-86,-40,-126
q2572,q,Congenital pulmonary arteriovenous malformation,Congenital and chromosomal abnormalities,19,17,10,-0.105263158,-0.411764706,-0.473684211,2008,2072,2419,64,347,411
q2579,q,Other congenital malformations of pulmonary artery,Congenital and chromosomal abnormalities,23,15,27,-0.347826087,0.8,0.173913043,1846,2160,1702,314,-458,-144
q258,q,Other congenital malformations of other great arteries,Congenital and chromosomal abnormalities,15,12,10,-0.2,-0.166666667,-0.333333333,2202,2323,2418,121,95,216
q261,q,Persistent left superior vena cava,Congenital and chromosomal abnormalities,26,26,15,0,-0.423076923,-0.423076923,1743,1695,2163,-48,468,420
q262,q,Total anomalous pulmonary venous connection,Congenital and chromosomal abnormalities,22,22,14,0,-0.363636364,-0.363636364,1885,1850,2215,-35,365,330
q263,q,Partial anomalous pulmonary venous connection,Congenital and chromosomal abnormalities,14,13,18,-0.071428571,0.384615385,0.285714286,2247,2261,2021,14,-240,-226
q270,q,Congenital absence and hypoplasia of umbilical artery,Congenital and chromosomal abnormalities,73,70,88,-0.04109589,0.257142857,0.205479452,1038,1012,914,-26,-98,-124
q272,q,Other congenital malformations of renal artery,Congenital and chromosomal abnormalities,16,17,18,0.0625,0.058823529,0.125,2147,2069,2020,-78,-49,-127
q2730,q,"Arteriovenous malformation, site unspecified",Congenital and chromosomal abnormalities,22,26,23,0.181818182,-0.115384615,0.045454545,1884,1694,1829,-190,135,-55
q2733,q,Arteriovenous malformation of digestive system vessel,Congenital and chromosomal abnormalities,56,45,44,-0.196428571,-0.022222222,-0.214285714,1192,1268,1332,76,64,140
q2739,q,"Arteriovenous malformation, other site",Congenital and chromosomal abnormalities,17,27,23,0.588235294,-0.148148148,0.352941176,2098,1656,1828,-442,172,-270
q278,q,Other specified congenital malformations of peripheral vascular system,Congenital and chromosomal abnormalities,41,37,45,-0.097560976,0.216216216,0.097560976,1397,1415,1312,18,-103,-85
q279,q,"Congenital malformation of peripheral vascular system, unspecified",Congenital and chromosomal abnormalities,26,14,32,-0.461538462,1.285714286,0.230769231,1740,2207,1566,467,-641,-174
q282,q,Arteriovenous malformation of cerebral vessels,Congenital and chromosomal abnormalities,118,102,75,-0.13559322,-0.264705882,-0.36440678,804,827,997,23,170,193
q283,q,Other malformations of cerebral vessels,Congenital and chromosomal abnormalities,82,83,83,0.012195122,0,0.012195122,973,922,937,-51,15,-36
q315,q,Congenital laryngomalacia,Congenital and chromosomal abnormalities,108,108,115,0,0.064814815,0.064814815,843,806,793,-37,-13,-50
q320,q,Congenital tracheomalacia,Congenital and chromosomal abnormalities,65,42,36,-0.353846154,-0.142857143,-0.446153846,1095,1315,1452,220,137,357
q322,q,Congenital bronchomalacia,Congenital and chromosomal abnormalities,15,16,12,0.066666667,-0.25,-0.2,2189,2107,2307,-82,200,118
q330,q,Congenital cystic lung,Congenital and chromosomal abnormalities,11,13,12,0.181818182,-0.076923077,0.090909091,2370,2249,2307,-121,58,-63
q336,q,Congenital hypoplasia and dysplasia of lung,Congenital and chromosomal abnormalities,56,41,25,-0.267857143,-0.390243902,-0.553571429,1188,1338,1757,150,419,569
q359,q,"Cleft palate, unspecified",Congenital and chromosomal abnormalities,26,25,31,-0.038461538,0.24,0.192307692,1735,1715,1592,-20,-123,-143
q369,q,"Cleft lip, unilateral",Congenital and chromosomal abnormalities,11,15,12,0.363636364,-0.2,0.090909091,2368,2145,2305,-223,160,-63
q379,q,Unspecified cleft palate with unilateral cleft lip,Congenital and chromosomal abnormalities,27,11,31,-0.592592593,1.818181818,0.148148148,1712,2354,1592,642,-762,-120
q380,q,"Congenital malformations of lips, not elsewhere classified",Congenital and chromosomal abnormalities,26,21,36,-0.192307692,0.714285714,0.384615385,1734,1884,1452,150,-432,-282
q381,q,Ankyloglossia,Congenital and chromosomal abnormalities,873,744,749,-0.147766323,0.00672043,-0.142038946,251,272,279,21,7,28
q382,q,Macroglossia,Congenital and chromosomal abnormalities,19,18,14,-0.052631579,-0.222222222,-0.263157895,1991,2000,2198,9,198,207
q394,q,Esophageal web,Congenital and chromosomal abnormalities,12,13,12,0.083333333,-0.076923077,0,2325,2243,2301,-82,58,-24
q396,q,Congenital diverticulum of esophagus,Congenital and chromosomal abnormalities,11,16,17,0.454545455,0.0625,0.545454545,2363,2102,2051,-261,-51,-312
q400,q,Congenital hypertrophic pyloric stenosis,Congenital and chromosomal abnormalities,42,46,49,0.095238095,0.065217391,0.166666667,1373,1256,1239,-117,-17,-134
q410,q,"Congenital absence, atresia and stenosis of duodenum",Congenital and chromosomal abnormalities,15,21,15,0.4,-0.285714286,0,2182,1882,2144,-300,262,-38
q423,q,"Congenital absence, atresia and stenosis of anus without fistula",Congenital and chromosomal abnormalities,30,30,34,0,0.133333333,0.133333333,1618,1558,1505,-60,-53,-113
q430,q,Meckel's diverticulum (displaced) (hypertrophic),Congenital and chromosomal abnormalities,62,57,67,-0.080645161,0.175438596,0.080645161,1126,1126,1050,0,-76,-76
q431,q,Hirschsprung's disease,Congenital and chromosomal abnormalities,50,39,46,-0.22,0.179487179,-0.08,1257,1371,1291,114,-80,34
q433,q,Congenital malformations of intestinal fixation,Congenital and chromosomal abnormalities,84,73,50,-0.130952381,-0.315068493,-0.404761905,953,985,1223,32,238,270
q438,q,Other specified congenital malformations of intestine,Congenital and chromosomal abnormalities,230,187,222,-0.186956522,0.187165775,-0.034782609,561,609,559,48,-50,-2
q442,q,Atresia of bile ducts,Congenital and chromosomal abnormalities,22,25,24,0.136363636,-0.04,0.090909091,1866,1708,1790,-158,82,-76
q444,q,Choledochal cyst,Congenital and chromosomal abnormalities,12,10,18,-0.166666667,0.8,0.5,2317,2392,1999,75,-393,-318
q446,q,Cystic disease of liver,Congenital and chromosomal abnormalities,59,52,42,-0.118644068,-0.192307692,-0.288135593,1156,1174,1355,18,181,199
q451,q,Annular pancreas,Congenital and chromosomal abnormalities,11,13,10,0.181818182,-0.230769231,-0.090909091,2353,2233,2383,-120,150,30
q453,q,Other congenital malformations of pancreas and pancreatic duct,Congenital and chromosomal abnormalities,78,96,79,0.230769231,-0.177083333,0.012820513,994,854,966,-140,112,-28
q513,q,Bicornate uterus,Congenital and chromosomal abnormalities,125,93,111,-0.256,0.193548387,-0.112,768,867,807,99,-60,39
q514,q,Unicornate uterus,Congenital and chromosomal abnormalities,17,14,13,-0.176470588,-0.071428571,-0.235294118,2076,2184,2239,108,55,163
q51810,q,Arcuate uterus,Congenital and chromosomal abnormalities,13,22,11,0.692307692,-0.5,-0.153846154,2275,1828,2339,-447,511,64
q5310,q,"Unspecified undescended testicle, unilateral",Congenital and chromosomal abnormalities,113,133,138,0.17699115,0.037593985,0.221238938,824,721,705,-103,-16,-119
q53112,q,Unilateral inguinal testis,Congenital and chromosomal abnormalities,10,14,21,0.4,0.5,1.1,2395,2182,1866,-213,-316,-529
q5320,q,"Undescended testicle, unspecified, bilateral",Congenital and chromosomal abnormalities,93,64,56,-0.311827957,-0.125,-0.397849462,901,1051,1139,150,88,238
q540,q,"Hypospadias, balanic",Congenital and chromosomal abnormalities,14,24,25,0.714285714,0.041666667,0.785714286,2215,1743,1742,-472,-1,-473
q541,q,"Hypospadias, penile",Congenital and chromosomal abnormalities,25,30,20,0.2,-0.333333333,-0.2,1760,1549,1905,-211,356,145
q544,q,Congenital chordee,Congenital and chromosomal abnormalities,50,62,41,0.24,-0.338709677,-0.18,1250,1077,1366,-173,289,116
q549,q,"Hypospadias, unspecified",Congenital and chromosomal abnormalities,97,106,130,0.092783505,0.226415094,0.340206186,885,809,732,-76,-77,-153
q5563,q,Congenital torsion of penis,Congenital and chromosomal abnormalities,75,63,68,-0.16,0.079365079,-0.093333333,1008,1061,1038,53,-23,30
q5564,q,Hidden penis,Congenital and chromosomal abnormalities,37,36,39,-0.027027027,0.083333333,0.054054054,1448,1410,1391,-38,-19,-57
q5569,q,Other congenital malformation of penis,Congenital and chromosomal abnormalities,32,26,32,-0.1875,0.230769231,0,1555,1669,1545,114,-124,-10
q600,q,"Renal agenesis, unilateral",Congenital and chromosomal abnormalities,280,244,252,-0.128571429,0.032786885,-0.1,507,530,529,23,-1,22
q604,q,"Renal hypoplasia, bilateral",Congenital and chromosomal abnormalities,19,16,18,-0.157894737,0.125,-0.052631579,1972,2080,1985,108,-95,13
q6102,q,Congenital multiple renal cysts,Congenital and chromosomal abnormalities,20,23,22,0.15,-0.043478261,0.1,1929,1773,1829,-156,56,-100
q612,q,"Polycystic kidney, adult type",Congenital and chromosomal abnormalities,167,168,174,0.005988024,0.035714286,0.041916168,646,627,627,-19,0,-19
q613,q,"Polycystic kidney, unspecified",Congenital and chromosomal abnormalities,350,330,346,-0.057142857,0.048484848,-0.011428571,438,435,439,-3,4,1
q614,q,Renal dysplasia,Congenital and chromosomal abnormalities,60,63,56,0.05,-0.111111111,-0.066666667,1130,1058,1134,-72,76,4
q615,q,Medullary cystic kidney,Congenital and chromosomal abnormalities,42,25,36,-0.404761905,0.44,-0.142857143,1357,1693,1433,336,-260,76
q619,q,"Cystic kidney disease, unspecified",Congenital and chromosomal abnormalities,28,17,25,-0.392857143,0.470588235,-0.107142857,1655,2029,1732,374,-297,77
q620,q,Congenital hydronephrosis,Congenital and chromosomal abnormalities,222,219,212,-0.013513514,-0.03196347,-0.045045045,568,564,569,-4,5,1
q6211,q,Congenital occlusion of ureteropelvic junction,Congenital and chromosomal abnormalities,12,15,15,0.25,0,0.25,2294,2111,2115,-183,4,-179
q6239,q,Other obstructive defects of renal pelvis and ureter,Congenital and chromosomal abnormalities,28,33,25,0.178571429,-0.242424242,-0.107142857,1654,1465,1731,-189,266,77
q625,q,Duplication of ureter,Congenital and chromosomal abnormalities,49,30,39,-0.387755102,0.3,-0.204081633,1256,1539,1386,283,-153,130
q627,q,Congenital vesico-uretero-renal reflux,Congenital and chromosomal abnormalities,22,19,14,-0.136363636,-0.263157895,-0.363636364,1846,1929,2163,83,234,317
q630,q,Accessory kidney,Congenital and chromosomal abnormalities,30,25,23,-0.166666667,-0.08,-0.233333333,1597,1690,1790,93,100,193
q631,q,"Lobulated, fused and horseshoe kidney",Congenital and chromosomal abnormalities,131,111,117,-0.152671756,0.054054054,-0.106870229,743,787,777,44,-10,34
q632,q,Ectopic kidney,Congenital and chromosomal abnormalities,33,26,35,-0.212121212,0.346153846,0.060606061,1518,1661,1459,143,-202,-59
q638,q,Other specified congenital malformations of kidney,Congenital and chromosomal abnormalities,46,38,32,-0.173913043,-0.157894737,-0.304347826,1295,1369,1536,74,167,241
q642,q,Congenital posterior urethral valves,Congenital and chromosomal abnormalities,21,14,15,-0.333333333,0.071428571,-0.285714286,1879,2157,2109,278,-48,230
q644,q,Malformation of urachus,Congenital and chromosomal abnormalities,19,11,17,-0.421052632,0.545454545,-0.105263158,1957,2307,2015,350,-292,58
q6589,q,Other specified congenital deformities of hip,Congenital and chromosomal abnormalities,243,155,155,-0.362139918,0,-0.362139918,545,662,658,117,-4,113
q659,q,"Congenital deformity of hip, unspecified",Congenital and chromosomal abnormalities,22,13,14,-0.409090909,0.076923077,-0.363636364,1841,2200,2156,359,-44,315
q6601,q,"Congenital talipes equinovarus, right foot",Congenital and chromosomal abnormalities,10,34,42,2.4,0.235294118,3.2,2366,1433,1342,-933,-91,-1024
q6689,q,Other specified congenital deformities of feet,Congenital and chromosomal abnormalities,136,97,111,-0.286764706,0.144329897,-0.183823529,730,840,799,110,-41,69
q672,q,Dolichocephaly,Congenital and chromosomal abnormalities,11,14,14,0.272727273,0,0.272727273,2318,2154,2154,-164,0,-164
q673,q,Plagiocephaly,Congenital and chromosomal abnormalities,165,114,107,-0.309090909,-0.061403509,-0.351515152,647,779,811,132,32,164
q675,q,Congenital deformity of spine,Congenital and chromosomal abnormalities,23,25,23,0.086956522,-0.08,0,1799,1683,1783,-116,100,-16
q676,q,Pectus excavatum,Congenital and chromosomal abnormalities,185,161,205,-0.12972973,0.273291925,0.108108108,614,645,577,31,-68,-37
q677,q,Pectus carinatum,Congenital and chromosomal abnormalities,14,15,13,0.071428571,-0.133333333,-0.071428571,2185,2098,2202,-87,104,17
q680,q,Congenital deformity of sternocleidomastoid muscle,Congenital and chromosomal abnormalities,24,20,17,-0.166666667,-0.15,-0.291666667,1769,1884,2009,115,125,240
q688,q,Other specified congenital musculoskeletal deformities,Congenital and chromosomal abnormalities,22,27,25,0.227272727,-0.074074074,0.136363636,1836,1619,1722,-217,103,-114
q690,q,Accessory finger(s),Congenital and chromosomal abnormalities,48,44,50,-0.083333333,0.136363636,0.041666667,1264,1263,1206,-1,-57,-58
q692,q,Accessory toe(s),Congenital and chromosomal abnormalities,20,18,21,-0.1,0.166666667,0.05,1906,1956,1837,50,-119,-69
q699,q,"Polydactyly, unspecified",Congenital and chromosomal abnormalities,27,18,24,-0.333333333,0.333333333,-0.111111111,1677,1956,1760,279,-196,83
q740,q,"Other congenital malformations of upper limb(s), including shoulder girdle",Congenital and chromosomal abnormalities,10,22,17,1.2,-0.227272727,0.7,2355,1798,2005,-557,207,-350
q742,q,"Other congenital malformations of lower limb(s), including pelvic girdle",Congenital and chromosomal abnormalities,23,20,16,-0.130434783,-0.2,-0.304347826,1795,1881,2046,86,165,251
q743,q,Arthrogryposis multiplex congenita,Congenital and chromosomal abnormalities,14,15,16,0.071428571,0.066666667,0.142857143,2179,2091,2046,-88,-45,-133
q750,q,Craniosynostosis,Congenital and chromosomal abnormalities,64,84,83,0.3125,-0.011904762,0.296875,1088,898,922,-190,24,-166
q753,q,Macrocephaly,Congenital and chromosomal abnormalities,52,45,36,-0.134615385,-0.2,-0.307692308,1211,1241,1423,30,182,212
q760,q,Spina bifida occulta,Congenital and chromosomal abnormalities,28,20,24,-0.285714286,0.2,-0.142857143,1642,1879,1758,237,-121,116
q761,q,Klippel-Feil syndrome,Congenital and chromosomal abnormalities,19,12,26,-0.368421053,1.166666667,0.368421053,1942,2237,1689,295,-548,-253
q762,q,Congenital spondylolisthesis,Congenital and chromosomal abnormalities,17,14,17,-0.176470588,0.214285714,0,2034,2139,2001,105,-138,-33
q7649,q,"Other congenital malformations of spine, not associated with scoliosis",Congenital and chromosomal abnormalities,68,68,67,0,-0.014705882,-0.014705882,1047,1008,1034,-39,26,-13
q774,q,Achondroplasia,Congenital and chromosomal abnormalities,17,20,23,0.176470588,0.15,0.352941176,2033,1878,1774,-155,-104,-259
q780,q,Osteogenesis imperfecta,Congenital and chromosomal abnormalities,46,38,40,-0.173913043,0.052631579,-0.130434783,1287,1361,1362,74,1,75
q782,q,Osteopetrosis,Congenital and chromosomal abnormalities,41,24,43,-0.414634146,0.791666667,0.048780488,1360,1713,1321,353,-392,-39
q790,q,Congenital diaphragmatic hernia,Congenital and chromosomal abnormalities,24,28,20,0.166666667,-0.285714286,-0.166666667,1761,1580,1868,-181,288,107
q791,q,Other congenital malformations of diaphragm,Congenital and chromosomal abnormalities,20,17,12,-0.15,-0.294117647,-0.4,1897,2000,2231,103,231,334
q792,q,Exomphalos,Congenital and chromosomal abnormalities,10,13,17,0.3,0.307692308,0.7,2342,2175,1996,-167,-179,-346
q793,q,Gastroschisis,Congenital and chromosomal abnormalities,35,26,25,-0.257142857,-0.038461538,-0.285714286,1465,1648,1715,183,67,250
q7960,q,"Ehlers-Danlos syndrome, unspecified",Congenital and chromosomal abnormalities,118,213,214,0.805084746,0.004694836,0.813559322,792,573,568,-219,-5,-224
q820,q,Hereditary lymphedema,Congenital and chromosomal abnormalities,11,11,11,0,0,0,2294,2276,2279,-18,3,-15
q825,q,Congenital non-neoplastic nevus,Congenital and chromosomal abnormalities,234,233,236,-0.004273504,0.012875536,0.008547009,554,546,544,-8,-2,-10
q826,q,Congenital sacral dimple,Congenital and chromosomal abnormalities,550,472,458,-0.141818182,-0.029661017,-0.167272727,336,360,376,24,16,40
q828,q,Other specified congenital malformations of skin,Congenital and chromosomal abnormalities,567,548,559,-0.0335097,0.020072993,-0.014109347,327,325,331,-2,6,4
q833,q,Accessory nipple,Congenital and chromosomal abnormalities,11,11,14,0,0.272727273,0.272727273,2291,2273,2127,-18,-146,-164
q8500,q,"Neurofibromatosis, unspecified",Congenital and chromosomal abnormalities,58,57,53,-0.017241379,-0.070175439,-0.086206897,1147,1101,1157,-46,56,10
q8501,q,"Neurofibromatosis, type 1",Congenital and chromosomal abnormalities,68,53,55,-0.220588235,0.037735849,-0.191176471,1043,1138,1136,95,-2,93
q8502,q,"Neurofibromatosis, type 2",Congenital and chromosomal abnormalities,17,17,20,0,0.176470588,0.176470588,2022,1993,1861,-29,-132,-161
q851,q,Tuberous sclerosis,Congenital and chromosomal abnormalities,18,23,42,0.277777778,0.826086957,1.333333333,1978,1741,1329,-237,-412,-649
q858,q,"Other phakomatoses, not elsewhere classified",Congenital and chromosomal abnormalities,22,32,30,0.454545455,-0.0625,0.363636364,1819,1467,1567,-352,100,-252
q859,q,"Phakomatosis, unspecified",Congenital and chromosomal abnormalities,18,14,16,-0.222222222,0.142857143,-0.111111111,1977,2123,2025,146,-98,48
q860,q,Fetal alcohol syndrome (dysmorphic),Congenital and chromosomal abnormalities,50,58,51,0.16,-0.120689655,0.02,1229,1092,1183,-137,91,-46
q870,q,Congenital malformation syndromes predominantly affecting facial appearance,Congenital and chromosomal abnormalities,55,55,39,0,-0.290909091,-0.290909091,1174,1115,1367,-59,252,193
q8719,q,Other congenital malformation syndromes predominantly associated with short stature,Congenital and chromosomal abnormalities,21,22,31,0.047619048,0.409090909,0.476190476,1851,1781,1544,-70,-237,-307
q872,q,Congenital malformation syndromes predominantly involving limbs,Congenital and chromosomal abnormalities,51,34,36,-0.333333333,0.058823529,-0.294117647,1217,1417,1411,200,-6,194
q873,q,Congenital malformation syndromes involving early overgrowth,Congenital and chromosomal abnormalities,11,10,10,-0.090909091,0,-0.090909091,2281,2311,2304,30,-7,23
q8740,q,"Marfan's syndrome, unspecified",Congenital and chromosomal abnormalities,66,53,56,-0.196969697,0.056603774,-0.151515152,1061,1136,1122,75,-14,61
q8781,q,Alport syndrome,Congenital and chromosomal abnormalities,39,26,27,-0.333333333,0.038461538,-0.307692308,1387,1637,1640,250,3,253
q8789,q,"Other specified congenital malformation syndromes, not elsewhere classified",Congenital and chromosomal abnormalities,34,36,44,0.058823529,0.222222222,0.294117647,1470,1385,1295,-85,-90,-175
q8901,q,Asplenia (congenital),Congenital and chromosomal abnormalities,48,61,64,0.270833333,0.049180328,0.333333333,1251,1066,1048,-185,-18,-203
q8909,q,Congenital malformations of spleen,Congenital and chromosomal abnormalities,50,49,35,-0.02,-0.285714286,-0.3,1226,1177,1435,-49,258,209
q893,q,Situs inversus,Congenital and chromosomal abnormalities,36,41,33,0.138888889,-0.195121951,-0.083333333,1431,1300,1485,-131,185,54
q898,q,Other specified congenital malformations,Congenital and chromosomal abnormalities,33,36,29,0.090909091,-0.194444444,-0.121212121,1491,1382,1568,-109,186,77
q899,q,"Congenital malformation, unspecified",Congenital and chromosomal abnormalities,28,27,39,-0.035714286,0.444444444,0.392857143,1622,1597,1364,-25,-233,-258
q909,q,"Down syndrome, unspecified",Congenital and chromosomal abnormalities,437,446,405,0.020594966,-0.091928251,-0.073226545,379,376,403,-3,27,24
q913,q,"Trisomy 18, unspecified",Congenital and chromosomal abnormalities,16,23,14,0.4375,-0.391304348,-0.125,2048,1728,2108,-320,380,60
q928,q,Other specified trisomies and partial trisomies of autosomes,Congenital and chromosomal abnormalities,41,32,28,-0.219512195,-0.125,-0.317073171,1347,1457,1604,110,147,257
q929,q,"Trisomy and partial trisomy of autosomes, unspecified",Congenital and chromosomal abnormalities,24,18,27,-0.25,0.5,0.125,1741,1922,1632,181,-290,-109
q9351,q,Angelman syndrome,Congenital and chromosomal abnormalities,21,11,11,-0.476190476,0,-0.476190476,1839,2251,2253,412,2,414
q9381,q,Velo-cardio-facial syndrome,Congenital and chromosomal abnormalities,21,15,17,-0.285714286,0.133333333,-0.19047619,1839,2056,1971,217,-85,132
q9382,q,Williams syndrome,Congenital and chromosomal abnormalities,14,14,14,0,0,0,2139,2106,2105,-33,-1,-34
q9388,q,Other microdeletions,Congenital and chromosomal abnormalities,45,28,12,-0.377777778,-0.571428571,-0.733333333,1293,1562,2200,269,638,907
q9389,q,Other deletions from the autosomes,Congenital and chromosomal abnormalities,31,23,19,-0.258064516,-0.173913043,-0.387096774,1535,1726,1887,191,161,352
q939,q,"Deletion from autosomes, unspecified",Congenital and chromosomal abnormalities,35,21,21,-0.4,0,-0.4,1448,1809,1804,361,-5,356
q969,q,"Turner's syndrome, unspecified",Congenital and chromosomal abnormalities,35,30,56,-0.142857143,0.866666667,0.6,1448,1509,1120,61,-389,-328
q984,q,"Klinefelter syndrome, unspecified",Congenital and chromosomal abnormalities,25,23,38,-0.08,0.652173913,0.52,1706,1725,1379,19,-346,-327
q992,q,Fragile X chromosome,Congenital and chromosomal abnormalities,14,17,17,0.214285714,0,0.214285714,2134,1970,1967,-164,-3,-167
q998,q,Other specified chromosome abnormalities,Congenital and chromosomal abnormalities,82,68,72,-0.170731707,0.058823529,-0.12195122,951,1003,992,52,-11,41
q999,q,"Chromosomal abnormality, unspecified",Congenital and chromosomal abnormalities,73,91,83,0.246575342,-0.087912088,0.136986301,1011,859,917,-152,58,-94
r000,r,"Tachycardia, unspecified",abnormal clinical findings,7024,7237,7707,0.030324601,0.064944038,0.097238041,47,43,43,-4,0,-4
r001,r,"Bradycardia, unspecified",abnormal clinical findings,5821,5432,6236,-0.066827006,0.148011782,0.071293592,56,58,52,2,-6,-4
r002,r,Palpitations,abnormal clinical findings,1003,662,732,-0.33998006,0.105740181,-0.270189432,223,297,280,74,-17,57
r008,r,Other abnormalities of heart beat,abnormal clinical findings,114,134,140,0.175438596,0.044776119,0.228070175,803,699,681,-104,-18,-122
r010,r,Benign and innocent cardiac murmurs,abnormal clinical findings,22,19,26,-0.136363636,0.368421053,0.181818182,1794,1871,1655,77,-216,-139
r011,r,"Cardiac murmur, unspecified",abnormal clinical findings,1268,1033,990,-0.18533123,-0.041626331,-0.219242902,195,221,229,26,8,34
r030,r,"Elevated blood-pressure reading, without diagnosis of hypertension",abnormal clinical findings,1696,1620,1721,-0.044811321,0.062345679,0.014740566,162,165,162,3,-3,0
r031,r,Nonspecific low blood-pressure reading,abnormal clinical findings,109,89,119,-0.183486239,0.337078652,0.091743119,816,859,757,43,-102,-59
r040,r,Epistaxis,abnormal clinical findings,1106,1303,1310,0.178119349,0.005372218,0.184448463,212,192,195,-20,3,-17
r042,r,Hemoptysis,abnormal clinical findings,1454,1588,1449,0.09215956,-0.087531486,-0.00343879,177,169,181,-8,12,4
r0489,r,Hemorrhage from other sites in respiratory passages,abnormal clinical findings,118,114,113,-0.033898305,-0.00877193,-0.042372881,781,765,778,-16,13,-3
r05,r,Cough,abnormal clinical findings,1849,3315,2352,0.792861006,-0.290497738,0.27203894,150,92,124,-58,32,-26
r0600,r,"Dyspnea, unspecified",abnormal clinical findings,1650,1659,1459,0.005454545,-0.120554551,-0.115757576,162,161,179,-1,18,17
r0601,r,Orthopnea,abnormal clinical findings,84,77,82,-0.083333333,0.064935065,-0.023809524,922,917,911,-5,-6,-11
r0602,r,Shortness of breath,abnormal clinical findings,8025,9934,10078,0.23788162,0.014495671,0.255825545,37,27,30,-10,3,-7
r0603,r,Acute respiratory distress,abnormal clinical findings,995,1068,686,0.073366834,-0.357677903,-0.310552764,216,208,284,-8,76,68
r0609,r,Other forms of dyspnea,abnormal clinical findings,217,207,193,-0.046082949,-0.06763285,-0.110599078,563,561,576,-2,15,13
r061,r,Stridor,abnormal clinical findings,127,95,95,-0.251968504,0,-0.251968504,735,824,846,89,22,111
r062,r,Wheezing,abnormal clinical findings,174,166,133,-0.045977011,-0.198795181,-0.235632184,616,616,697,0,81,81
r063,r,Periodic breathing,abnormal clinical findings,26,22,29,-0.153846154,0.318181818,0.115384615,1648,1745,1544,97,-201,-104
r064,r,Hyperventilation,abnormal clinical findings,34,18,33,-0.470588235,0.833333333,-0.029411765,1442,1895,1461,453,-434,19
r066,r,Hiccough,abnormal clinical findings,305,267,305,-0.124590164,0.142322097,0,465,488,459,23,-29,-6
r0681,r,"Apnea, not elsewhere classified",abnormal clinical findings,121,108,104,-0.107438017,-0.037037037,-0.140495868,757,774,797,17,23,40
r0682,r,"Tachypnea, not elsewhere classified",abnormal clinical findings,264,326,348,0.234848485,0.067484663,0.318181818,505,426,424,-79,-2,-81
r0683,r,Snoring,abnormal clinical findings,110,102,81,-0.072727273,-0.205882353,-0.263636364,800,791,906,-9,115,106
r0689,r,Other abnormalities of breathing,abnormal clinical findings,535,534,474,-0.001869159,-0.112359551,-0.114018692,330,318,356,-12,38,26
r070,r,Pain in throat,abnormal clinical findings,114,106,98,-0.070175439,-0.075471698,-0.140350877,787,777,827,-10,50,40
r071,r,Chest pain on breathing,abnormal clinical findings,31,24,44,-0.225806452,0.833333333,0.419354839,1506,1663,1266,157,-397,-240
r072,r,Precordial pain,abnormal clinical findings,192,193,145,0.005208333,-0.248704663,-0.244791667,590,578,660,-12,82,70
r0781,r,Pleurodynia,abnormal clinical findings,523,468,495,-0.105162524,0.057692308,-0.053537285,339,353,346,14,-7,7
r0789,r,Other chest pain,abnormal clinical findings,2945,2589,2748,-0.120882852,0.061413673,-0.066893039,99,106,103,7,-3,4
r079,r,"Chest pain, unspecified",abnormal clinical findings,5767,4998,5008,-0.133344893,0.0020008,-0.13161089,56,62,68,6,6,12
r0902,r,Hypoxemia,abnormal clinical findings,7031,8531,8353,0.213340919,-0.02086508,0.188024463,45,34,36,-11,2,-9
r091,r,Pleurisy,abnormal clinical findings,118,109,107,-0.076271186,-0.018348624,-0.093220339,765,763,781,-2,18,16
r092,r,Respiratory arrest,abnormal clinical findings,52,60,44,0.153846154,-0.266666667,-0.153846154,1169,1040,1260,-129,220,91
r0981,r,Nasal congestion,abnormal clinical findings,375,424,424,0.130666667,0,0.130666667,400,368,374,-32,6,-26
r0982,r,Postnasal drip,abnormal clinical findings,95,97,74,0.021052632,-0.237113402,-0.221052632,849,805,946,-44,141,97
r0989,r,Other specified symptoms and signs involving the circulatory and respiratory systems,abnormal clinical findings,254,241,231,-0.051181102,-0.041493776,-0.090551181,506,510,525,4,15,19
r100,r,Acute abdomen,abnormal clinical findings,28,30,35,0.071428571,0.166666667,0.25,1578,1473,1394,-105,-79,-184
r1010,r,"Upper abdominal pain, unspecified",abnormal clinical findings,122,105,111,-0.139344262,0.057142857,-0.090163934,742,771,767,29,-4,25
r1011,r,Right upper quadrant pain,abnormal clinical findings,730,548,576,-0.249315068,0.051094891,-0.210958904,276,311,315,35,4,39
r1012,r,Left upper quadrant pain,abnormal clinical findings,191,167,158,-0.12565445,-0.053892216,-0.172774869,583,600,622,17,22,39
r1013,r,Epigastric pain,abnormal clinical findings,1116,1006,1089,-0.098566308,0.08250497,-0.024193548,202,212,207,10,-5,5
r102,r,Pelvic and perineal pain,abnormal clinical findings,365,324,307,-0.112328767,-0.052469136,-0.15890411,407,419,446,12,27,39
r1030,r,"Lower abdominal pain, unspecified",abnormal clinical findings,307,264,258,-0.140065147,-0.022727273,-0.159609121,453,479,494,26,15,41
r1031,r,Right lower quadrant pain,abnormal clinical findings,549,465,500,-0.153005464,0.075268817,-0.089253188,319,348,339,29,-9,20
r1032,r,Left lower quadrant pain,abnormal clinical findings,415,366,375,-0.118072289,0.024590164,-0.096385542,373,392,402,19,10,29
r1033,r,Periumbilical pain,abnormal clinical findings,61,41,58,-0.327868852,0.414634146,-0.049180328,1066,1255,1053,189,-202,-13
r10819,r,"Abdominal tenderness, unspecified site",abnormal clinical findings,24,19,21,-0.208333333,0.105263158,-0.125,1687,1829,1752,142,-77,65
r1084,r,Generalized abdominal pain,abnormal clinical findings,411,354,408,-0.138686131,0.152542373,-0.00729927,375,396,380,21,-16,5
r109,r,Unspecified abdominal pain,abnormal clinical findings,7532,6525,6600,-0.133696229,0.011494253,-0.123738715,41,46,47,5,1,6
r110,r,Nausea,abnormal clinical findings,2746,2352,2662,-0.143481428,0.131802721,-0.030589949,101,108,101,7,-7,0
r1110,r,"Vomiting, unspecified",abnormal clinical findings,1149,1011,989,-0.120104439,-0.021760633,-0.139251523,195,209,217,14,8,22
r1111,r,Vomiting without nausea,abnormal clinical findings,36,23,29,-0.361111111,0.260869565,-0.194444444,1379,1674,1512,295,-162,133
r1112,r,Projectile vomiting,abnormal clinical findings,18,23,16,0.277777778,-0.304347826,-0.111111111,1899,1674,1948,-225,274,49
r1114,r,Bilious vomiting,abnormal clinical findings,27,40,50,0.481481481,0.25,0.851851852,1594,1268,1145,-326,-123,-449
r1115,r,Cyclical vomiting syndrome unrelated to migraine,abnormal clinical findings,114,197,207,0.728070175,0.050761421,0.815789474,767,555,541,-212,-14,-226
r112,r,"Nausea with vomiting, unspecified",abnormal clinical findings,5616,5260,5677,-0.063390313,0.079277567,0.010861823,55,57,54,2,-3,-1
r12,r,Heartburn,abnormal clinical findings,362,309,380,-0.14640884,0.229773463,0.049723757,400,427,392,27,-35,-8
r130,r,Aphagia,abnormal clinical findings,79,73,72,-0.075949367,-0.01369863,-0.088607595,922,916,943,-6,27,21
r1310,r,"Dysphagia, unspecified",abnormal clinical findings,7743,7422,6993,-0.0414568,-0.057801132,-0.096861682,38,38,42,0,4,4
r1311,r,"Dysphagia, oral phase",abnormal clinical findings,151,221,170,0.463576159,-0.230769231,0.125827815,645,525,590,-120,65,-55
r1312,r,"Dysphagia, oropharyngeal phase",abnormal clinical findings,1476,1588,1618,0.075880759,0.018891688,0.096205962,166,159,164,-7,5,-2
r1313,r,"Dysphagia, pharyngeal phase",abnormal clinical findings,283,294,266,0.038869258,-0.095238095,-0.060070671,466,440,478,-26,38,12
r1314,r,"Dysphagia, pharyngoesophageal phase",abnormal clinical findings,173,167,153,-0.034682081,-0.083832335,-0.115606936,593,584,615,-9,31,22
r1319,r,Other dysphagia,abnormal clinical findings,288,223,192,-0.225694444,-0.139013453,-0.333333333,463,520,553,57,33,90
r140,r,Abdominal distension (gaseous),abnormal clinical findings,501,452,523,-0.097804391,0.157079646,0.043912176,330,349,325,19,-24,-5
r141,r,Gas pain,abnormal clinical findings,21,14,17,-0.333333333,0.214285714,-0.19047619,1766,2031,1899,265,-132,133
r143,r,Flatulence,abnormal clinical findings,55,64,47,0.163636364,-0.265625,-0.145454545,1113,976,1181,-137,205,68
r152,r,Fecal urgency,abnormal clinical findings,22,13,11,-0.409090909,-0.153846154,-0.5,1732,2069,2174,337,105,442
r159,r,Full incontinence of feces,abnormal clinical findings,796,699,806,-0.121859296,0.153075823,0.012562814,249,271,243,22,-28,-6
r160,r,"Hepatomegaly, not elsewhere classified",abnormal clinical findings,566,515,598,-0.090106007,0.161165049,0.056537102,304,317,293,13,-24,-11
r161,r,"Splenomegaly, not elsewhere classified",abnormal clinical findings,719,686,724,-0.045897079,0.055393586,0.006954103,271,274,266,3,-8,-5
r162,r,"Hepatomegaly with splenomegaly, not elsewhere classified",abnormal clinical findings,237,216,258,-0.088607595,0.194444444,0.088607595,507,524,479,17,-45,-28
r17,r,Unspecified jaundice,abnormal clinical findings,718,769,855,0.071030641,0.11183355,0.190807799,272,245,232,-27,-13,-40
r180,r,Malignant ascites,abnormal clinical findings,501,481,480,-0.03992016,-0.002079002,-0.041916168,326,327,334,1,7,8
r188,r,Other ascites,abnormal clinical findings,4465,4349,4527,-0.025979843,0.040928949,0.013885778,66,67,71,1,4,5
r1900,r,"Intra-abdominal and pelvic swelling, mass and lump, unspecified site",abnormal clinical findings,350,287,345,-0.18,0.202090592,-0.014285714,398,443,399,45,-44,1
r1903,r,"Right lower quadrant abdominal swelling, mass and lump",abnormal clinical findings,32,22,17,-0.3125,-0.227272727,-0.46875,1442,1691,1890,249,199,448
r1904,r,"Left lower quadrant abdominal swelling, mass and lump",abnormal clinical findings,17,17,10,0,-0.411764706,-0.411764706,1916,1891,2202,-25,311,286
r1909,r,"Other intra-abdominal and pelvic swelling, mass and lump",abnormal clinical findings,125,120,119,-0.04,-0.008333333,-0.048,703,694,710,-9,16,7
r194,r,Change in bowel habit,abnormal clinical findings,20,17,10,-0.15,-0.411764706,-0.5,1786,1890,2201,104,311,415
r195,r,Other fecal abnormalities,abnormal clinical findings,386,404,457,0.046632124,0.131188119,0.183937824,374,362,343,-12,-19,-31
r197,r,"Diarrhea, unspecified",abnormal clinical findings,5830,5923,7934,0.015951973,0.33952389,0.360891938,51,49,38,-2,-11,-13
r198,r,Other specified symptoms and signs involving the digestive system and abdomen,abnormal clinical findings,30,37,28,0.233333333,-0.243243243,-0.066666667,1485,1294,1524,-191,230,39
r200,r,Anesthesia of skin,abnormal clinical findings,1186,1098,1164,-0.074198988,0.06010929,-0.018549747,184,193,187,9,-6,3
r201,r,Hypoesthesia of skin,abnormal clinical findings,20,22,34,0.1,0.545454545,0.7,1782,1686,1378,-96,-308,-404
r202,r,Paresthesia of skin,abnormal clinical findings,1023,954,1003,-0.06744868,0.051362683,-0.019550342,202,208,210,6,2,8
r208,r,Other disturbances of skin sensation,abnormal clinical findings,96,121,141,0.260416667,0.165289256,0.46875,808,685,627,-123,-58,-181
r209,r,Unspecified disturbances of skin sensation,abnormal clinical findings,68,42,48,-0.382352941,0.142857143,-0.294117647,970,1202,1149,232,-53,179
r21,r,Rash and other nonspecific skin eruption,abnormal clinical findings,1590,1489,1416,-0.063522013,-0.049026192,-0.109433962,154,160,172,6,12,18
r220,r,"Localized swelling, mass and lump, head",abnormal clinical findings,176,135,160,-0.232954545,0.185185185,-0.090909091,572,643,587,71,-56,15
r221,r,"Localized swelling, mass and lump, neck",abnormal clinical findings,219,181,186,-0.173515982,0.027624309,-0.150684932,520,549,549,29,0,29
r222,r,"Localized swelling, mass and lump, trunk",abnormal clinical findings,124,112,130,-0.096774194,0.160714286,0.048387097,697,714,660,17,-54,-37
r2231,r,"Localized swelling, mass and lump, right upper limb",abnormal clinical findings,30,21,19,-0.3,-0.095238095,-0.366666667,1477,1718,1794,241,76,317
r2232,r,"Localized swelling, mass and lump, left upper limb",abnormal clinical findings,29,24,21,-0.172413793,-0.125,-0.275862069,1503,1606,1713,103,107,210
r2241,r,"Localized swelling, mass and lump, right lower limb",abnormal clinical findings,56,37,29,-0.339285714,-0.216216216,-0.482142857,1079,1286,1479,207,193,400
r2242,r,"Localized swelling, mass and lump, left lower limb",abnormal clinical findings,51,35,27,-0.31372549,-0.228571429,-0.470588235,1134,1313,1541,179,228,407
r2243,r,"Localized swelling, mass and lump, lower limb, bilateral",abnormal clinical findings,83,37,23,-0.554216867,-0.378378378,-0.722891566,870,1286,1655,416,369,785
r229,r,"Localized swelling, mass and lump, unspecified",abnormal clinical findings,41,46,34,0.12195122,-0.260869565,-0.170731707,1263,1143,1371,-120,228,108
r230,r,Cyanosis,abnormal clinical findings,84,87,84,0.035714286,-0.034482759,0,862,804,843,-58,39,-19
r231,r,Pallor,abnormal clinical findings,15,20,18,0.333333333,-0.1,0.2,1986,1750,1827,-236,77,-159
r232,r,Flushing,abnormal clinical findings,17,12,15,-0.294117647,0.25,-0.117647059,1895,2090,1950,195,-140,55
r233,r,Spontaneous ecchymoses,abnormal clinical findings,140,118,103,-0.157142857,-0.127118644,-0.264285714,651,694,750,43,56,99
r234,r,Changes in skin texture,abnormal clinical findings,58,60,71,0.034482759,0.183333333,0.224137931,1063,993,928,-70,-65,-135
r238,r,Other skin changes,abnormal clinical findings,158,129,129,-0.183544304,0,-0.183544304,602,659,662,57,3,60
r251,r,"Tremor, unspecified",abnormal clinical findings,798,818,750,0.025062657,-0.083129584,-0.060150376,243,228,252,-15,24,9
r252,r,Cramp and spasm,abnormal clinical findings,496,378,478,-0.237903226,0.264550265,-0.036290323,321,366,328,45,-38,7
r253,r,Fasciculation,abnormal clinical findings,67,55,81,-0.179104478,0.472727273,0.208955224,968,1029,851,61,-178,-117
r258,r,Other abnormal involuntary movements,abnormal clinical findings,74,60,65,-0.189189189,0.083333333,-0.121621622,925,990,957,65,-33,32
r259,r,Unspecified abnormal involuntary movements,abnormal clinical findings,56,40,48,-0.285714286,0.2,-0.142857143,1070,1228,1137,158,-91,67
r260,r,Ataxic gait,abnormal clinical findings,257,219,187,-0.147859922,-0.146118721,-0.272373541,473,508,546,35,38,73
r262,r,"Difficulty in walking, not elsewhere classified",abnormal clinical findings,1138,996,1070,-0.124780316,0.074297189,-0.059753954,189,202,202,13,0,13
r2681,r,Unsteadiness on feet,abnormal clinical findings,1048,954,942,-0.089694656,-0.012578616,-0.101145038,196,206,212,10,6,16
r2689,r,Other abnormalities of gait and mobility,abnormal clinical findings,1433,1520,2012,0.060711793,0.323684211,0.404047453,165,159,133,-6,-26,-32
r269,r,Unspecified abnormalities of gait and mobility,abnormal clinical findings,2644,2697,2366,0.020045386,-0.122728958,-0.105143722,98,97,110,-1,13,12
r270,r,"Ataxia, unspecified",abnormal clinical findings,803,714,726,-0.110834371,0.016806723,-0.095890411,237,253,254,16,1,17
r278,r,Other lack of coordination,abnormal clinical findings,288,234,456,-0.1875,0.948717949,0.583333333,443,484,332,41,-152,-111
r279,r,Unspecified lack of coordination,abnormal clinical findings,117,92,107,-0.213675214,0.163043478,-0.085470085,716,776,729,60,-47,13
r291,r,Meningismus,abnormal clinical findings,20,10,16,-0.5,0.6,-0.2,1752,2169,1888,417,-281,136
r292,r,Abnormal reflex,abnormal clinical findings,68,38,80,-0.441176471,1.105263158,0.176470588,951,1249,849,298,-400,-102
r294,r,Clicking hip,abnormal clinical findings,66,37,53,-0.439393939,0.432432432,-0.196969697,966,1267,1058,301,-209,92
r296,r,Repeated falls,abnormal clinical findings,3865,3800,4247,-0.016817594,0.117631579,0.098835705,75,72,73,-3,1,-2
r29700,r,NIHSS score 0,abnormal clinical findings,431,465,464,0.078886311,-0.002150538,0.076566125,336,325,328,-11,3,-8
r29701,r,NIHSS score 1,abnormal clinical findings,469,471,444,0.004264392,-0.057324841,-0.053304904,324,319,332,-5,13,8
r29702,r,NIHSS score 2,abnormal clinical findings,430,437,433,0.01627907,-0.009153318,0.006976744,335,332,336,-3,4,1
r29703,r,NIHSS score 3,abnormal clinical findings,324,390,371,0.203703704,-0.048717949,0.145061728,400,351,370,-49,19,-30
r29704,r,NIHSS score 4,abnormal clinical findings,284,295,282,0.038732394,-0.044067797,-0.007042254,438,415,433,-23,18,-5
r29705,r,NIHSS score 5,abnormal clinical findings,201,227,221,0.129353234,-0.026431718,0.099502488,526,489,492,-37,3,-34
r29706,r,NIHSS score 6,abnormal clinical findings,157,201,199,0.280254777,-0.009950249,0.267515924,591,510,515,-81,5,-76
r29707,r,NIHSS score 7,abnormal clinical findings,130,146,135,0.123076923,-0.075342466,0.038461538,659,599,624,-60,25,-35
r29708,r,NIHSS score 8,abnormal clinical findings,87,127,119,0.459770115,-0.062992126,0.367816092,823,647,682,-176,35,-141
r29709,r,NIHSS score 9,abnormal clinical findings,85,98,102,0.152941176,0.040816327,0.2,836,733,733,-103,0,-103
r29710,r,NIHSS score 10,abnormal clinical findings,92,75,78,-0.184782609,0.04,-0.152173913,799,850,857,51,7,58
r29711,r,NIHSS score 11,abnormal clinical findings,67,83,52,0.23880597,-0.373493976,-0.223880597,946,803,1059,-143,256,113
r29712,r,NIHSS score 12,abnormal clinical findings,50,65,64,0.3,-0.015384615,0.28,1110,925,942,-185,17,-168
r29713,r,NIHSS score 13,abnormal clinical findings,57,52,58,-0.087719298,0.115384615,0.01754386,1041,1036,990,-5,-46,-51
r29714,r,NIHSS score 14,abnormal clinical findings,60,55,64,-0.083333333,0.163636364,0.066666667,1006,1006,942,0,-64,-64
r29715,r,NIHSS score 15,abnormal clinical findings,52,71,48,0.365384615,-0.323943662,-0.076923077,1086,881,1111,-205,230,25
r29716,r,NIHSS score 16,abnormal clinical findings,38,60,48,0.578947368,-0.2,0.263157895,1279,967,1111,-312,144,-168
r29717,r,NIHSS score 17,abnormal clinical findings,42,41,46,-0.023809524,0.12195122,0.095238095,1211,1185,1142,-26,-43,-69
r29718,r,NIHSS score 18,abnormal clinical findings,47,42,51,-0.106382979,0.214285714,0.085106383,1141,1163,1068,22,-95,-73
r29719,r,NIHSS score 19,abnormal clinical findings,41,47,33,0.146341463,-0.29787234,-0.195121951,1225,1093,1357,-132,264,132
r29720,r,NIHSS score 20,abnormal clinical findings,45,42,43,-0.066666667,0.023809524,-0.044444444,1173,1162,1188,-11,26,15
r29721,r,NIHSS score 21,abnormal clinical findings,40,43,45,0.075,0.046511628,0.125,1237,1145,1154,-92,9,-83
r29722,r,NIHSS score 22,abnormal clinical findings,26,41,36,0.576923077,-0.12195122,0.384615385,1533,1181,1281,-352,100,-252
r29723,r,NIHSS score 23,abnormal clinical findings,31,31,31,0,0,0,1404,1351,1405,-53,54,1
r29724,r,NIHSS score 24,abnormal clinical findings,23,16,27,-0.304347826,0.6875,0.173913043,1623,1867,1496,244,-371,-127
r29725,r,NIHSS score 25,abnormal clinical findings,15,19,21,0.266666667,0.105263158,0.4,1940,1737,1664,-203,-73,-276
r29726,r,NIHSS score 26,abnormal clinical findings,14,23,21,0.642857143,-0.086956522,0.5,1983,1592,1664,-391,72,-319
r29727,r,NIHSS score 27,abnormal clinical findings,22,18,16,-0.181818182,-0.111111111,-0.272727273,1660,1773,1858,113,85,198
r29729,r,NIHSS score 29,abnormal clinical findings,10,18,13,0.8,-0.277777778,0.3,2150,1773,1998,-377,225,-152
r29810,r,Facial weakness,abnormal clinical findings,2966,2857,2617,-0.036749831,-0.0840042,-0.117666891,88,92,98,4,6,10
r29818,r,Other symptoms and signs involving the nervous system,abnormal clinical findings,112,90,92,-0.196428571,0.022222222,-0.178571429,723,766,781,43,15,58
r29898,r,Other symptoms and signs involving the musculoskeletal system,abnormal clinical findings,560,462,472,-0.175,0.021645022,-0.157142857,292,323,323,31,0,31
r2990,r,Unspecified symptoms and signs involving the nervous system,abnormal clinical findings,23,21,29,-0.086956522,0.380952381,0.260869565,1620,1665,1431,45,-234,-189
r300,r,Dysuria,abnormal clinical findings,742,688,738,-0.07277628,0.072674419,-0.005390836,250,259,246,9,-13,-4
r309,r,"Painful micturition, unspecified",abnormal clinical findings,69,44,60,-0.362318841,0.363636364,-0.130434783,930,1130,969,200,-161,39
r310,r,Gross hematuria,abnormal clinical findings,2008,1869,1964,-0.069223108,0.05082932,-0.021912351,123,131,133,8,2,10
r3121,r,Asymptomatic microscopic hematuria,abnormal clinical findings,78,63,58,-0.192307692,-0.079365079,-0.256410256,870,935,983,65,48,113
r3129,r,Other microscopic hematuria,abnormal clinical findings,659,621,586,-0.057663126,-0.056360709,-0.1107739,267,270,283,3,13,16
r319,r,"Hematuria, unspecified",abnormal clinical findings,2098,1932,2105,-0.079122974,0.089544513,0.003336511,119,122,125,3,3,6
r32,r,Unspecified urinary incontinence,abnormal clinical findings,3560,3373,3129,-0.05252809,-0.072339164,-0.121067416,76,80,87,4,7,11
r330,r,Drug induced retention of urine,abnormal clinical findings,70,49,61,-0.3,0.244897959,-0.128571429,917,1055,957,138,-98,40
r338,r,Other retention of urine,abnormal clinical findings,3521,3229,3082,-0.082930986,-0.04552493,-0.124680488,76,84,88,8,4,12
r339,r,"Retention of urine, unspecified",abnormal clinical findings,5919,5628,5709,-0.04916371,0.014392324,-0.035478966,50,51,51,1,0,1
r34,r,Anuria and oliguria,abnormal clinical findings,300,312,428,0.04,0.371794872,0.426666667,416,388,330,-28,-58,-86
r350,r,Frequency of micturition,abnormal clinical findings,851,742,788,-0.128084606,0.061994609,-0.074030552,218,234,232,16,-2,14
r351,r,Nocturia,abnormal clinical findings,300,277,294,-0.076666667,0.061371841,-0.02,415,418,413,3,-5,-2
r358,r,Other polyuria,abnormal clinical findings,73,81,83,0.109589041,0.024691358,0.136986301,896,799,810,-97,11,-86
r369,r,"Urethral discharge, unspecified",abnormal clinical findings,16,18,26,0.125,0.444444444,0.625,1871,1755,1507,-116,-248,-364
r3911,r,Hesitancy of micturition,abnormal clinical findings,158,124,120,-0.215189873,-0.032258065,-0.240506329,574,642,664,68,22,90
r3912,r,Poor urinary stream,abnormal clinical findings,106,85,83,-0.198113208,-0.023529412,-0.216981132,726,774,809,48,35,83
r3914,r,Feeling of incomplete bladder emptying,abnormal clinical findings,92,73,94,-0.206521739,0.287671233,0.02173913,784,849,758,65,-91,-26
r3915,r,Urgency of urination,abnormal clinical findings,366,312,300,-0.147540984,-0.038461538,-0.180327869,362,387,407,25,20,45
r3916,r,Straining to void,abnormal clinical findings,14,19,16,0.357142857,-0.157894737,0.142857143,1959,1714,1835,-245,121,-124
r39198,r,Other difficulties with micturition,abnormal clinical findings,70,63,97,-0.1,0.53968254,0.385714286,907,922,745,15,-177,-162
r392,r,Extrarenal uremia,abnormal clinical findings,16,11,21,-0.3125,0.909090909,0.3125,1866,2065,1640,199,-425,-226
r3981,r,Functional urinary incontinence,abnormal clinical findings,19,17,29,-0.105263158,0.705882353,0.526315789,1737,1798,1412,61,-386,-325
r3989,r,Other symptoms and signs involving the genitourinary system,abnormal clinical findings,28,28,36,0,0.285714286,0.285714286,1460,1408,1259,-52,-149,-201
r400,r,Somnolence,abnormal clinical findings,348,315,393,-0.094827586,0.247619048,0.129310345,371,382,347,11,-35,-24
r4020,r,Unspecified coma,abnormal clinical findings,223,222,202,-0.004484305,-0.09009009,-0.094170404,482,478,496,-4,18,14
r402110,r,"Coma scale, eyes open, never, unspecified time",abnormal clinical findings,17,22,19,0.294117647,-0.136363636,0.117647059,1822,1604,1713,-218,109,-109
r402111,r,"Coma scale, eyes open, never, in the field [EMT or ambulance]",abnormal clinical findings,66,70,63,0.060606061,-0.1,-0.045454545,929,865,931,-64,66,2
r402112,r,"Coma scale, eyes open, never, at arrival to emergency department",abnormal clinical findings,375,354,344,-0.056,-0.028248588,-0.082666667,356,356,370,0,14,14
r402113,r,"Coma scale, eyes open, never, at hospital admission",abnormal clinical findings,138,155,115,0.123188406,-0.258064516,-0.166666667,624,565,676,-59,111,52
r402114,r,"Coma scale, eyes open, never, 24 hours or more after hospital admission",abnormal clinical findings,129,122,96,-0.054263566,-0.213114754,-0.255813953,644,643,744,-1,101,100
r402121,r,"Coma scale, eyes open, to pain, in the field [EMT or ambulance]",abnormal clinical findings,20,15,13,-0.25,-0.133333333,-0.35,1693,1866,1963,173,97,270
r402122,r,"Coma scale, eyes open, to pain, at arrival to emergency department",abnormal clinical findings,104,114,130,0.096153846,0.140350877,0.25,725,671,626,-54,-45,-99
r402123,r,"Coma scale, eyes open, to pain, at hospital admission",abnormal clinical findings,123,100,76,-0.18699187,-0.24,-0.382113821,664,705,843,41,138,179
r402124,r,"Coma scale, eyes open, to pain, 24 hours or more after hospital admission",abnormal clinical findings,127,116,84,-0.086614173,-0.275862069,-0.338582677,650,664,797,14,133,147
r402131,r,"Coma scale, eyes open, to sound, in the field [EMT or ambulance]",abnormal clinical findings,16,10,12,-0.375,0.2,-0.25,1853,2098,2005,245,-93,152
r402132,r,"Coma scale, eyes open, to sound, at arrival to emergency department",abnormal clinical findings,114,99,91,-0.131578947,-0.080808081,-0.201754386,699,708,765,9,57,66
r402133,r,"Coma scale, eyes open, to sound, at hospital admission",abnormal clinical findings,115,68,64,-0.408695652,-0.058823529,-0.443478261,694,873,914,179,41,220
r402134,r,"Coma scale, eyes open, to sound, 24 hours or more after hospital admission",abnormal clinical findings,100,98,43,-0.02,-0.56122449,-0.57,738,710,1154,-28,444,416
r402141,r,"Coma scale, eyes open, spontaneous, in the field [EMT or ambulance]",abnormal clinical findings,84,60,66,-0.285714286,0.1,-0.214285714,810,935,904,125,-31,94
r402142,r,"Coma scale, eyes open, spontaneous, at arrival to emergency department",abnormal clinical findings,962,796,797,-0.172557173,0.001256281,-0.171517672,192,223,228,31,5,36
r402143,r,"Coma scale, eyes open, spontaneous, at hospital admission",abnormal clinical findings,457,437,334,-0.043763676,-0.235697941,-0.269146608,315,321,377,6,56,62
r402144,r,"Coma scale, eyes open, spontaneous, 24 hours or more after hospital admission",abnormal clinical findings,117,117,96,0,-0.179487179,-0.179487179,684,658,741,-26,83,57
r402210,r,"Coma scale, best verbal response, none, unspecified time",abnormal clinical findings,28,29,46,0.035714286,0.586206897,0.642857143,1444,1362,1104,-82,-258,-340
r402211,r,"Coma scale, best verbal response, none, in the field [EMT or ambulance]",abnormal clinical findings,78,74,65,-0.051282051,-0.121621622,-0.166666667,843,823,904,-20,81,61
r402212,r,"Coma scale, best verbal response, none, at arrival to emergency department",abnormal clinical findings,460,433,430,-0.058695652,-0.006928406,-0.065217391,313,322,325,9,3,12
r402213,r,"Coma scale, best verbal response, none, at hospital admission",abnormal clinical findings,254,257,192,0.011811024,-0.252918288,-0.244094488,444,433,504,-11,71,60
r402214,r,"Coma scale, best verbal response, none, 24 hours or more after hospital admission",abnormal clinical findings,237,230,202,-0.029535865,-0.12173913,-0.147679325,464,465,492,1,27,28
r402221,r,"Coma scale, best verbal response, incomprehensible words, in the field [EMT or ambulance]",abnormal clinical findings,22,17,14,-0.227272727,-0.176470588,-0.363636364,1615,1775,1900,160,125,285
r402222,r,"Coma scale, best verbal response, incomprehensible words, at arrival to emergency department",abnormal clinical findings,121,136,115,0.123966942,-0.154411765,-0.049586777,664,601,670,-63,69,6
r402223,r,"Coma scale, best verbal response, incomprehensible words, at hospital admission",abnormal clinical findings,104,93,56,-0.105769231,-0.397849462,-0.461538462,714,727,969,13,242,255
r402224,r,"Coma scale, best verbal response, incomprehensible words, 24 hours or more after hospital admission",abnormal clinical findings,99,98,61,-0.01010101,-0.37755102,-0.383838384,732,703,926,-29,223,194
r402232,r,"Coma scale, best verbal response, inappropriate words, at arrival to emergency department",abnormal clinical findings,53,45,48,-0.150943396,0.066666667,-0.094339623,1029,1070,1066,41,-4,37
r402233,r,"Coma scale, best verbal response, inappropriate words, at hospital admission",abnormal clinical findings,33,25,13,-0.242424242,-0.48,-0.606060606,1312,1473,1943,161,470,631
r402241,r,"Coma scale, best verbal response, confused conversation, in the field [EMT or ambulance]",abnormal clinical findings,27,22,22,-0.185185185,0,-0.185185185,1463,1580,1585,117,5,122
r402242,r,"Coma scale, best verbal response, confused conversation, at arrival to emergency department",abnormal clinical findings,208,180,215,-0.134615385,0.194444444,0.033653846,500,512,479,12,-33,-21
r402243,r,"Coma scale, best verbal response, confused conversation, at hospital admission",abnormal clinical findings,106,124,97,0.169811321,-0.217741935,-0.08490566,708,630,733,-78,103,25
r402244,r,"Coma scale, best verbal response, confused conversation, 24 hours or more after hospital admission",abnormal clinical findings,66,89,46,0.348484848,-0.483146067,-0.303030303,907,735,1094,-172,359,187
r402251,r,"Coma scale, best verbal response, oriented, in the field [EMT or ambulance]",abnormal clinical findings,53,32,43,-0.396226415,0.34375,-0.188679245,1026,1279,1138,253,-141,112
r402252,r,"Coma scale, best verbal response, oriented, at arrival to emergency department",abnormal clinical findings,716,555,555,-0.224860335,0,-0.224860335,252,276,285,24,9,33
r402253,r,"Coma scale, best verbal response, oriented, at hospital admission",abnormal clinical findings,348,271,241,-0.221264368,-0.110701107,-0.307471264,366,417,451,51,34,85
r402254,r,"Coma scale, best verbal response, oriented, 24 hours or more after hospital admission",abnormal clinical findings,76,54,25,-0.289473684,-0.537037037,-0.671052632,841,965,1496,124,531,655
r402311,r,"Coma scale, best motor response, none, in the field [EMT or ambulance]",abnormal clinical findings,54,55,47,0.018518519,-0.145454545,-0.12962963,1015,956,1075,-59,119,60
r402312,r,"Coma scale, best motor response, none, at arrival to emergency department",abnormal clinical findings,244,234,225,-0.040983607,-0.038461538,-0.077868852,454,457,468,3,11,14
r402313,r,"Coma scale, best motor response, none, at hospital admission",abnormal clinical findings,68,76,72,0.117647059,-0.052631579,0.058823529,889,802,851,-87,49,-38
r402314,r,"Coma scale, best motor response, none, 24 hours or more after hospital admission",abnormal clinical findings,77,79,83,0.025974026,0.050632911,0.077922078,837,780,786,-57,6,-51
r402322,r,"Coma scale, best motor response, extension, at arrival to emergency department",abnormal clinical findings,20,16,26,-0.2,0.625,0.3,1660,1796,1465,136,-331,-195
r402332,r,"Coma scale, best motor response, abnormal flexion, at arrival to emergency department",abnormal clinical findings,39,34,46,-0.128205128,0.352941176,0.179487179,1200,1225,1088,25,-137,-112
r402333,r,"Coma scale, best motor response, abnormal flexion, at hospital admission",abnormal clinical findings,31,23,20,-0.258064516,-0.130434783,-0.35483871,1345,1531,1633,186,102,288
r402334,r,"Coma scale, best motor response, abnormal flexion, 24 hours or more after hospital admission",abnormal clinical findings,18,10,18,-0.444444444,0.8,0,1740,2065,1713,325,-352,-27
r402341,r,"Coma scale, best motor response, flexion withdrawal, in the field [EMT or ambulance]",abnormal clinical findings,24,27,15,0.125,-0.444444444,-0.375,1535,1402,1832,-133,430,297
r402342,r,"Coma scale, best motor response, flexion withdrawal, at arrival to emergency department",abnormal clinical findings,130,129,115,-0.007692308,-0.108527132,-0.115384615,632,614,666,-18,52,34
r402343,r,"Coma scale, best motor response, flexion withdrawal, at hospital admission",abnormal clinical findings,94,71,56,-0.244680851,-0.211267606,-0.404255319,747,834,960,87,126,213
r402344,r,"Coma scale, best motor response, flexion withdrawal, 24 hours or more after hospital admission",abnormal clinical findings,87,77,56,-0.114942529,-0.272727273,-0.356321839,778,788,960,10,172,182
r402351,r,"Coma scale, best motor response, localizes pain, in the field [EMT or ambulance]",abnormal clinical findings,21,17,20,-0.19047619,0.176470588,-0.047619048,1622,1752,1630,130,-122,8
r402352,r,"Coma scale, best motor response, localizes pain, at arrival to emergency department",abnormal clinical findings,165,195,175,0.181818182,-0.102564103,0.060606061,544,495,520,-49,25,-24
r402353,r,"Coma scale, best motor response, localizes pain, at hospital admission",abnormal clinical findings,148,134,86,-0.094594595,-0.358208955,-0.418918919,590,597,768,7,171,178
r402354,r,"Coma scale, best motor response, localizes pain, 24 hours or more after hospital admission",abnormal clinical findings,126,116,69,-0.079365079,-0.405172414,-0.452380952,641,649,868,8,219,227
r402361,r,"Coma scale, best motor response, obeys commands, in the field [EMT or ambulance]",abnormal clinical findings,75,45,61,-0.4,0.355555556,-0.186666667,840,1054,915,214,-139,75
r402362,r,"Coma scale, best motor response, obeys commands, at arrival to emergency department",abnormal clinical findings,923,735,763,-0.20368364,0.038095238,-0.173347779,198,239,235,41,-4,37
r402363,r,"Coma scale, best motor response, obeys commands, at hospital admission",abnormal clinical findings,460,407,337,-0.115217391,-0.171990172,-0.267391304,311,330,372,19,42,61
r402364,r,"Coma scale, best motor response, obeys commands, 24 hours or more after hospital admission",abnormal clinical findings,122,126,89,0.032786885,-0.293650794,-0.270491803,649,619,757,-30,138,108
r402410,r,"Glasgow coma scale score 13-15, unspecified time",abnormal clinical findings,356,277,211,-0.221910112,-0.238267148,-0.407303371,360,409,478,49,69,118
r402411,r,"Glasgow coma scale score 13-15, in the field [EMT or ambulance]",abnormal clinical findings,40,55,54,0.375,-0.018181818,0.35,1169,943,970,-226,27,-199
r402412,r,"Glasgow coma scale score 13-15, at arrival to emergency department",abnormal clinical findings,399,355,333,-0.110275689,-0.061971831,-0.165413534,338,349,373,11,24,35
r402413,r,"Glasgow coma scale score 13-15, at hospital admission",abnormal clinical findings,102,132,164,0.294117647,0.242424242,0.607843137,709,604,537,-105,-67,-172
r402420,r,"Glasgow coma scale score 9-12, unspecified time",abnormal clinical findings,49,28,16,-0.428571429,-0.428571429,-0.673469388,1047,1357,1774,310,417,727
r402421,r,"Glasgow coma scale score 9-12, in the field [EMT or ambulance]",abnormal clinical findings,21,22,22,0.047619048,0,0.047619048,1610,1551,1558,-59,7,-52
r402422,r,"Glasgow coma scale score 9-12, at arrival to emergency department",abnormal clinical findings,31,73,35,1.35483871,-0.520547945,0.129032258,1330,809,1234,-521,425,-96
r402423,r,"Glasgow coma scale score 9-12, at hospital admission",abnormal clinical findings,21,21,13,0,-0.380952381,-0.380952381,1609,1586,1908,-23,322,299
r402430,r,"Glasgow coma scale score 3-8, unspecified time",abnormal clinical findings,86,84,62,-0.023255814,-0.261904762,-0.279069767,774,745,903,-29,158,129
r402431,r,"Glasgow coma scale score 3-8, in the field [EMT or ambulance]",abnormal clinical findings,50,43,49,-0.14,0.139534884,-0.02,1036,1073,1027,37,-46,-9
r402432,r,"Glasgow coma scale score 3-8, at arrival to emergency department",abnormal clinical findings,156,135,178,-0.134615385,0.318518519,0.141025641,561,592,510,31,-82,-51
r402433,r,"Glasgow coma scale score 3-8, at hospital admission",abnormal clinical findings,47,59,53,0.255319149,-0.101694915,0.127659574,1067,907,976,-160,69,-91
r403,r,Persistent vegetative state,abnormal clinical findings,62,52,48,-0.161290323,-0.076923077,-0.225806452,923,963,1041,40,78,118
r404,r,Transient alteration of awareness,abnormal clinical findings,254,224,241,-0.118110236,0.075892857,-0.051181102,438,463,448,25,-15,10
r410,r,"Disorientation, unspecified",abnormal clinical findings,2141,1998,1987,-0.066791219,-0.005505506,-0.071929005,113,114,128,1,14,15
r413,r,Other amnesia,abnormal clinical findings,884,772,830,-0.126696833,0.075129534,-0.061085973,206,225,216,19,-9,10
r414,r,Neurologic neglect syndrome,abnormal clinical findings,441,531,483,0.204081633,-0.09039548,0.095238095,315,279,307,-36,28,-8
r4181,r,Age-related cognitive decline,abnormal clinical findings,55,31,36,-0.436363636,0.161290323,-0.345454545,984,1269,1200,285,-69,216
r4182,r,"Altered mental status, unspecified",abnormal clinical findings,4900,4637,4835,-0.053673469,0.042700022,-0.013265306,59,61,64,2,3,5
r4183,r,Borderline intellectual functioning,abnormal clinical findings,74,75,45,0.013513514,-0.4,-0.391891892,838,787,1074,-51,287,236
r41840,r,Attention and concentration deficit,abnormal clinical findings,122,161,195,0.319672131,0.211180124,0.598360656,641,530,484,-111,-46,-157
r41841,r,Cognitive communication deficit,abnormal clinical findings,132,168,234,0.272727273,0.392857143,0.772727273,614,513,453,-101,-60,-161
r41842,r,Visuospatial deficit,abnormal clinical findings,36,36,41,0,0.138888889,0.138888889,1215,1169,1128,-46,-41,-87
r41843,r,Psychomotor deficit,abnormal clinical findings,22,22,13,0,-0.409090909,-0.409090909,1564,1535,1893,-29,358,329
r41844,r,Frontal lobe and executive function deficit,abnormal clinical findings,136,120,157,-0.117647059,0.308333333,0.154411765,608,619,536,11,-83,-72
r4189,r,Other symptoms and signs involving cognitive functions and awareness,abnormal clinical findings,1156,1217,1295,0.052768166,0.06409203,0.120242215,175,169,169,-6,0,-6
r419,r,Unspecified symptoms and signs involving cognitive functions and awareness,abnormal clinical findings,454,498,573,0.0969163,0.15060241,0.262114537,309,293,277,-16,-16,-32
r42,r,Dizziness and giddiness,abnormal clinical findings,3288,2761,2975,-0.160279805,0.077508149,-0.095194647,79,90,87,11,-3,8
r432,r,Parageusia,abnormal clinical findings,26,33,35,0.269230769,0.060606061,0.346153846,1434,1218,1215,-216,-3,-219
r440,r,Auditory hallucinations,abnormal clinical findings,307,262,333,-0.146579805,0.270992366,0.084690554,389,414,366,25,-48,-23
r441,r,Visual hallucinations,abnormal clinical findings,414,352,423,-0.149758454,0.201704545,0.02173913,322,342,321,20,-21,-1
r442,r,Other hallucinations,abnormal clinical findings,39,29,34,-0.256410256,0.172413793,-0.128205128,1165,1305,1233,140,-72,68
r443,r,"Hallucinations, unspecified",abnormal clinical findings,473,459,531,-0.029598309,0.156862745,0.122621564,304,307,288,3,-19,-16
r451,r,Restlessness and agitation,abnormal clinical findings,1224,1375,1658,0.123366013,0.205818182,0.354575163,170,156,142,-14,-14,-28
r454,r,Irritability and anger,abnormal clinical findings,141,152,177,0.078014184,0.164473684,0.255319149,584,543,496,-41,-47,-88
r456,r,Violent behavior,abnormal clinical findings,367,489,558,0.332425068,0.141104294,0.520435967,342,292,275,-50,-17,-67
r4584,r,Anhedonia,abnormal clinical findings,50,17,35,-0.66,1.058823529,-0.3,1015,1709,1209,694,-500,194
r45850,r,Homicidal ideations,abnormal clinical findings,2003,1815,1696,-0.093859211,-0.065564738,-0.153270095,116,129,140,13,11,24
r45851,r,Suicidal ideations,abnormal clinical findings,23957,21687,22034,-0.094753099,0.016000369,-0.080268815,10,11,12,1,1,2
r4586,r,Emotional lability,abnormal clinical findings,64,71,61,0.109375,-0.14084507,-0.046875,883,801,888,-82,87,5
r4587,r,Impulsiveness,abnormal clinical findings,322,342,416,0.062111801,0.216374269,0.291925466,366,344,317,-22,-27,-49
r4589,r,Other symptoms and signs involving emotional state,abnormal clinical findings,15,16,22,0.066666667,0.375,0.466666667,1813,1741,1525,-72,-216,-288
r460,r,Very low level of personal hygiene,abnormal clinical findings,18,10,12,-0.444444444,0.2,-0.333333333,1687,2011,1917,324,-94,230
r4689,r,Other symptoms and signs involving appearance and behavior,abnormal clinical findings,25,28,34,0.12,0.214285714,0.36,1457,1325,1224,-132,-101,-233
r4701,r,Aphasia,abnormal clinical findings,3387,3385,3397,-0.000590493,0.003545052,0.002952465,76,76,80,0,4,4
r4702,r,Dysphasia,abnormal clinical findings,547,654,430,0.195612431,-0.342507645,-0.213893967,277,248,310,-29,62,33
r471,r,Dysarthria and anarthria,abnormal clinical findings,1917,1906,1820,-0.005738132,-0.045120672,-0.050599896,121,118,130,-3,12,9
r4781,r,Slurred speech,abnormal clinical findings,1423,1367,1316,-0.039353479,-0.037307974,-0.075193254,150,155,161,5,6,11
r4789,r,Other speech disturbances,abnormal clinical findings,83,95,79,0.144578313,-0.168421053,-0.048192771,764,674,775,-90,101,11
r479,r,Unspecified speech disturbances,abnormal clinical findings,176,144,122,-0.181818182,-0.152777778,-0.306818182,506,550,609,44,59,103
r480,r,Dyslexia and alexia,abnormal clinical findings,53,33,49,-0.377358491,0.484848485,-0.075471698,974,1202,998,228,-204,24
r482,r,Apraxia,abnormal clinical findings,87,75,80,-0.137931034,0.066666667,-0.08045977,743,766,763,23,-3,20
r488,r,Other symbolic dysfunctions,abnormal clinical findings,21,32,39,0.523809524,0.21875,0.857142857,1567,1219,1131,-348,-88,-436
r490,r,Dysphonia,abnormal clinical findings,248,267,292,0.076612903,0.093632959,0.177419355,427,399,385,-28,-14,-42
r491,r,Aphonia,abnormal clinical findings,13,13,29,0,1.230769231,1.230769231,1894,1853,1317,-41,-536,-577
r498,r,Other voice and resonance disorders,abnormal clinical findings,13,10,12,-0.230769231,0.2,-0.076923077,1894,1999,1905,105,-94,11
r499,r,Unspecified voice and resonance disorder,abnormal clinical findings,25,11,19,-0.56,0.727272727,-0.24,1448,1953,1613,505,-340,165
r502,r,Drug induced fever,abnormal clinical findings,76,67,62,-0.118421053,-0.074626866,-0.184210526,797,815,874,18,59,77
r5081,r,Fever presenting with conditions classified elsewhere,abnormal clinical findings,1359,1170,1128,-0.139072848,-0.035897436,-0.169977925,153,165,174,12,9,21
r5082,r,Postprocedural fever,abnormal clinical findings,377,327,295,-0.132625995,-0.097859327,-0.217506631,329,346,382,17,36,53
r5084,r,Febrile nonhemolytic transfusion reaction,abnormal clinical findings,13,18,20,0.384615385,0.111111111,0.538461538,1890,1642,1569,-248,-73,-321
r509,r,"Fever, unspecified",abnormal clinical findings,4469,5399,5377,0.208100246,-0.004074829,0.203177445,61,51,54,-10,3,-7
r52,r,"Pain, unspecified",abnormal clinical findings,560,531,543,-0.051785714,0.02259887,-0.030357143,268,267,273,-1,6,5
r530,r,Neoplastic (malignant) related fatigue,abnormal clinical findings,184,128,73,-0.304347826,-0.4296875,-0.60326087,488,577,801,89,224,313
r531,r,Weakness,abnormal clinical findings,7946,7703,9047,-0.030581425,0.174477476,0.138560282,36,35,29,-1,-6,-7
r532,r,Functional quadriplegia,abnormal clinical findings,337,372,391,0.103857567,0.051075269,0.160237389,344,322,323,-22,1,-21
r5381,r,Other malaise,abnormal clinical findings,3974,3677,3804,-0.074735783,0.034539026,-0.042778057,67,71,73,4,2,6
r5382,r,"Chronic fatigue, unspecified",abnormal clinical findings,232,192,219,-0.172413793,0.140625,-0.056034483,432,468,440,36,-28,8
r5383,r,Other fatigue,abnormal clinical findings,1301,1352,1881,0.039200615,0.391272189,0.445810915,154,153,123,-1,-30,-31
r54,r,Age-related physical debility,abnormal clinical findings,563,676,608,0.20071048,-0.100591716,0.079928952,263,236,249,-27,13,-14
r55,r,Syncope and collapse,abnormal clinical findings,4711,4556,4790,-0.032901719,0.051360843,0.016769263,58,58,62,0,4,4
r5600,r,Simple febrile convulsions,abnormal clinical findings,33,53,26,0.606060606,-0.509433962,-0.212121212,1232,910,1392,-322,482,160
r5601,r,Complex febrile convulsions,abnormal clinical findings,64,60,35,-0.0625,-0.416666667,-0.453125,861,859,1182,-2,323,321
r561,r,Post traumatic seizures,abnormal clinical findings,60,73,71,0.216666667,-0.02739726,0.183333333,892,766,811,-126,45,-81
r569,r,Unspecified convulsions,abnormal clinical findings,4045,3719,3700,-0.080593325,-0.0051089,-0.085290482,63,68,73,5,5,10
r570,r,Cardiogenic shock,abnormal clinical findings,2094,2226,2210,0.063037249,-0.007187781,0.055396371,106,97,107,-9,10,1
r571,r,Hypovolemic shock,abnormal clinical findings,1237,1098,1281,-0.112368634,0.166666667,0.035569927,156,165,155,9,-10,-1
r578,r,Other shock,abnormal clinical findings,1107,1136,1440,0.026196929,0.267605634,0.300813008,164,160,145,-4,-15,-19
r579,r,"Shock, unspecified",abnormal clinical findings,770,854,1063,0.109090909,0.244730679,0.380519481,212,184,174,-28,-10,-38
r58,r,"Hemorrhage, not elsewhere classified",abnormal clinical findings,212,167,222,-0.212264151,0.329341317,0.047169811,449,483,429,34,-54,-20
r590,r,Localized enlarged lymph nodes,abnormal clinical findings,1536,1465,1657,-0.046223958,0.13105802,0.078776042,135,138,131,3,-7,-4
r591,r,Generalized enlarged lymph nodes,abnormal clinical findings,418,383,441,-0.083732057,0.151436031,0.055023923,298,308,291,10,-17,-7
r599,r,"Enlarged lymph nodes, unspecified",abnormal clinical findings,195,197,182,0.01025641,-0.076142132,-0.066666667,460,451,465,-9,14,5
r600,r,Localized edema,abnormal clinical findings,2805,2551,2482,-0.090552585,-0.027048216,-0.115151515,80,84,88,4,4,8
r601,r,Generalized edema,abnormal clinical findings,475,462,495,-0.027368421,0.071428571,0.042105263,281,282,276,1,-6,-5
r609,r,"Edema, unspecified",abnormal clinical findings,821,755,683,-0.080389769,-0.095364238,-0.168087698,198,207,227,9,20,29
r61,r,Generalized hyperhidrosis,abnormal clinical findings,172,162,201,-0.058139535,0.240740741,0.168604651,487,488,441,1,-47,-46
r620,r,Delayed milestone in childhood,abnormal clinical findings,108,73,90,-0.324074074,0.232876712,-0.166666667,638,753,696,115,-57,58
r6250,r,Unspecified lack of expected normal physiological development in childhood,abnormal clinical findings,769,758,720,-0.014304291,-0.050131926,-0.063719116,209,206,220,-3,14,11
r6251,r,Failure to thrive (child),abnormal clinical findings,525,469,397,-0.106666667,-0.153518124,-0.243809524,268,279,302,11,23,34
r6252,r,Short stature (child),abnormal clinical findings,48,45,60,-0.0625,0.333333333,0.25,991,980,853,-11,-127,-138
r6259,r,Other lack of expected normal physiological development in childhood,abnormal clinical findings,42,28,26,-0.333333333,-0.071428571,-0.380952381,1068,1282,1373,214,91,305
r627,r,Adult failure to thrive,abnormal clinical findings,2962,2854,3130,-0.03646185,0.096706377,0.056718433,76,81,77,5,-4,1
r630,r,Anorexia,abnormal clinical findings,888,924,1150,0.040540541,0.244588745,0.295045045,183,175,159,-8,-16,-24
r631,r,Polydipsia,abnormal clinical findings,222,234,227,0.054054054,-0.02991453,0.022522523,424,409,417,-15,8,-7
r632,r,Polyphagia,abnormal clinical findings,17,13,12,-0.235294118,-0.076923077,-0.294117647,1677,1815,1866,138,51,189
r633,r,Feeding difficulties,abnormal clinical findings,743,806,679,0.084791386,-0.157568238,-0.086137281,213,194,224,-19,30,11
r634,r,Abnormal weight loss,abnormal clinical findings,1882,1673,1803,-0.111052072,0.077704722,-0.041976621,116,126,122,10,-4,6
r635,r,Abnormal weight gain,abnormal clinical findings,78,77,73,-0.012820513,-0.051948052,-0.064102564,757,718,773,-39,55,16
r636,r,Underweight,abnormal clinical findings,478,437,507,-0.085774059,0.160183066,0.060669456,272,280,267,8,-13,-5
r638,r,Other symptoms and signs concerning food and fluid intake,abnormal clinical findings,49,55,100,0.12244898,0.818181818,1.040816327,972,869,647,-103,-222,-325
r64,r,Cachexia,abnormal clinical findings,2174,2250,2214,0.034958602,-0.016,0.018399264,99,92,104,-7,12,5
r6510,r,Systemic inflammatory response syndrome (SIRS) of non-infectious origin without acute organ dysfunction,abnormal clinical findings,2755,2495,2722,-0.094373866,0.090981964,-0.011978221,79,86,82,7,-4,3
r6511,r,Systemic inflammatory response syndrome (SIRS) of non-infectious origin with acute organ dysfunction,abnormal clinical findings,309,270,290,-0.126213592,0.074074074,-0.061488673,346,367,356,21,-11,10
r6520,r,Severe sepsis without septic shock,abnormal clinical findings,3686,4080,4115,0.106890939,0.008578431,0.116386327,67,63,67,-4,4,0
r6521,r,Severe sepsis with septic shock,abnormal clinical findings,6007,7188,8492,0.196603962,0.181413467,0.413684035,47,38,33,-9,-5,-14
r680,r,"Hypothermia, not associated with low environmental temperature",abnormal clinical findings,223,277,222,0.242152466,-0.198555957,-0.004484305,415,359,411,-56,52,-4
r6812,r,Fussy infant (baby),abnormal clinical findings,82,93,50,0.134146341,-0.462365591,-0.390243902,727,644,939,-83,295,212
r6813,r,Apparent life threatening event in infant (ALTE),abnormal clinical findings,118,93,77,-0.211864407,-0.172043011,-0.347457627,599,644,743,45,99,144
r682,r,"Dry mouth, unspecified",abnormal clinical findings,96,127,102,0.322916667,-0.196850394,0.0625,664,547,632,-117,85,-32
r6881,r,Early satiety,abnormal clinical findings,100,73,104,-0.27,0.424657534,0.04,647,735,625,88,-110,-22
r6883,r,Chills (without fever),abnormal clinical findings,106,121,146,0.141509434,0.20661157,0.377358491,628,557,504,-71,-53,-124
r6884,r,Jaw pain,abnormal clinical findings,141,128,150,-0.092198582,0.171875,0.063829787,535,543,495,8,-48,-40
r6889,r,Other general symptoms and signs,abnormal clinical findings,739,821,727,0.110960758,-0.114494519,-0.01623816,209,186,211,-23,25,2
r700,r,Elevated erythrocyte sedimentation rate,abnormal clinical findings,149,157,173,0.053691275,0.101910828,0.161073826,517,483,458,-34,-25,-59
r710,r,Precipitous drop in hematocrit,abnormal clinical findings,108,83,138,-0.231481481,0.662650602,0.277777778,620,677,518,57,-159,-102
r718,r,Other abnormality of red blood cells,abnormal clinical findings,41,31,51,-0.243902439,0.64516129,0.243902439,1059,1183,918,124,-265,-141
r7301,r,Impaired fasting glucose,abnormal clinical findings,115,98,97,-0.147826087,-0.010204082,-0.156521739,604,617,650,13,33,46
r7302,r,Impaired glucose tolerance (oral),abnormal clinical findings,117,98,85,-0.162393162,-0.132653061,-0.273504274,597,617,697,20,80,100
r7303,r,Prediabetes,abnormal clinical findings,3456,3304,3983,-0.043981481,0.205508475,0.152488426,66,71,67,5,-4,1
r7309,r,Other abnormal glucose,abnormal clinical findings,75,62,58,-0.173333333,-0.064516129,-0.226666667,750,803,842,53,39,92
r739,r,"Hyperglycemia, unspecified",abnormal clinical findings,6422,6229,7823,-0.030052943,0.255899823,0.218156338,43,43,35,0,-8,-8
r748,r,Abnormal levels of other serum enzymes,abnormal clinical findings,2306,1936,2081,-0.160450997,0.074896694,-0.097571552,91,99,105,8,6,14
r760,r,Raised antibody titer,abnormal clinical findings,44,34,34,-0.227272727,0,-0.227272727,1012,1112,1152,100,40,140
r7611,r,Nonspecific reaction to tuberculin skin test without active tuberculosis,abnormal clinical findings,270,152,102,-0.437037037,-0.328947368,-0.622222222,373,491,623,118,132,250
r7612,r,Nonspecific reaction to cell mediated immunity measurement of gamma interferon antigen response without active tuberculosis,abnormal clinical findings,76,53,40,-0.302631579,-0.245283019,-0.473684211,741,862,1054,121,192,313
r768,r,Other specified abnormal immunological findings in serum,abnormal clinical findings,185,169,193,-0.086486486,0.142011834,0.043243243,448,454,429,6,-25,-19
r770,r,Abnormality of albumin,abnormal clinical findings,16,15,18,-0.0625,0.2,0.125,1684,1696,1581,12,-115,-103
r778,r,Other specified abnormalities of plasma proteins,abnormal clinical findings,18,23,1161,0.277777778,49.47826087,63.5,1607,1404,147,-203,-1257,-1460
r784,r,Finding of other drugs of addictive potential in blood,abnormal clinical findings,17,23,15,0.352941176,-0.347826087,-0.117647059,1645,1404,1697,-241,293,52
r7881,r,Bacteremia,abnormal clinical findings,2586,2505,2635,-0.031322506,0.051896208,0.018948183,78,81,79,3,-2,1
r7889,r,"Finding of other specified substances, not normally found in blood",abnormal clinical findings,55,36,32,-0.345454545,-0.111111111,-0.418181818,895,1081,1192,186,111,297
r790,r,Abnormal level of blood mineral,abnormal clinical findings,12,16,28,0.333333333,0.75,1.333333333,1853,1657,1280,-196,-377,-573
r791,r,Abnormal coagulation profile,abnormal clinical findings,2479,2523,2764,0.017749092,0.095521205,0.114965712,80,80,76,0,-4,-4
r7982,r,Elevated C-reactive protein (CRP),abnormal clinical findings,358,561,957,0.567039106,0.705882353,1.673184358,304,232,165,-72,-67,-139
r7989,r,Other specified abnormal findings of blood chemistry,abnormal clinical findings,3003,4103,4863,0.366300366,0.185230319,0.619380619,71,59,58,-12,-1,-13
r799,r,"Abnormal finding of blood chemistry, unspecified",abnormal clinical findings,69,36,55,-0.47826087,0.527777778,-0.202898551,776,1078,862,302,-216,86
r808,r,Other proteinuria,abnormal clinical findings,23,24,29,0.043478261,0.208333333,0.260869565,1426,1364,1244,-62,-120,-182
r809,r,"Proteinuria, unspecified",abnormal clinical findings,758,693,908,-0.085751979,0.31024531,0.197889182,200,209,172,9,-37,-28
r81,r,Glycosuria,abnormal clinical findings,21,22,27,0.047619048,0.227272727,0.285714286,1489,1430,1300,-59,-130,-189
r821,r,Myoglobinuria,abnormal clinical findings,11,10,13,-0.090909091,0.3,0.181818182,1881,1915,1780,34,-135,-101
r824,r,Acetonuria,abnormal clinical findings,62,65,56,0.048387097,-0.138461538,-0.096774194,826,767,852,-59,85,26
r825,r,"Elevated urine levels of drugs, medicaments and biological substances",abnormal clinical findings,45,36,32,-0.2,-0.111111111,-0.288888889,992,1076,1186,84,110,194
r8271,r,Bacteriuria,abnormal clinical findings,571,525,536,-0.08056042,0.020952381,-0.061295972,234,239,242,5,3,8
r8279,r,Other abnormal findings on microbiological examination of urine,abnormal clinical findings,20,19,15,-0.05,-0.210526316,-0.25,1513,1527,1684,14,157,171
r8281,r,Pyuria,abnormal clinical findings,292,603,599,1.065068493,-0.006633499,1.051369863,348,222,223,-126,1,-125
r8289,r,Other abnormal findings on cytological and histological examination of urine,abnormal clinical findings,26,32,38,0.230769231,0.1875,0.461538462,1334,1141,1072,-193,-69,-262
r8290,r,Unspecified abnormal findings in urine,abnormal clinical findings,229,168,174,-0.266375546,0.035714286,-0.240174672,396,449,443,53,-6,47
r82998,r,Other abnormal findings in urine,abnormal clinical findings,99,29,40,-0.707070707,0.379310345,-0.595959596,628,1207,1042,579,-165,414
r87610,r,Atypical squamous cells of undetermined significance on cytologic smear of cervix (ASC-US),abnormal clinical findings,35,25,29,-0.285714286,0.16,-0.171428571,1128,1320,1236,192,-84,108
r87612,r,Low grade squamous intraepithelial lesion on cytologic smear of cervix (LGSIL),abnormal clinical findings,40,33,38,-0.175,0.151515152,-0.05,1048,1122,1070,74,-52,22
r87619,r,Unspecified abnormal cytological findings in specimens from cervix uteri,abnormal clinical findings,16,14,10,-0.125,-0.285714286,-0.375,1663,1722,1894,59,172,231
r87810,r,Cervical high risk human papillomavirus (HPV) DNA test positive,abnormal clinical findings,26,26,37,0,0.423076923,0.423076923,1330,1294,1078,-36,-216,-252
r87820,r,Cervical low risk human papillomavirus (HPV) DNA test positive,abnormal clinical findings,11,11,13,0,0.181818182,0.181818182,1869,1858,1769,-11,-89,-100
r9082,r,"White matter disease, unspecified",abnormal clinical findings,72,69,98,-0.041666667,0.420289855,0.361111111,754,737,633,-17,-104,-121
r9089,r,Other abnormal findings on diagnostic imaging of central nervous system,abnormal clinical findings,24,27,30,0.125,0.111111111,0.25,1390,1260,1223,-130,-37,-167
r911,r,Solitary pulmonary nodule,abnormal clinical findings,2904,3020,2755,0.039944904,-0.087748344,-0.05130854,72,71,75,-1,4,3
r918,r,Other nonspecific abnormal finding of lung field,abnormal clinical findings,2015,2171,2330,0.077419355,0.073238139,0.156327543,94,85,89,-9,4,-5
r930,r,"Abnormal findings on diagnostic imaging of skull and head, not elsewhere classified",abnormal clinical findings,44,44,47,0,0.068181818,0.068181818,993,953,946,-40,-7,-47
r931,r,Abnormal findings on diagnostic imaging of heart and coronary circulation,abnormal clinical findings,31,32,41,0.032258065,0.28125,0.322580645,1203,1135,1027,-68,-108,-176
r932,r,Abnormal findings on diagnostic imaging of liver and biliary tract,abnormal clinical findings,64,48,39,-0.25,-0.1875,-0.390625,801,903,1049,102,146,248
r933,r,Abnormal findings on diagnostic imaging of other parts of digestive tract,abnormal clinical findings,52,54,37,0.038461538,-0.314814815,-0.288461538,903,840,1072,-63,232,169
r9341,r,"Abnormal radiologic findings on diagnostic imaging of renal pelvis, ureter, or bladder",abnormal clinical findings,28,19,18,-0.321428571,-0.052631579,-0.357142857,1276,1512,1552,236,40,276
r935,r,"Abnormal findings on diagnostic imaging of other abdominal regions, including retroperitoneum",abnormal clinical findings,42,48,45,0.142857143,-0.0625,0.071428571,1016,902,971,-114,69,-45
r937,r,Abnormal findings on diagnostic imaging of other parts of musculoskeletal system,abnormal clinical findings,18,24,17,0.333333333,-0.291666667,-0.055555556,1577,1344,1590,-233,246,13
r9389,r,Abnormal findings on diagnostic imaging of other specified body structures,abnormal clinical findings,159,158,169,-0.006289308,0.069620253,0.062893082,476,466,447,-10,-19,-29
r9401,r,Abnormal electroencephalogram [EEG],abnormal clinical findings,68,64,68,-0.058823529,0.0625,0,770,765,767,-5,2,-3
r94120,r,Abnormal auditory function study,abnormal clinical findings,259,291,357,0.123552124,0.226804124,0.378378378,369,337,301,-32,-36,-68
r9431,r,Abnormal electrocardiogram [ECG] [EKG],abnormal clinical findings,1282,1857,1995,0.448517941,0.074313409,0.556162246,135,102,103,-33,1,-32
r9439,r,Abnormal result of other cardiovascular function study,abnormal clinical findings,158,111,135,-0.297468354,0.216216216,-0.14556962,476,562,506,86,-56,30
r944,r,Abnormal results of kidney function studies,abnormal clinical findings,123,133,152,0.081300813,0.142857143,0.235772358,559,515,471,-44,-44,-88
r945,r,Abnormal results of liver function studies,abnormal clinical findings,799,741,893,-0.072590738,0.205128205,0.117647059,187,191,169,4,-22,-18
r946,r,Abnormal results of thyroid function studies,abnormal clinical findings,403,343,363,-0.148883375,0.058309038,-0.099255583,277,293,295,16,2,18
r948,r,Abnormal results of function studies of other organs and systems,abnormal clinical findings,19,24,16,0.263157895,-0.333333333,-0.157894737,1522,1336,1616,-186,280,94
r970,r,Elevated carcinoembryonic antigen [CEA],abnormal clinical findings,30,33,25,0.1,-0.242424242,-0.166666667,1215,1107,1325,-108,218,110
r971,r,Elevated cancer antigen 125 [CA 125],abnormal clinical findings,47,31,53,-0.340425532,0.709677419,0.127659574,944,1142,864,198,-278,-80
r9720,r,Elevated prostate specific antigen [PSA],abnormal clinical findings,137,107,123,-0.218978102,0.14953271,-0.102189781,524,571,540,47,-31,16
r9721,r,Rising PSA following treatment for malignant neoplasm of prostate,abnormal clinical findings,11,10,15,-0.090909091,0.5,0.363636364,1846,1879,1654,33,-225,-192
s0001xa,s,"Abrasion of scalp, initial encounter",Injury or poisoning,126,115,145,-0.087301587,0.260869565,0.150793651,547,552,481,5,-71,-66
s0003xa,s,"Contusion of scalp, initial encounter",Injury or poisoning,600,621,642,0.035,0.033816425,0.07,222,215,209,-7,-6,-13
s0003xd,s,"Contusion of scalp, subsequent encounter",Injury or poisoning,42,57,52,0.357142857,-0.087719298,0.238095238,1004,808,872,-196,64,-132
s0010xa,s,"Contusion of unspecified eyelid and periocular area, initial encounter",Injury or poisoning,36,18,31,-0.5,0.722222222,-0.138888889,1089,1529,1184,440,-345,95
s0011xa,s,"Contusion of right eyelid and periocular area, initial encounter",Injury or poisoning,141,138,129,-0.021276596,-0.065217391,-0.085106383,511,502,519,-9,17,8
s0011xd,s,"Contusion of right eyelid and periocular area, subsequent encounter",Injury or poisoning,12,12,16,0,0.333333333,0.333333333,1806,1782,1608,-24,-174,-198
s0012xa,s,"Contusion of left eyelid and periocular area, initial encounter",Injury or poisoning,139,146,143,0.050359712,-0.020547945,0.028776978,515,483,483,-32,0,-32
s00211a,s,"Abrasion of right eyelid and periocular area, initial encounter",Injury or poisoning,22,22,26,0,0.181818182,0.181818182,1423,1393,1293,-30,-100,-130
s00212a,s,"Abrasion of left eyelid and periocular area, initial encounter",Injury or poisoning,18,19,27,0.055555556,0.421052632,0.5,1558,1492,1265,-66,-227,-293
s0031xa,s,"Abrasion of nose, initial encounter",Injury or poisoning,48,58,79,0.208333333,0.362068966,0.645833333,929,798,694,-131,-104,-235
s0033xa,s,"Contusion of nose, initial encounter",Injury or poisoning,23,14,27,-0.391304348,0.928571429,0.173913043,1387,1689,1264,302,-425,-123
s00511a,s,"Abrasion of lip, initial encounter",Injury or poisoning,20,14,21,-0.3,0.5,0.05,1476,1689,1419,213,-270,-57
s00531a,s,"Contusion of lip, initial encounter",Injury or poisoning,18,19,24,0.055555556,0.263157895,0.333333333,1555,1491,1349,-64,-142,-206
s0081xa,s,"Abrasion of other part of head, initial encounter",Injury or poisoning,477,433,461,-0.092243187,0.064665127,-0.033542977,254,260,257,6,-3,3
s0081xd,s,"Abrasion of other part of head, subsequent encounter",Injury or poisoning,29,34,35,0.172413793,0.029411765,0.206896552,1230,1074,1091,-156,17,-139
s0083xa,s,"Contusion of other part of head, initial encounter",Injury or poisoning,591,480,523,-0.187817259,0.089583333,-0.115059222,224,247,241,23,-6,17
s0083xd,s,"Contusion of other part of head, subsequent encounter",Injury or poisoning,50,61,52,0.22,-0.147540984,0.04,908,778,867,-130,89,-41
s0091xa,s,"Abrasion of unspecified part of head, initial encounter",Injury or poisoning,30,25,27,-0.166666667,0.08,-0.1,1203,1288,1260,85,-28,57
s0093xa,s,"Contusion of unspecified part of head, initial encounter",Injury or poisoning,101,72,90,-0.287128713,0.25,-0.108910891,607,703,642,96,-61,35
s0101xa,s,"Laceration without foreign body of scalp, initial encounter",Injury or poisoning,1118,1085,1172,-0.029516995,0.080184332,0.048300537,145,148,140,3,-8,-5
s0101xd,s,"Laceration without foreign body of scalp, subsequent encounter",Injury or poisoning,106,81,111,-0.235849057,0.37037037,0.047169811,592,653,572,61,-81,-20
s0102xa,s,"Laceration with foreign body of scalp, initial encounter",Injury or poisoning,19,13,18,-0.315789474,0.384615385,-0.052631579,1501,1716,1520,215,-196,19
s01111a,s,"Laceration without foreign body of right eyelid and periocular area, initial encounter",Injury or poisoning,210,213,246,0.014285714,0.154929577,0.171428571,409,398,369,-11,-29,-40
s01112a,s,"Laceration without foreign body of left eyelid and periocular area, initial encounter",Injury or poisoning,249,228,261,-0.084337349,0.144736842,0.048192771,370,385,358,15,-27,-12
s0121xa,s,"Laceration without foreign body of nose, initial encounter",Injury or poisoning,117,128,135,0.094017094,0.0546875,0.153846154,565,512,495,-53,-17,-70
s01311a,s,"Laceration without foreign body of right ear, initial encounter",Injury or poisoning,47,45,46,-0.042553191,0.022222222,-0.021276596,929,909,936,-20,27,7
s01312a,s,"Laceration without foreign body of left ear, initial encounter",Injury or poisoning,75,50,45,-0.333333333,-0.1,-0.4,714,848,945,134,97,231
s01411a,s,"Laceration without foreign body of right cheek and temporomandibular area, initial encounter",Injury or poisoning,33,38,33,0.151515152,-0.131578947,0,1128,1012,1120,-116,108,-8
s01412a,s,"Laceration without foreign body of left cheek and temporomandibular area, initial encounter",Injury or poisoning,48,49,34,0.020833333,-0.306122449,-0.291666667,919,861,1098,-58,237,179
s01511a,s,"Laceration without foreign body of lip, initial encounter",Injury or poisoning,240,228,239,-0.05,0.048245614,-0.004166667,377,385,375,8,-10,-2
s01511d,s,"Laceration without foreign body of lip, subsequent encounter",Injury or poisoning,10,12,18,0.2,0.5,0.8,1856,1758,1512,-98,-246,-344
s01512a,s,"Laceration without foreign body of oral cavity, initial encounter",Injury or poisoning,152,105,113,-0.309210526,0.076190476,-0.256578947,480,563,563,83,0,83
s01551a,s,"Open bite of lip, initial encounter",Injury or poisoning,14,12,11,-0.142857143,-0.083333333,-0.214285714,1696,1757,1799,61,42,103
s0181xa,s,"Laceration without foreign body of other part of head, initial encounter",Injury or poisoning,936,866,887,-0.074786325,0.024249423,-0.052350427,158,162,168,4,6,10
s0181xd,s,"Laceration without foreign body of other part of head, subsequent encounter",Injury or poisoning,91,102,86,0.120879121,-0.156862745,-0.054945055,635,570,647,-65,77,12
s0182xa,s,"Laceration with foreign body of other part of head, initial encounter",Injury or poisoning,10,12,17,0.2,0.416666667,0.7,1852,1755,1546,-97,-209,-306
s0185xa,s,"Open bite of other part of head, initial encounter",Injury or poisoning,15,13,11,-0.133333333,-0.153846154,-0.266666667,1652,1705,1796,53,91,144
s0191xa,s,"Laceration without foreign body of unspecified part of head, initial encounter",Injury or poisoning,55,63,60,0.145454545,-0.047619048,0.090909091,855,751,786,-104,35,-69
s020xxa,s,"Fracture of vault of skull, initial encounter for closed fracture",Injury or poisoning,290,246,231,-0.151724138,-0.06097561,-0.203448276,339,360,379,21,19,40
s020xxb,s,"Fracture of vault of skull, initial encounter for open fracture",Injury or poisoning,44,41,57,-0.068181818,0.390243902,0.295454545,958,961,808,3,-153,-150
s020xxd,s,"Fracture of vault of skull, subsequent encounter for fracture with routine healing",Injury or poisoning,37,38,64,0.027027027,0.684210526,0.72972973,1052,1004,762,-48,-242,-290
s02109a,s,"Fracture of base of skull, unspecified side, initial encounter for closed fracture",Injury or poisoning,18,15,21,-0.166666667,0.4,0.166666667,1531,1617,1395,86,-222,-136
s02113a,s,"Unspecified occipital condyle fracture, initial encounter for closed fracture",Injury or poisoning,44,35,51,-0.204545455,0.457142857,0.159090909,958,1041,863,83,-178,-95
s02113d,s,"Unspecified occipital condyle fracture, subsequent encounter for fracture with routine healing",Injury or poisoning,14,18,16,0.285714286,-0.111111111,0.142857143,1687,1499,1573,-188,74,-114
s02119a,s,"Unspecified fracture of occiput, initial encounter for closed fracture",Injury or poisoning,143,145,147,0.013986014,0.013793103,0.027972028,498,475,467,-23,-8,-31
s02119d,s,"Unspecified fracture of occiput, subsequent encounter for fracture with routine healing",Injury or poisoning,28,21,28,-0.25,0.333333333,0,1232,1400,1214,168,-186,-18
s0211ga,s,"Other fracture of occiput, right side, initial encounter for closed fracture",Injury or poisoning,23,12,17,-0.47826087,0.416666667,-0.260869565,1361,1745,1538,384,-207,177
s02121a,s,"Fracture of orbital roof, right side, initial encounter for closed fracture",Injury or poisoning,15,26,18,0.733333333,-0.307692308,0.2,1643,1244,1501,-399,257,-142
s02122a,s,"Fracture of orbital roof, left side, initial encounter for closed fracture",Injury or poisoning,12,16,21,0.333333333,0.3125,0.75,1766,1578,1392,-188,-186,-374
s0219xa,s,"Other fracture of base of skull, initial encounter for closed fracture",Injury or poisoning,375,330,345,-0.12,0.045454545,-0.08,284,293,294,9,1,10
s0219xb,s,"Other fracture of base of skull, initial encounter for open fracture",Injury or poisoning,45,43,50,-0.044444444,0.162790698,0.111111111,948,924,872,-24,-52,-76
s0219xd,s,"Other fracture of base of skull, subsequent encounter for fracture with routine healing",Injury or poisoning,63,49,63,-0.222222222,0.285714286,0,780,853,768,73,-85,-12
s022xxa,s,"Fracture of nasal bones, initial encounter for closed fracture",Injury or poisoning,624,602,594,-0.03525641,-0.013289037,-0.048076923,216,215,217,-1,2,1
s022xxb,s,"Fracture of nasal bones, initial encounter for open fracture",Injury or poisoning,37,45,45,0.216216216,0,0.216216216,1046,897,931,-149,34,-115
s022xxd,s,"Fracture of nasal bones, subsequent encounter for fracture with routine healing",Injury or poisoning,80,82,87,0.025,0.06097561,0.0875,687,638,640,-49,2,-47
s0231xa,s,"Fracture of orbital floor, right side, initial encounter for closed fracture",Injury or poisoning,144,151,135,0.048611111,-0.105960265,-0.0625,493,464,489,-29,25,-4
s0231xd,s,"Fracture of orbital floor, right side, subsequent encounter for fracture with routine healing",Injury or poisoning,15,18,12,0.2,-0.333333333,-0.2,1636,1489,1731,-147,242,95
s0232xa,s,"Fracture of orbital floor, left side, initial encounter for closed fracture",Injury or poisoning,160,148,149,-0.075,0.006756757,-0.06875,459,467,461,8,-6,2
s0232xd,s,"Fracture of orbital floor, left side, subsequent encounter for fracture with routine healing",Injury or poisoning,14,19,15,0.357142857,-0.210526316,0.071428571,1674,1456,1599,-218,143,-75
s02401a,s,"Maxillary fracture, unspecified side, initial encounter for closed fracture",Injury or poisoning,39,29,31,-0.256410256,0.068965517,-0.205128205,1015,1149,1149,134,0,134
s0240ca,s,"Maxillary fracture, right side, initial encounter for closed fracture",Injury or poisoning,149,140,119,-0.060402685,-0.15,-0.201342282,483,483,538,0,55,55
s0240cd,s,"Maxillary fracture, right side, subsequent encounter for fracture with routine healing",Injury or poisoning,16,20,20,0.25,0,0.25,1588,1424,1413,-164,-11,-175
s0240da,s,"Maxillary fracture, left side, initial encounter for closed fracture",Injury or poisoning,153,143,140,-0.065359477,-0.020979021,-0.08496732,472,477,473,5,-4,1
s0240dd,s,"Maxillary fracture, left side, subsequent encounter for fracture with routine healing",Injury or poisoning,12,12,15,0,0.25,0.25,1752,1729,1595,-23,-134,-157
s0240ea,s,"Zygomatic fracture, right side, initial encounter for closed fracture",Injury or poisoning,128,119,92,-0.0703125,-0.226890756,-0.28125,522,521,620,-1,99,98
s0240ed,s,"Zygomatic fracture, right side, subsequent encounter for fracture with routine healing",Injury or poisoning,16,12,14,-0.25,0.166666667,-0.125,1586,1728,1636,142,-92,50
s0240fa,s,"Zygomatic fracture, left side, initial encounter for closed fracture",Injury or poisoning,122,118,114,-0.032786885,-0.033898305,-0.06557377,535,523,549,-12,26,14
s0240fd,s,"Zygomatic fracture, left side, subsequent encounter for fracture with routine healing",Injury or poisoning,11,10,18,-0.090909091,0.8,0.636363636,1781,1812,1486,31,-326,-295
s02411a,s,"LeFort I fracture, initial encounter for closed fracture",Injury or poisoning,34,28,18,-0.176470588,-0.357142857,-0.470588235,1081,1171,1486,90,315,405
s02412a,s,"LeFort II fracture, initial encounter for closed fracture",Injury or poisoning,23,27,22,0.173913043,-0.185185185,-0.043478261,1347,1198,1354,-149,156,7
s02413a,s,"LeFort III fracture, initial encounter for closed fracture",Injury or poisoning,13,23,15,0.769230769,-0.347826087,0.153846154,1713,1317,1590,-396,273,-123
s0242xa,s,"Fracture of alveolus of maxilla, initial encounter for closed fracture",Injury or poisoning,10,22,15,1.2,-0.318181818,0.5,1817,1350,1590,-467,240,-227
s025xxa,s,"Fracture of tooth (traumatic), initial encounter for closed fracture",Injury or poisoning,110,70,98,-0.363636364,0.4,-0.109090909,568,691,600,123,-91,32
s02601a,s,"Fracture of unspecified part of body of right mandible, initial encounter for closed fracture",Injury or poisoning,19,19,18,0,-0.052631579,-0.052631579,1466,1445,1484,-21,39,18
s02602a,s,"Fracture of unspecified part of body of left mandible, initial encounter for closed fracture",Injury or poisoning,18,21,15,0.166666667,-0.285714286,-0.166666667,1510,1381,1588,-129,207,78
s02609a,s,"Fracture of mandible, unspecified, initial encounter for closed fracture",Injury or poisoning,56,43,49,-0.232142857,0.139534884,-0.125,829,913,872,84,-41,43
s02609d,s,"Fracture of mandible, unspecified, subsequent encounter for fracture with routine healing",Injury or poisoning,33,16,21,-0.515151515,0.3125,-0.363636364,1101,1554,1376,453,-178,275
s02611a,s,"Fracture of condylar process of right mandible, initial encounter for closed fracture",Injury or poisoning,47,27,28,-0.425531915,0.037037037,-0.404255319,908,1196,1199,288,3,291
s02612a,s,"Fracture of condylar process of left mandible, initial encounter for closed fracture",Injury or poisoning,44,18,29,-0.590909091,0.611111111,-0.340909091,943,1472,1169,529,-303,226
s02621a,s,"Fracture of subcondylar process of right mandible, initial encounter for closed fracture",Injury or poisoning,19,15,19,-0.210526316,0.266666667,0,1462,1584,1443,122,-141,-19
s02622a,s,"Fracture of subcondylar process of left mandible, initial encounter for closed fracture",Injury or poisoning,20,17,19,-0.15,0.117647059,-0.05,1429,1516,1443,87,-73,14
s02641a,s,"Fracture of ramus of right mandible, initial encounter for closed fracture",Injury or poisoning,16,18,16,0.125,-0.111111111,0,1574,1472,1543,-102,71,-31
s02642a,s,"Fracture of ramus of left mandible, initial encounter for closed fracture",Injury or poisoning,27,27,28,0,0.037037037,0.037037037,1239,1196,1198,-43,2,-41
s02651a,s,"Fracture of angle of right mandible, initial encounter for closed fracture",Injury or poisoning,20,16,19,-0.2,0.1875,-0.05,1428,1549,1442,121,-107,14
s02652a,s,"Fracture of angle of left mandible, initial encounter for closed fracture",Injury or poisoning,35,27,29,-0.228571429,0.074074074,-0.171428571,1064,1196,1169,132,-27,105
s0266xa,s,"Fracture of symphysis of mandible, initial encounter for closed fracture",Injury or poisoning,51,30,44,-0.411764706,0.466666667,-0.137254902,873,1122,936,249,-186,63
s0266xb,s,"Fracture of symphysis of mandible, initial encounter for open fracture",Injury or poisoning,26,15,20,-0.423076923,0.333333333,-0.230769231,1255,1578,1401,323,-177,146
s0281xa,s,"Fracture of other specified skull and facial bones, right side, initial encounter for closed fracture",Injury or poisoning,67,12,17,-0.820895522,0.416666667,-0.746268657,739,1708,1506,969,-202,767
s0282xa,s,"Fracture of other specified skull and facial bones, left side, initial encounter for closed fracture",Injury or poisoning,64,12,12,-0.8125,0,-0.8125,762,1708,1700,946,-8,938
s02831a,s,"Fracture of medial orbital wall, right side, initial encounter for closed fracture",Injury or poisoning,34,62,67,0.823529412,0.080645161,0.970588235,1073,749,736,-324,-13,-337
s02832a,s,"Fracture of medial orbital wall, left side, initial encounter for closed fracture",Injury or poisoning,41,65,54,0.585365854,-0.169230769,0.317073171,974,725,819,-249,94,-155
s02841a,s,"Fracture of lateral orbital wall, right side, initial encounter for closed fracture",Injury or poisoning,29,53,48,0.827586207,-0.094339623,0.655172414,1182,805,884,-377,79,-298
s02842a,s,"Fracture of lateral orbital wall, left side, initial encounter for closed fracture",Injury or poisoning,25,65,48,1.6,-0.261538462,0.92,1282,725,884,-557,159,-398
s0285xa,s,"Fracture of orbit, unspecified, initial encounter for closed fracture",Injury or poisoning,43,72,75,0.674418605,0.041666667,0.744186047,952,683,691,-269,8,-261
s0285xd,s,"Fracture of orbit, unspecified, subsequent encounter for fracture with routine healing",Injury or poisoning,14,26,29,0.857142857,0.115384615,1.071428571,1643,1218,1163,-425,-55,-480
s0291xa,s,"Unspecified fracture of skull, initial encounter for closed fracture",Injury or poisoning,31,23,32,-0.258064516,0.391304348,0.032258065,1134,1305,1111,171,-194,-23
s0291xd,s,"Unspecified fracture of skull, subsequent encounter for fracture with routine healing",Injury or poisoning,12,15,18,0.25,0.2,0.5,1722,1571,1466,-151,-105,-256
s0292xa,s,"Unspecified fracture of facial bones, initial encounter for closed fracture",Injury or poisoning,29,25,28,-0.137931034,0.12,-0.034482759,1180,1240,1189,60,-51,9
s032xxa,s,"Dislocation of tooth, initial encounter",Injury or poisoning,20,23,21,0.15,-0.086956522,0.05,1416,1304,1363,-112,59,-53
s0501xa,s,"Injury of conjunctiva and corneal abrasion without foreign body, right eye, initial encounter",Injury or poisoning,14,22,34,0.571428571,0.545454545,1.428571429,1640,1335,1068,-305,-267,-572
s0502xa,s,"Injury of conjunctiva and corneal abrasion without foreign body, left eye, initial encounter",Injury or poisoning,31,24,25,-0.225806452,0.041666667,-0.193548387,1134,1273,1258,139,-15,124
s0511xa,s,"Contusion of eyeball and orbital tissues, right eye, initial encounter",Injury or poisoning,85,74,85,-0.129411765,0.148648649,0,651,668,644,17,-24,-7
s0512xa,s,"Contusion of eyeball and orbital tissues, left eye, initial encounter",Injury or poisoning,111,72,102,-0.351351351,0.416666667,-0.081081081,564,682,580,118,-102,16
s0512xd,s,"Contusion of eyeball and orbital tissues, left eye, subsequent encounter",Injury or poisoning,11,10,10,-0.090909091,0,-0.090909091,1747,1777,1765,30,-12,18
s0531xa,s,"Ocular laceration without prolapse or loss of intraocular tissue, right eye, initial encounter",Injury or poisoning,17,17,16,0,-0.058823529,-0.058823529,1519,1499,1523,-20,24,4
s0532xa,s,"Ocular laceration without prolapse or loss of intraocular tissue, left eye, initial encounter",Injury or poisoning,22,20,29,-0.090909091,0.45,0.318181818,1358,1397,1159,39,-238,-199
s060x0a,s,"Concussion without loss of consciousness, initial encounter",Injury or poisoning,253,274,236,0.083003953,-0.138686131,-0.067193676,361,337,375,-24,38,14
s060x0d,s,"Concussion without loss of consciousness, subsequent encounter",Injury or poisoning,27,30,29,0.111111111,-0.033333333,0.074074074,1225,1114,1158,-111,44,-67
s060x1a,s,"Concussion with loss of consciousness of 30 minutes or less, initial encounter",Injury or poisoning,212,217,172,0.023584906,-0.207373272,-0.188679245,400,385,427,-15,42,27
s060x9a,s,"Concussion with loss of consciousness of unspecified duration, initial encounter",Injury or poisoning,339,304,281,-0.103244838,-0.075657895,-0.171091445,296,314,334,18,20,38
s060x9d,s,"Concussion with loss of consciousness of unspecified duration, subsequent encounter",Injury or poisoning,42,51,51,0.214285714,0,0.214285714,956,812,843,-144,31,-113
s061x0a,s,"Traumatic cerebral edema without loss of consciousness, initial encounter",Injury or poisoning,46,40,40,-0.130434783,0,-0.130434783,909,949,973,40,24,64
s061x1a,s,"Traumatic cerebral edema with loss of consciousness of 30 minutes or less, initial encounter",Injury or poisoning,19,16,26,-0.157894737,0.625,0.368421053,1436,1526,1226,90,-300,-210
s061x7a,s,"Traumatic cerebral edema with loss of consciousness of any duration with death due to brain injury prior to regaining consciousness, initial encounter",Injury or poisoning,19,25,32,0.315789474,0.28,0.684210526,1436,1232,1103,-204,-129,-333
s061x9a,s,"Traumatic cerebral edema with loss of consciousness of unspecified duration, initial encounter",Injury or poisoning,94,98,107,0.042553191,0.091836735,0.138297872,607,567,564,-40,-3,-43
s062x0a,s,"Diffuse traumatic brain injury without loss of consciousness, initial encounter",Injury or poisoning,58,53,60,-0.086206897,0.132075472,0.034482759,810,797,764,-13,-33,-46
s062x1a,s,"Diffuse traumatic brain injury with loss of consciousness of 30 minutes or less, initial encounter",Injury or poisoning,14,15,20,0.071428571,0.333333333,0.428571429,1625,1553,1377,-72,-176,-248
s062x7a,s,"Diffuse traumatic brain injury with loss of consciousness of any duration with death due to brain injury prior to regaining consciousness, initial encounter",Injury or poisoning,15,12,15,-0.2,0.25,0,1586,1681,1548,95,-133,-38
s062x9a,s,"Diffuse traumatic brain injury with loss of consciousness of unspecified duration, initial encounter",Injury or poisoning,81,94,141,0.160493827,0.5,0.740740741,665,581,469,-84,-112,-196
s062x9d,s,"Diffuse traumatic brain injury with loss of consciousness of unspecified duration, subsequent encounter",Injury or poisoning,23,21,30,-0.086956522,0.428571429,0.304347826,1317,1353,1141,36,-212,-176
s062x9s,s,"Diffuse traumatic brain injury with loss of consciousness of unspecified duration, sequela",Injury or poisoning,11,13,10,0.181818182,-0.230769231,-0.090909091,1731,1630,1749,-101,119,18
s06300a,s,"Unspecified focal traumatic brain injury without loss of consciousness, initial encounter",Injury or poisoning,11,16,16,0.454545455,0,0.454545455,1731,1521,1509,-210,-12,-222
s06309a,s,"Unspecified focal traumatic brain injury with loss of consciousness of unspecified duration, initial encounter",Injury or poisoning,19,21,19,0.105263158,-0.095238095,0,1432,1353,1412,-79,59,-20
s06340a,s,"Traumatic hemorrhage of right cerebrum without loss of consciousness, initial encounter",Injury or poisoning,14,15,13,0.071428571,-0.133333333,-0.071428571,1621,1549,1628,-72,79,7
s06350a,s,"Traumatic hemorrhage of left cerebrum without loss of consciousness, initial encounter",Injury or poisoning,10,11,14,0.1,0.272727273,0.4,1765,1713,1582,-52,-131,-183
s06359a,s,"Traumatic hemorrhage of left cerebrum with loss of consciousness of unspecified duration, initial encounter",Injury or poisoning,16,13,18,-0.1875,0.384615385,0.125,1541,1627,1445,86,-182,-96
s06360a,s,"Traumatic hemorrhage of cerebrum, unspecified, without loss of consciousness, initial encounter",Injury or poisoning,16,16,19,0,0.1875,0.1875,1541,1520,1412,-21,-108,-129
s06369a,s,"Traumatic hemorrhage of cerebrum, unspecified, with loss of consciousness of unspecified duration, initial encounter",Injury or poisoning,37,31,50,-0.162162162,0.612903226,0.351351351,1019,1082,850,63,-232,-169
s064x0a,s,"Epidural hemorrhage without loss of consciousness, initial encounter",Injury or poisoning,58,47,47,-0.189655172,0,-0.189655172,809,854,883,45,29,74
s064x1a,s,"Epidural hemorrhage with loss of consciousness of 30 minutes or less, initial encounter",Injury or poisoning,17,24,25,0.411764706,0.041666667,0.470588235,1503,1259,1241,-244,-18,-262
s064x9a,s,"Epidural hemorrhage with loss of consciousness of unspecified duration, initial encounter",Injury or poisoning,69,83,70,0.202898551,-0.156626506,0.014492754,724,623,713,-101,90,-11
s065x0a,s,"Traumatic subdural hemorrhage without loss of consciousness, initial encounter",Injury or poisoning,565,582,555,0.030088496,-0.046391753,-0.017699115,226,217,228,-9,11,2
s065x0d,s,"Traumatic subdural hemorrhage without loss of consciousness, subsequent encounter",Injury or poisoning,143,105,134,-0.265734266,0.276190476,-0.062937063,488,548,484,60,-64,-4
s065x0s,s,"Traumatic subdural hemorrhage without loss of consciousness, sequela",Injury or poisoning,22,37,36,0.681818182,-0.027027027,0.636363636,1343,986,1012,-357,26,-331
s065x1a,s,"Traumatic subdural hemorrhage with loss of consciousness of 30 minutes or less, initial encounter",Injury or poisoning,147,144,132,-0.020408163,-0.083333333,-0.102040816,482,470,489,-12,19,7
s065x6a,s,"Traumatic subdural hemorrhage with loss of consciousness greater than 24 hours without return to pre-existing conscious level with patient surviving, initial encounter",Injury or poisoning,10,11,12,0.1,0.090909091,0.2,1755,1703,1656,-52,-47,-99
s065x7a,s,"Traumatic subdural hemorrhage with loss of consciousness of any duration with death due to brain injury before regaining consciousness, initial encounter",Injury or poisoning,46,37,39,-0.195652174,0.054054054,-0.152173913,901,985,975,84,-10,74
s065x9a,s,"Traumatic subdural hemorrhage with loss of consciousness of unspecified duration, initial encounter",Injury or poisoning,859,850,914,-0.010477299,0.075294118,0.064027939,173,164,166,-9,2,-7
s065x9d,s,"Traumatic subdural hemorrhage with loss of consciousness of unspecified duration, subsequent encounter",Injury or poisoning,189,191,199,0.010582011,0.041884817,0.052910053,415,408,395,-7,-13,-20
s065x9s,s,"Traumatic subdural hemorrhage with loss of consciousness of unspecified duration, sequela",Injury or poisoning,39,32,37,-0.179487179,0.15625,-0.051282051,984,1054,995,70,-59,11
s066x0a,s,"Traumatic subarachnoid hemorrhage without loss of consciousness, initial encounter",Injury or poisoning,312,302,307,-0.032051282,0.016556291,-0.016025641,316,313,314,-3,1,-2
s066x0d,s,"Traumatic subarachnoid hemorrhage without loss of consciousness, subsequent encounter",Injury or poisoning,60,61,56,0.016666667,-0.081967213,-0.066666667,775,737,787,-38,50,12
s066x1a,s,"Traumatic subarachnoid hemorrhage with loss of consciousness of 30 minutes or less, initial encounter",Injury or poisoning,139,154,147,0.107913669,-0.045454545,0.057553957,490,454,457,-36,3,-33
s066x7a,s,"Traumatic subarachnoid hemorrhage with loss of consciousness of any duration with death due to brain injury prior to regaining consciousness, initial encounter",Injury or poisoning,45,42,35,-0.066666667,-0.166666667,-0.222222222,913,902,1027,-11,125,114
s066x9a,s,"Traumatic subarachnoid hemorrhage with loss of consciousness of unspecified duration, initial encounter",Injury or poisoning,546,562,590,0.029304029,0.049822064,0.080586081,230,218,217,-12,-1,-13
s066x9d,s,"Traumatic subarachnoid hemorrhage with loss of consciousness of unspecified duration, subsequent encounter",Injury or poisoning,131,108,130,-0.175572519,0.203703704,-0.007633588,505,536,490,31,-46,-15
s066x9s,s,"Traumatic subarachnoid hemorrhage with loss of consciousness of unspecified duration, sequela",Injury or poisoning,13,19,17,0.461538462,-0.105263158,0.307692308,1645,1395,1457,-250,62,-188
s069x0a,s,"Unspecified intracranial injury without loss of consciousness, initial encounter",Injury or poisoning,42,31,40,-0.261904762,0.290322581,-0.047619048,938,1066,957,128,-109,19
s069x0d,s,"Unspecified intracranial injury without loss of consciousness, subsequent encounter",Injury or poisoning,31,39,59,0.258064516,0.512820513,0.903225806,1107,947,759,-160,-188,-348
s069x0s,s,"Unspecified intracranial injury without loss of consciousness, sequela",Injury or poisoning,95,78,45,-0.178947368,-0.423076923,-0.526315789,596,631,894,35,263,298
s069x1a,s,"Unspecified intracranial injury with loss of consciousness of 30 minutes or less, initial encounter",Injury or poisoning,40,40,51,0,0.275,0.275,958,932,828,-26,-104,-130
s069x9a,s,"Unspecified intracranial injury with loss of consciousness of unspecified duration, initial encounter",Injury or poisoning,159,147,149,-0.075471698,0.013605442,-0.062893082,452,460,453,8,-7,1
s069x9d,s,"Unspecified intracranial injury with loss of consciousness of unspecified duration, subsequent encounter",Injury or poisoning,54,54,74,0,0.37037037,0.37037037,822,775,677,-47,-98,-145
s069x9s,s,"Unspecified intracranial injury with loss of consciousness of unspecified duration, sequela",Injury or poisoning,47,30,48,-0.361702128,0.6,0.021276596,882,1084,858,202,-226,-24
s080xxa,s,"Avulsion of scalp, initial encounter",Injury or poisoning,18,18,22,0,0.222222222,0.222222222,1448,1417,1297,-31,-120,-151
s098xxa,s,"Other specified injuries of head, initial encounter",Injury or poisoning,56,43,49,-0.232142857,0.139534884,-0.125,805,884,844,79,-40,39
s0990xa,s,"Unspecified injury of head, initial encounter",Injury or poisoning,876,840,810,-0.04109589,-0.035714286,-0.075342466,169,169,176,0,7,7
s0990xd,s,"Unspecified injury of head, subsequent encounter",Injury or poisoning,56,55,44,-0.017857143,-0.2,-0.214285714,804,768,901,-36,133,97
s0993xa,s,"Unspecified injury of face, initial encounter",Injury or poisoning,32,24,23,-0.25,-0.041666667,-0.28125,1080,1234,1267,154,33,187
s1091xa,s,"Abrasion of unspecified part of neck, initial encounter",Injury or poisoning,31,31,33,0,0.064516129,0.064516129,1098,1058,1051,-40,-7,-47
s1093xa,s,"Contusion of unspecified part of neck, initial encounter",Injury or poisoning,45,45,37,0,-0.177777778,-0.177777778,904,858,980,-46,122,76
s1181xa,s,"Laceration without foreign body of other specified part of neck, initial encounter",Injury or poisoning,33,34,18,0.03030303,-0.470588235,-0.454545455,1056,999,1412,-57,413,356
s1191xa,s,"Laceration without foreign body of unspecified part of neck, initial encounter",Injury or poisoning,56,63,56,0.125,-0.111111111,0,804,716,780,-88,64,-24
s1191xd,s,"Laceration without foreign body of unspecified part of neck, subsequent encounter",Injury or poisoning,23,11,18,-0.52173913,0.636363636,-0.217391304,1286,1676,1411,390,-265,125
s12000a,s,"Unspecified displaced fracture of first cervical vertebra, initial encounter for closed fracture",Injury or poisoning,51,43,47,-0.156862745,0.093023256,-0.078431373,844,880,864,36,-16,20
s12000d,s,"Unspecified displaced fracture of first cervical vertebra, subsequent encounter for fracture with routine healing",Injury or poisoning,14,27,15,0.928571429,-0.444444444,0.071428571,1583,1147,1505,-436,358,-78
s12030a,s,"Displaced posterior arch fracture of first cervical vertebra, initial encounter for closed fracture",Injury or poisoning,12,24,13,1,-0.458333333,0.083333333,1658,1228,1587,-430,359,-71
s12090a,s,"Other displaced fracture of first cervical vertebra, initial encounter for closed fracture",Injury or poisoning,23,22,11,-0.043478261,-0.5,-0.52173913,1285,1286,1668,1,382,383
s12100a,s,"Unspecified displaced fracture of second cervical vertebra, initial encounter for closed fracture",Injury or poisoning,60,67,68,0.116666667,0.014925373,0.133333333,769,689,710,-80,21,-59
s12100d,s,"Unspecified displaced fracture of second cervical vertebra, subsequent encounter for fracture with routine healing",Injury or poisoning,29,40,19,0.379310345,-0.525,-0.344827586,1136,923,1377,-213,454,241
s12101a,s,"Unspecified nondisplaced fracture of second cervical vertebra, initial encounter for closed fracture",Injury or poisoning,42,38,39,-0.095238095,0.026315789,-0.071428571,927,948,955,21,7,28
s12110a,s,"Anterior displaced Type II dens fracture, initial encounter for closed fracture",Injury or poisoning,72,67,56,-0.069444444,-0.164179104,-0.222222222,696,689,779,-7,90,83
s12110d,s,"Anterior displaced Type II dens fracture, subsequent encounter for fracture with routine healing",Injury or poisoning,14,16,10,0.142857143,-0.375,-0.285714286,1578,1477,1698,-101,221,120
s12190a,s,"Other displaced fracture of second cervical vertebra, initial encounter for closed fracture",Injury or poisoning,20,18,21,-0.1,0.166666667,0.05,1363,1401,1309,38,-92,-54
s12200a,s,"Unspecified displaced fracture of third cervical vertebra, initial encounter for closed fracture",Injury or poisoning,24,30,40,0.25,0.333333333,0.666666667,1258,1072,944,-186,-128,-314
s12300a,s,"Unspecified displaced fracture of fourth cervical vertebra, initial encounter for closed fracture",Injury or poisoning,39,42,52,0.076923077,0.238095238,0.333333333,963,889,812,-74,-77,-151
s12300d,s,"Unspecified displaced fracture of fourth cervical vertebra, subsequent encounter for fracture with routine healing",Injury or poisoning,20,14,22,-0.3,0.571428571,0.1,1361,1543,1284,182,-259,-77
s12301a,s,"Unspecified nondisplaced fracture of fourth cervical vertebra, initial encounter for closed fracture",Injury or poisoning,10,10,10,0,0,0,1714,1704,1694,-10,-10,-20
s12400a,s,"Unspecified displaced fracture of fifth cervical vertebra, initial encounter for closed fracture",Injury or poisoning,92,57,90,-0.380434783,0.578947368,-0.02173913,603,751,606,148,-145,3
s12400d,s,"Unspecified displaced fracture of fifth cervical vertebra, subsequent encounter for fracture with routine healing",Injury or poisoning,18,26,27,0.444444444,0.038461538,0.5,1428,1167,1159,-261,-8,-269
s12401a,s,"Unspecified nondisplaced fracture of fifth cervical vertebra, initial encounter for closed fracture",Injury or poisoning,22,10,14,-0.545454545,0.4,-0.363636364,1307,1702,1532,395,-170,225
s12500a,s,"Unspecified displaced fracture of sixth cervical vertebra, initial encounter for closed fracture",Injury or poisoning,113,111,140,-0.017699115,0.261261261,0.238938053,546,525,461,-21,-64,-85
s12500d,s,"Unspecified displaced fracture of sixth cervical vertebra, subsequent encounter for fracture with routine healing",Injury or poisoning,32,31,36,-0.03125,0.161290323,0.125,1070,1047,982,-23,-65,-88
s12501a,s,"Unspecified nondisplaced fracture of sixth cervical vertebra, initial encounter for closed fracture",Injury or poisoning,24,16,20,-0.333333333,0.25,-0.166666667,1254,1470,1330,216,-140,76
s12590a,s,"Other displaced fracture of sixth cervical vertebra, initial encounter for closed fracture",Injury or poisoning,43,20,28,-0.534883721,0.4,-0.348837209,915,1338,1135,423,-203,220
s12590d,s,"Other displaced fracture of sixth cervical vertebra, subsequent encounter for fracture with routine healing",Injury or poisoning,16,10,11,-0.375,0.1,-0.3125,1489,1698,1653,209,-45,164
s12600a,s,"Unspecified displaced fracture of seventh cervical vertebra, initial encounter for closed fracture",Injury or poisoning,119,124,155,0.042016807,0.25,0.302521008,533,497,442,-36,-55,-91
s12600d,s,"Unspecified displaced fracture of seventh cervical vertebra, subsequent encounter for fracture with routine healing",Injury or poisoning,38,44,40,0.157894737,-0.090909091,0.052631579,971,866,940,-105,74,-31
s12601a,s,"Unspecified nondisplaced fracture of seventh cervical vertebra, initial encounter for closed fracture",Injury or poisoning,34,25,23,-0.264705882,-0.08,-0.323529412,1024,1184,1251,160,67,227
s12690a,s,"Other displaced fracture of seventh cervical vertebra, initial encounter for closed fracture",Injury or poisoning,36,23,33,-0.361111111,0.434782609,-0.083333333,995,1242,1038,247,-204,43
s12690d,s,"Other displaced fracture of seventh cervical vertebra, subsequent encounter for fracture with routine healing",Injury or poisoning,11,13,19,0.181818182,0.461538462,0.727272727,1666,1568,1361,-98,-207,-305
s12691a,s,"Other nondisplaced fracture of seventh cervical vertebra, initial encounter for closed fracture",Injury or poisoning,12,10,15,-0.166666667,0.5,0.25,1636,1693,1486,57,-207,-150
s129xxa,s,"Fracture of neck, unspecified, initial encounter",Injury or poisoning,18,15,18,-0.166666667,0.2,0,1419,1491,1391,72,-100,-28
s134xxa,s,"Sprain of ligaments of cervical spine, initial encounter",Injury or poisoning,57,38,56,-0.333333333,0.473684211,-0.01754386,794,942,776,148,-166,-18
s134xxd,s,"Sprain of ligaments of cervical spine, subsequent encounter",Injury or poisoning,13,14,25,0.076923077,0.785714286,0.923076923,1602,1531,1198,-71,-333,-404
s140xxa,s,"Concussion and edema of cervical spinal cord, initial encounter",Injury or poisoning,12,10,10,-0.166666667,0,-0.166666667,1633,1690,1677,57,-13,44
s14105s,s,"Unspecified injury at C5 level of cervical spinal cord, sequela",Injury or poisoning,20,17,12,-0.15,-0.294117647,-0.4,1350,1430,1601,80,171,251
s14106s,s,"Unspecified injury at C6 level of cervical spinal cord, sequela",Injury or poisoning,17,12,12,-0.294117647,0,-0.294117647,1447,1610,1601,163,-9,154
s14109s,s,"Unspecified injury at unspecified level of cervical spinal cord, sequela",Injury or poisoning,33,29,28,-0.121212121,-0.034482759,-0.151515152,1042,1082,1131,40,49,89
s14129a,s,"Central cord syndrome at unspecified level of cervical spinal cord, initial encounter",Injury or poisoning,18,21,14,0.166666667,-0.333333333,-0.222222222,1416,1300,1518,-116,218,102
s143xxa,s,"Injury of brachial plexus, initial encounter",Injury or poisoning,16,23,16,0.4375,-0.304347826,0,1479,1240,1446,-239,206,-33
s161xxa,s,"Strain of muscle, fascia and tendon at neck level, initial encounter",Injury or poisoning,99,84,108,-0.151515152,0.285714286,0.090909091,575,604,548,29,-56,-27
s199xxa,s,"Unspecified injury of neck, initial encounter",Injury or poisoning,22,13,14,-0.409090909,0.076923077,-0.363636364,1296,1560,1516,264,-44,220
s2020xa,s,"Contusion of thorax, unspecified, initial encounter",Injury or poisoning,42,46,35,0.095238095,-0.239130435,-0.166666667,920,845,1000,-75,155,80
s20211a,s,"Contusion of right front wall of thorax, initial encounter",Injury or poisoning,81,77,67,-0.049382716,-0.12987013,-0.172839506,649,631,710,-18,79,61
s20212a,s,"Contusion of left front wall of thorax, initial encounter",Injury or poisoning,101,85,78,-0.158415842,-0.082352941,-0.227722772,571,597,654,26,57,83
s20219a,s,"Contusion of unspecified front wall of thorax, initial encounter",Injury or poisoning,109,111,79,0.018348624,-0.288288288,-0.275229358,552,524,648,-28,124,96
s20219d,s,"Contusion of unspecified front wall of thorax, subsequent encounter",Injury or poisoning,16,13,15,-0.1875,0.153846154,-0.0625,1473,1556,1476,83,-80,3
s20229a,s,"Contusion of unspecified back wall of thorax, initial encounter",Injury or poisoning,42,27,28,-0.357142857,0.037037037,-0.333333333,917,1129,1126,212,-3,209
s20311a,s,"Abrasion of right front wall of thorax, initial encounter",Injury or poisoning,26,27,28,0.038461538,0.037037037,0.076923077,1182,1129,1126,-53,-3,-56
s20312a,s,"Abrasion of left front wall of thorax, initial encounter",Injury or poisoning,31,34,36,0.096774194,0.058823529,0.161290323,1074,982,975,-92,-7,-99
s20319a,s,"Abrasion of unspecified front wall of thorax, initial encounter",Injury or poisoning,50,42,53,-0.16,0.261904762,0.06,841,880,793,39,-87,-48
s20419a,s,"Abrasion of unspecified back wall of thorax, initial encounter",Injury or poisoning,23,10,16,-0.565217391,0.6,-0.304347826,1259,1674,1437,415,-237,178
s21111a,s,"Laceration without foreign body of right front wall of thorax without penetration into thoracic cavity, initial encounter",Injury or poisoning,26,11,20,-0.576923077,0.818181818,-0.230769231,1180,1633,1313,453,-320,133
s21112a,s,"Laceration without foreign body of left front wall of thorax without penetration into thoracic cavity, initial encounter",Injury or poisoning,29,27,31,-0.068965517,0.148148148,0.068965517,1115,1127,1074,12,-53,-41
s21119a,s,"Laceration without foreign body of unspecified front wall of thorax without penetration into thoracic cavity, initial encounter",Injury or poisoning,16,11,12,-0.3125,0.090909091,-0.25,1466,1632,1584,166,-48,118
s21312a,s,"Laceration without foreign body of left front wall of thorax with penetration into thoracic cavity, initial encounter",Injury or poisoning,14,14,11,0,-0.214285714,-0.214285714,1540,1517,1624,-23,107,84
s22009a,s,"Unspecified fracture of unspecified thoracic vertebra, initial encounter for closed fracture",Injury or poisoning,34,25,25,-0.264705882,0,-0.264705882,1015,1172,1187,157,15,172
s22018a,s,"Other fracture of first thoracic vertebra, initial encounter for closed fracture",Injury or poisoning,23,21,25,-0.086956522,0.19047619,0.086956522,1256,1288,1187,32,-101,-69
s22019a,s,"Unspecified fracture of first thoracic vertebra, initial encounter for closed fracture",Injury or poisoning,79,77,100,-0.025316456,0.298701299,0.265822785,657,629,567,-28,-62,-90
s22019d,s,"Unspecified fracture of first thoracic vertebra, subsequent encounter for fracture with routine healing",Injury or poisoning,17,30,20,0.764705882,-0.333333333,0.176470588,1429,1057,1309,-372,252,-120
s22020a,s,"Wedge compression fracture of second thoracic vertebra, initial encounter for closed fracture",Injury or poisoning,20,11,11,-0.45,0,-0.45,1333,1627,1620,294,-7,287
s22028a,s,"Other fracture of second thoracic vertebra, initial encounter for closed fracture",Injury or poisoning,22,17,29,-0.227272727,0.705882353,0.318181818,1282,1413,1097,131,-316,-185
s22029a,s,"Unspecified fracture of second thoracic vertebra, initial encounter for closed fracture",Injury or poisoning,62,53,80,-0.14516129,0.509433962,0.290322581,748,769,637,21,-132,-111
s22029d,s,"Unspecified fracture of second thoracic vertebra, subsequent encounter for fracture with routine healing",Injury or poisoning,14,22,16,0.571428571,-0.272727273,0.142857143,1533,1255,1429,-278,174,-104
s22030a,s,"Wedge compression fracture of third thoracic vertebra, initial encounter for closed fracture",Injury or poisoning,26,15,16,-0.423076923,0.066666667,-0.384615385,1176,1469,1429,293,-40,253
s22038a,s,"Other fracture of third thoracic vertebra, initial encounter for closed fracture",Injury or poisoning,24,18,29,-0.25,0.611111111,0.208333333,1232,1370,1096,138,-274,-136
s22039a,s,"Unspecified fracture of third thoracic vertebra, initial encounter for closed fracture",Injury or poisoning,59,57,65,-0.033898305,0.140350877,0.101694915,771,744,714,-27,-30,-57
s22039d,s,"Unspecified fracture of third thoracic vertebra, subsequent encounter for fracture with routine healing",Injury or poisoning,18,19,16,0.055555556,-0.157894737,-0.111111111,1394,1340,1427,-54,87,33
s22040a,s,"Wedge compression fracture of fourth thoracic vertebra, initial encounter for closed fracture",Injury or poisoning,20,15,10,-0.25,-0.333333333,-0.5,1328,1466,1644,138,178,316
s22048a,s,"Other fracture of fourth thoracic vertebra, initial encounter for closed fracture",Injury or poisoning,17,14,29,-0.176470588,1.071428571,0.705882353,1421,1505,1095,84,-410,-326
s22049a,s,"Unspecified fracture of fourth thoracic vertebra, initial encounter for closed fracture",Injury or poisoning,52,63,72,0.211538462,0.142857143,0.384615385,820,707,678,-113,-29,-142
s22049d,s,"Unspecified fracture of fourth thoracic vertebra, subsequent encounter for fracture with routine healing",Injury or poisoning,19,24,16,0.263157895,-0.333333333,-0.157894737,1352,1197,1425,-155,228,73
s22050a,s,"Wedge compression fracture of T5-T6 vertebra, initial encounter for closed fracture",Injury or poisoning,22,32,26,0.454545455,-0.1875,0.181818182,1277,1015,1158,-262,143,-119
s22051a,s,"Stable burst fracture of T5-T6 vertebra, initial encounter for closed fracture",Injury or poisoning,21,11,11,-0.476190476,0,-0.476190476,1299,1615,1609,316,-6,310
s22058a,s,"Other fracture of T5-T6 vertebra, initial encounter for closed fracture",Injury or poisoning,34,26,40,-0.235294118,0.538461538,0.176470588,1011,1145,930,134,-215,-81
s22059a,s,"Unspecified fracture of T5-T6 vertebra, initial encounter for closed fracture",Injury or poisoning,76,95,115,0.25,0.210526316,0.513157895,666,561,530,-105,-31,-136
s22059d,s,"Unspecified fracture of T5-T6 vertebra, subsequent encounter for fracture with routine healing",Injury or poisoning,23,26,24,0.130434783,-0.076923077,0.043478261,1248,1144,1208,-104,64,-40
s22060a,s,"Wedge compression fracture of T7-T8 vertebra, initial encounter for closed fracture",Injury or poisoning,26,34,41,0.307692308,0.205882353,0.576923077,1172,976,919,-196,-57,-253
s22060d,s,"Wedge compression fracture of T7-T8 vertebra, subsequent encounter for fracture with routine healing",Injury or poisoning,11,10,10,-0.090909091,0,-0.090909091,1618,1648,1635,30,-13,17
s22061a,s,"Stable burst fracture of T7-T8 vertebra, initial encounter for closed fracture",Injury or poisoning,21,10,20,-0.523809524,1,-0.047619048,1295,1648,1298,353,-350,3
s22068a,s,"Other fracture of T7-T8 thoracic vertebra, initial encounter for closed fracture",Injury or poisoning,32,32,42,0,0.3125,0.3125,1049,1013,906,-36,-107,-143
s22069a,s,"Unspecified fracture of T7-T8 vertebra, initial encounter for closed fracture",Injury or poisoning,89,97,133,0.08988764,0.371134021,0.494382022,608,557,477,-51,-80,-131
s22069d,s,"Unspecified fracture of T7-T8 vertebra, subsequent encounter for fracture with routine healing",Injury or poisoning,29,34,34,0.172413793,0,0.172413793,1106,975,1001,-131,26,-105
s22070a,s,"Wedge compression fracture of T9-T10 vertebra, initial encounter for closed fracture",Injury or poisoning,19,27,25,0.421052632,-0.074074074,0.315789474,1342,1116,1173,-226,57,-169
s22078a,s,"Other fracture of T9-T10 vertebra, initial encounter for closed fracture",Injury or poisoning,38,39,49,0.026315789,0.256410256,0.289473684,957,917,824,-40,-93,-133
s22079a,s,"Unspecified fracture of T9-T10 vertebra, initial encounter for closed fracture",Injury or poisoning,109,86,107,-0.211009174,0.244186047,-0.018348624,552,590,547,38,-43,-5
s22079d,s,"Unspecified fracture of T9-T10 vertebra, subsequent encounter for fracture with routine healing",Injury or poisoning,29,21,25,-0.275862069,0.19047619,-0.137931034,1104,1270,1171,166,-99,67
s22080a,s,"Wedge compression fracture of T11-T12 vertebra, initial encounter for closed fracture",Injury or poisoning,91,56,57,-0.384615385,0.017857143,-0.373626374,600,744,756,144,12,156
s22080d,s,"Wedge compression fracture of T11-T12 vertebra, subsequent encounter for fracture with routine healing",Injury or poisoning,44,31,20,-0.295454545,-0.35483871,-0.545454545,888,1024,1290,136,266,402
s22081a,s,"Stable burst fracture of T11-T12 vertebra, initial encounter for closed fracture",Injury or poisoning,43,42,45,-0.023255814,0.071428571,0.046511628,899,872,865,-27,-7,-34
s22088a,s,"Other fracture of T11-T12 vertebra, initial encounter for closed fracture",Injury or poisoning,63,51,56,-0.19047619,0.098039216,-0.111111111,736,775,764,39,-11,28
s22088d,s,"Other fracture of T11-T12 vertebra, subsequent encounter for fracture with routine healing",Injury or poisoning,20,15,20,-0.25,0.333333333,0,1310,1448,1288,138,-160,-22
s22089a,s,"Unspecified fracture of T11-T12 vertebra, initial encounter for closed fracture",Injury or poisoning,195,217,208,0.112820513,-0.041474654,0.066666667,405,379,386,-26,7,-19
s22089d,s,"Unspecified fracture of T11-T12 vertebra, subsequent encounter for fracture with routine healing",Injury or poisoning,42,67,37,0.595238095,-0.447761194,-0.119047619,904,678,948,-226,270,44
s2220xa,s,"Unspecified fracture of sternum, initial encounter for closed fracture",Injury or poisoning,167,145,176,-0.131736527,0.213793103,0.053892216,434,459,410,25,-49,-24
s2220xd,s,"Unspecified fracture of sternum, subsequent encounter for fracture with routine healing",Injury or poisoning,46,45,51,-0.02173913,0.133333333,0.108695652,863,835,801,-28,-34,-62
s2221xa,s,"Fracture of manubrium, initial encounter for closed fracture",Injury or poisoning,65,57,62,-0.123076923,0.087719298,-0.046153846,716,737,725,21,-12,9
s2222xa,s,"Fracture of body of sternum, initial encounter for closed fracture",Injury or poisoning,90,72,67,-0.2,-0.069444444,-0.255555556,602,652,700,50,48,98
s2231xa,s,"Fracture of one rib, right side, initial encounter for closed fracture",Injury or poisoning,260,291,294,0.119230769,0.010309278,0.130769231,350,321,323,-29,2,-27
s2231xd,s,"Fracture of one rib, right side, subsequent encounter for fracture with routine healing",Injury or poisoning,56,49,54,-0.125,0.102040816,-0.035714286,781,789,770,8,-19,-11
s2232xa,s,"Fracture of one rib, left side, initial encounter for closed fracture",Injury or poisoning,271,308,280,0.136531365,-0.090909091,0.033210332,346,305,328,-41,23,-18
s2232xd,s,"Fracture of one rib, left side, subsequent encounter for fracture with routine healing",Injury or poisoning,43,61,55,0.418604651,-0.098360656,0.279069767,890,711,761,-179,50,-129
s2239xa,s,"Fracture of one rib, unspecified side, initial encounter for closed fracture",Injury or poisoning,58,47,49,-0.189655172,0.042553191,-0.155172414,772,810,812,38,2,40
s2239xd,s,"Fracture of one rib, unspecified side, subsequent encounter for fracture with routine healing",Injury or poisoning,10,18,14,0.8,-0.222222222,0.4,1628,1339,1461,-289,122,-167
s2241xa,s,"Multiple fractures of ribs, right side, initial encounter for closed fracture",Injury or poisoning,759,709,754,-0.065876153,0.063469676,-0.006587615,191,197,189,6,-8,-2
s2241xd,s,"Multiple fractures of ribs, right side, subsequent encounter for fracture with routine healing",Injury or poisoning,150,133,153,-0.113333333,0.15037594,0.02,466,478,438,12,-40,-28
s2242xa,s,"Multiple fractures of ribs, left side, initial encounter for closed fracture",Injury or poisoning,749,739,827,-0.013351135,0.119079838,0.104138852,191,188,172,-3,-16,-19
s2242xd,s,"Multiple fractures of ribs, left side, subsequent encounter for fracture with routine healing",Injury or poisoning,178,173,162,-0.028089888,-0.063583815,-0.08988764,419,412,426,-7,14,7
s2243xa,s,"Multiple fractures of ribs, bilateral, initial encounter for closed fracture",Injury or poisoning,382,366,366,-0.041884817,0,-0.041884817,273,273,278,0,5,5
s2243xd,s,"Multiple fractures of ribs, bilateral, subsequent encounter for fracture with routine healing",Injury or poisoning,76,81,80,0.065789474,-0.012345679,0.052631579,653,601,625,-52,24,-28
s2249xa,s,"Multiple fractures of ribs, unspecified side, initial encounter for closed fracture",Injury or poisoning,48,40,60,-0.166666667,0.5,0.25,835,884,723,49,-161,-112
s2249xd,s,"Multiple fractures of ribs, unspecified side, subsequent encounter for fracture with routine healing",Injury or poisoning,34,34,40,0,0.176470588,0.176470588,985,952,904,-33,-48,-81
s225xxa,s,"Flail chest, initial encounter for closed fracture",Injury or poisoning,83,105,110,0.265060241,0.047619048,0.325301205,623,527,533,-96,6,-90
s225xxd,s,"Flail chest, subsequent encounter for fracture with routine healing",Injury or poisoning,13,11,21,-0.153846154,0.909090909,0.615384615,1526,1578,1240,52,-338,-286
s24102s,s,"Unspecified injury at T2-T6 level of thoracic spinal cord, sequela",Injury or poisoning,28,29,31,0.035714286,0.068965517,0.107142857,1099,1038,1039,-61,1,-60
s24103s,s,"Unspecified injury at T7-T10 level of thoracic spinal cord, sequela",Injury or poisoning,29,27,20,-0.068965517,-0.259259259,-0.310344828,1080,1089,1266,9,177,186
s24104s,s,"Unspecified injury at T11-T12 level of thoracic spinal cord, sequela",Injury or poisoning,20,15,17,-0.25,0.133333333,-0.15,1288,1425,1354,137,-71,66
s2691xa,s,"Contusion of heart, unspecified with or without hemopericardium, initial encounter",Injury or poisoning,26,21,24,-0.192307692,0.142857143,-0.076923077,1140,1244,1176,104,-68,36
s270xxa,s,"Traumatic pneumothorax, initial encounter",Injury or poisoning,548,539,611,-0.016423358,0.133580705,0.114963504,226,218,209,-8,-9,-17
s270xxd,s,"Traumatic pneumothorax, subsequent encounter",Injury or poisoning,67,50,67,-0.253731343,0.34,0,693,766,690,73,-76,-3
s271xxa,s,"Traumatic hemothorax, initial encounter",Injury or poisoning,184,167,170,-0.092391304,0.017964072,-0.076086957,408,416,413,8,-3,5
s271xxd,s,"Traumatic hemothorax, subsequent encounter",Injury or poisoning,18,18,20,0,0.111111111,0.111111111,1345,1324,1262,-21,-62,-83
s272xxa,s,"Traumatic hemopneumothorax, initial encounter",Injury or poisoning,237,318,331,0.341772152,0.040880503,0.396624473,363,291,293,-72,2,-70
s272xxd,s,"Traumatic hemopneumothorax, subsequent encounter",Injury or poisoning,19,30,16,0.578947368,-0.466666667,-0.157894737,1306,1018,1377,-288,359,71
s27321a,s,"Contusion of lung, unilateral, initial encounter",Injury or poisoning,312,305,361,-0.022435897,0.183606557,0.157051282,310,303,282,-7,-21,-28
s27321d,s,"Contusion of lung, unilateral, subsequent encounter",Injury or poisoning,28,16,29,-0.428571429,0.8125,0.035714286,1093,1391,1057,298,-334,-36
s27322a,s,"Contusion of lung, bilateral, initial encounter",Injury or poisoning,167,134,137,-0.19760479,0.02238806,-0.179640719,424,465,457,41,-8,33
s27322d,s,"Contusion of lung, bilateral, subsequent encounter",Injury or poisoning,24,14,13,-0.416666667,-0.071428571,-0.458333333,1187,1452,1479,265,27,292
s27329a,s,"Contusion of lung, unspecified, initial encounter",Injury or poisoning,127,134,126,0.05511811,-0.059701493,-0.007874016,496,465,480,-31,15,-16
s27329d,s,"Contusion of lung, unspecified, subsequent encounter",Injury or poisoning,23,34,17,0.47826087,-0.5,-0.260869565,1205,944,1344,-261,400,139
s27331a,s,"Laceration of lung, unilateral, initial encounter",Injury or poisoning,41,36,44,-0.12195122,0.222222222,0.073170732,886,921,851,35,-70,-35
s27803a,s,"Laceration of diaphragm, initial encounter",Injury or poisoning,11,23,20,1.090909091,-0.130434783,0.818181818,1567,1176,1256,-391,80,-311
s27892a,s,"Contusion of other specified intrathoracic organs, initial encounter",Injury or poisoning,15,25,14,0.666666667,-0.44,-0.066666667,1431,1120,1434,-311,314,3
s299xxa,s,"Unspecified injury of thorax, initial encounter",Injury or poisoning,14,12,18,-0.142857143,0.5,0.285714286,1468,1522,1314,54,-208,-154
s300xxa,s,"Contusion of lower back and pelvis, initial encounter",Injury or poisoning,214,203,240,-0.051401869,0.18226601,0.121495327,384,381,356,-3,-25,-28
s300xxd,s,"Contusion of lower back and pelvis, subsequent encounter",Injury or poisoning,30,44,45,0.466666667,0.022727273,0.5,1047,826,838,-221,12,-209
s301xxa,s,"Contusion of abdominal wall, initial encounter",Injury or poisoning,383,314,352,-0.180156658,0.121019108,-0.080939948,270,295,283,25,-12,13
s301xxd,s,"Contusion of abdominal wall, subsequent encounter",Injury or poisoning,26,19,25,-0.269230769,0.315789474,-0.038461538,1128,1284,1135,156,-149,7
s3022xa,s,"Contusion of scrotum and testes, initial encounter",Injury or poisoning,20,20,22,0,0.1,0.1,1272,1257,1203,-15,-54,-69
s30810a,s,"Abrasion of lower back and pelvis, initial encounter",Injury or poisoning,84,77,80,-0.083333333,0.038961039,-0.047619048,609,607,616,-2,9,7
s30811a,s,"Abrasion of abdominal wall, initial encounter",Injury or poisoning,86,81,121,-0.058139535,0.49382716,0.406976744,601,592,492,-9,-100,-109
s31010a,s,"Laceration without foreign body of lower back and pelvis without penetration into retroperitoneum, initial encounter",Injury or poisoning,11,13,12,0.181818182,-0.076923077,0.090909091,1558,1471,1503,-87,32,-55
s31109a,s,"Unspecified open wound of abdominal wall, unspecified quadrant without penetration into peritoneal cavity, initial encounter",Injury or poisoning,60,49,48,-0.183333333,-0.020408163,-0.2,730,769,804,39,35,74
s31109d,s,"Unspecified open wound of abdominal wall, unspecified quadrant without penetration into peritoneal cavity, subsequent encounter",Injury or poisoning,16,13,10,-0.1875,-0.230769231,-0.375,1387,1470,1571,83,101,184
s31119a,s,"Laceration without foreign body of abdominal wall, unspecified quadrant without penetration into peritoneal cavity, initial encounter",Injury or poisoning,64,49,45,-0.234375,-0.081632653,-0.296875,705,769,834,64,65,129
s31139a,s,"Puncture wound of abdominal wall without foreign body, unspecified quadrant without penetration into peritoneal cavity, initial encounter",Injury or poisoning,12,13,33,0.083333333,1.538461538,1.75,1527,1469,980,-58,-489,-547
s32009a,s,"Unspecified fracture of unspecified lumbar vertebra, initial encounter for closed fracture",Injury or poisoning,28,32,35,0.142857143,0.09375,0.25,1083,970,946,-113,-24,-137
s32009d,s,"Unspecified fracture of unspecified lumbar vertebra, subsequent encounter for fracture with routine healing",Injury or poisoning,11,20,14,0.818181818,-0.3,0.272727273,1553,1252,1422,-301,170,-131
s32010a,s,"Wedge compression fracture of first lumbar vertebra, initial encounter for closed fracture",Injury or poisoning,85,66,89,-0.223529412,0.348484848,0.047058824,606,663,584,57,-79,-22
s32010d,s,"Wedge compression fracture of first lumbar vertebra, subsequent encounter for fracture with routine healing",Injury or poisoning,31,39,33,0.258064516,-0.153846154,0.064516129,1023,879,978,-144,99,-45
s32011a,s,"Stable burst fracture of first lumbar vertebra, initial encounter for closed fracture",Injury or poisoning,46,50,54,0.086956522,0.08,0.173913043,835,756,748,-79,-8,-87
s32011d,s,"Stable burst fracture of first lumbar vertebra, subsequent encounter for fracture with routine healing",Injury or poisoning,15,12,12,-0.2,0,-0.2,1417,1505,1495,88,-10,78
s32018a,s,"Other fracture of first lumbar vertebra, initial encounter for closed fracture",Injury or poisoning,71,84,95,0.183098592,0.130952381,0.338028169,664,581,563,-83,-18,-101
s32018d,s,"Other fracture of first lumbar vertebra, subsequent encounter for fracture with routine healing",Injury or poisoning,25,34,34,0.36,0,0.36,1145,932,957,-213,25,-188
s32019a,s,"Unspecified fracture of first lumbar vertebra, initial encounter for closed fracture",Injury or poisoning,253,261,278,0.031620553,0.0651341,0.098814229,347,330,323,-17,-7,-24
s32019d,s,"Unspecified fracture of first lumbar vertebra, subsequent encounter for fracture with routine healing",Injury or poisoning,63,78,62,0.238095238,-0.205128205,-0.015873016,708,599,701,-109,102,-7
s32020a,s,"Wedge compression fracture of second lumbar vertebra, initial encounter for closed fracture",Injury or poisoning,46,41,29,-0.108695652,-0.292682927,-0.369565217,832,850,1038,18,188,206
s32020d,s,"Wedge compression fracture of second lumbar vertebra, subsequent encounter for fracture with routine healing",Injury or poisoning,13,14,17,0.076923077,0.214285714,0.307692308,1487,1428,1322,-59,-106,-165
s32021a,s,"Stable burst fracture of second lumbar vertebra, initial encounter for closed fracture",Injury or poisoning,29,23,14,-0.206896552,-0.391304348,-0.517241379,1058,1159,1413,101,254,355
s32028a,s,"Other fracture of second lumbar vertebra, initial encounter for closed fracture",Injury or poisoning,70,62,80,-0.114285714,0.290322581,0.142857143,668,685,612,17,-73,-56
s32028d,s,"Other fracture of second lumbar vertebra, subsequent encounter for fracture with routine healing",Injury or poisoning,15,22,30,0.466666667,0.363636364,1,1410,1185,1029,-225,-156,-381
s32029a,s,"Unspecified fracture of second lumbar vertebra, initial encounter for closed fracture",Injury or poisoning,218,246,240,0.128440367,-0.024390244,0.100917431,377,341,354,-36,13,-23
s32029d,s,"Unspecified fracture of second lumbar vertebra, subsequent encounter for fracture with routine healing",Injury or poisoning,66,61,47,-0.075757576,-0.229508197,-0.287878788,684,688,805,4,117,121
s32030a,s,"Wedge compression fracture of third lumbar vertebra, initial encounter for closed fracture",Injury or poisoning,33,23,26,-0.303030303,0.130434783,-0.212121212,978,1156,1096,178,-60,118
s32031a,s,"Stable burst fracture of third lumbar vertebra, initial encounter for closed fracture",Injury or poisoning,16,17,17,0.0625,0,0.0625,1372,1328,1317,-44,-11,-55
s32038a,s,"Other fracture of third lumbar vertebra, initial encounter for closed fracture",Injury or poisoning,57,52,76,-0.087719298,0.461538462,0.333333333,748,736,631,-12,-105,-117
s32039a,s,"Unspecified fracture of third lumbar vertebra, initial encounter for closed fracture",Injury or poisoning,181,200,211,0.104972376,0.055,0.165745856,404,378,371,-26,-7,-33
s32039d,s,"Unspecified fracture of third lumbar vertebra, subsequent encounter for fracture with routine healing",Injury or poisoning,49,50,38,0.020408163,-0.24,-0.224489796,801,748,897,-53,149,96
s32040a,s,"Wedge compression fracture of fourth lumbar vertebra, initial encounter for closed fracture",Injury or poisoning,18,16,16,-0.111111111,0,-0.111111111,1310,1356,1340,46,-16,30
s32041a,s,"Stable burst fracture of fourth lumbar vertebra, initial encounter for closed fracture",Injury or poisoning,14,17,14,0.214285714,-0.176470588,0,1437,1325,1403,-112,78,-34
s32048a,s,"Other fracture of fourth lumbar vertebra, initial encounter for closed fracture",Injury or poisoning,51,54,73,0.058823529,0.351851852,0.431372549,788,723,642,-65,-81,-146
s32049a,s,"Unspecified fracture of fourth lumbar vertebra, initial encounter for closed fracture",Injury or poisoning,149,169,166,0.134228188,-0.017751479,0.11409396,453,406,412,-47,6,-41
s32049d,s,"Unspecified fracture of fourth lumbar vertebra, subsequent encounter for fracture with routine healing",Injury or poisoning,40,47,40,0.175,-0.14893617,0,876,777,876,-99,99,0
s32058a,s,"Other fracture of fifth lumbar vertebra, initial encounter for closed fracture",Injury or poisoning,41,35,52,-0.146341463,0.485714286,0.268292683,866,908,756,42,-152,-110
s32059a,s,"Unspecified fracture of fifth lumbar vertebra, initial encounter for closed fracture",Injury or poisoning,132,109,112,-0.174242424,0.027522936,-0.151515152,479,507,515,28,8,36
s32059d,s,"Unspecified fracture of fifth lumbar vertebra, subsequent encounter for fracture with routine healing",Injury or poisoning,34,29,32,-0.147058824,0.103448276,-0.058823529,953,1001,980,48,-21,27
s3210xa,s,"Unspecified fracture of sacrum, initial encounter for closed fracture",Injury or poisoning,267,244,254,-0.086142322,0.040983607,-0.048689139,341,345,346,4,1,5
s3210xd,s,"Unspecified fracture of sacrum, subsequent encounter for fracture with routine healing",Injury or poisoning,84,62,86,-0.261904762,0.387096774,0.023809524,601,680,583,79,-97,-18
s32110a,s,"Nondisplaced Zone I fracture of sacrum, initial encounter for closed fracture",Injury or poisoning,29,29,26,0,-0.103448276,-0.103448276,1043,999,1085,-44,86,42
s32111a,s,"Minimally displaced Zone I fracture of sacrum, initial encounter for closed fracture",Injury or poisoning,20,19,32,-0.05,0.684210526,0.6,1242,1251,978,9,-273,-264
s32119a,s,"Unspecified Zone I fracture of sacrum, initial encounter for closed fracture",Injury or poisoning,87,73,74,-0.16091954,0.01369863,-0.149425287,591,621,633,30,12,42
s32119d,s,"Unspecified Zone I fracture of sacrum, subsequent encounter for fracture with routine healing",Injury or poisoning,16,14,16,-0.125,0.142857143,0,1357,1405,1329,48,-76,-28
s32121a,s,"Minimally displaced Zone II fracture of sacrum, initial encounter for closed fracture",Injury or poisoning,16,12,12,-0.25,0,-0.25,1357,1475,1465,118,-10,108
s32129a,s,"Unspecified Zone II fracture of sacrum, initial encounter for closed fracture",Injury or poisoning,21,28,27,0.333333333,-0.035714286,0.285714286,1216,1020,1059,-196,39,-157
s3219xa,s,"Other fracture of sacrum, initial encounter for closed fracture",Injury or poisoning,61,42,69,-0.31147541,0.642857143,0.131147541,711,821,659,110,-162,-52
s3219xd,s,"Other fracture of sacrum, subsequent encounter for fracture with routine healing",Injury or poisoning,47,36,42,-0.234042553,0.166666667,-0.106382979,811,893,849,82,-44,38
s322xxa,s,"Fracture of coccyx, initial encounter for closed fracture",Injury or poisoning,29,29,33,0,0.137931034,0.137931034,1040,996,957,-44,-39,-83
s32301a,s,"Unspecified fracture of right ilium, initial encounter for closed fracture",Injury or poisoning,32,39,43,0.21875,0.102564103,0.34375,984,860,838,-124,-22,-146
s32302a,s,"Unspecified fracture of left ilium, initial encounter for closed fracture",Injury or poisoning,41,42,27,0.024390244,-0.357142857,-0.341463415,860,821,1055,-39,234,195
s32391a,s,"Other fracture of right ilium, initial encounter for closed fracture",Injury or poisoning,13,13,13,0,0,0,1456,1428,1422,-28,-6,-34
s32392a,s,"Other fracture of left ilium, initial encounter for closed fracture",Injury or poisoning,17,17,12,0,-0.294117647,-0.294117647,1319,1308,1458,-11,150,139
s32401a,s,"Unspecified fracture of right acetabulum, initial encounter for closed fracture",Injury or poisoning,63,70,61,0.111111111,-0.128571429,-0.031746032,699,629,692,-70,63,-7
s32401d,s,"Unspecified fracture of right acetabulum, subsequent encounter for fracture with routine healing",Injury or poisoning,31,35,28,0.129032258,-0.2,-0.096774194,997,899,1036,-98,137,39
s32402a,s,"Unspecified fracture of left acetabulum, initial encounter for closed fracture",Injury or poisoning,85,88,71,0.035294118,-0.193181818,-0.164705882,599,558,651,-41,93,52
s32402d,s,"Unspecified fracture of left acetabulum, subsequent encounter for fracture with routine healing",Injury or poisoning,43,34,36,-0.209302326,0.058823529,-0.162790698,846,908,901,62,-7,55
s32421a,s,"Displaced fracture of posterior wall of right acetabulum, initial encounter for closed fracture",Injury or poisoning,18,20,34,0.111111111,0.7,0.888888889,1289,1215,935,-74,-280,-354
s32422a,s,"Displaced fracture of posterior wall of left acetabulum, initial encounter for closed fracture",Injury or poisoning,22,26,20,0.181818182,-0.230769231,-0.090909091,1185,1059,1207,-126,148,22
s32431a,s,"Displaced fracture of anterior column [iliopubic] of right acetabulum, initial encounter for closed fracture",Injury or poisoning,33,29,34,-0.121212121,0.172413793,0.03030303,960,990,935,30,-55,-25
s32432a,s,"Displaced fracture of anterior column [iliopubic] of left acetabulum, initial encounter for closed fracture",Injury or poisoning,39,32,27,-0.179487179,-0.15625,-0.307692308,881,940,1049,59,109,168
s32441a,s,"Displaced fracture of posterior column [ilioischial] of right acetabulum, initial encounter for closed fracture",Injury or poisoning,12,14,21,0.166666667,0.5,0.75,1475,1390,1178,-85,-212,-297
s32442a,s,"Displaced fracture of posterior column [ilioischial] of left acetabulum, initial encounter for closed fracture",Injury or poisoning,14,14,13,0,-0.071428571,-0.071428571,1409,1390,1413,-19,23,4
s32491a,s,"Other specified fracture of right acetabulum, initial encounter for closed fracture",Injury or poisoning,18,19,22,0.055555556,0.157894737,0.222222222,1286,1236,1157,-50,-79,-129
s32492a,s,"Other specified fracture of left acetabulum, initial encounter for closed fracture",Injury or poisoning,18,11,20,-0.388888889,0.818181818,0.111111111,1286,1490,1203,204,-287,-83
s32501a,s,"Unspecified fracture of right pubis, initial encounter for closed fracture",Injury or poisoning,38,42,31,0.105263158,-0.261904762,-0.184210526,892,819,990,-73,171,98
s32501d,s,"Unspecified fracture of right pubis, subsequent encounter for fracture with routine healing",Injury or poisoning,18,20,14,0.111111111,-0.3,-0.222222222,1285,1211,1373,-74,162,88
s32502a,s,"Unspecified fracture of left pubis, initial encounter for closed fracture",Injury or poisoning,48,30,29,-0.375,-0.033333333,-0.395833333,802,973,1011,171,38,209
s32502d,s,"Unspecified fracture of left pubis, subsequent encounter for fracture with routine healing",Injury or poisoning,13,14,10,0.076923077,-0.285714286,-0.230769231,1441,1386,1509,-55,123,68
s32511a,s,"Fracture of superior rim of right pubis, initial encounter for closed fracture",Injury or poisoning,81,77,76,-0.049382716,-0.012987013,-0.061728395,613,597,626,-16,29,13
s32511d,s,"Fracture of superior rim of right pubis, subsequent encounter for fracture with routine healing",Injury or poisoning,28,22,17,-0.214285714,-0.227272727,-0.392857143,1044,1153,1283,109,130,239
s32512a,s,"Fracture of superior rim of left pubis, initial encounter for closed fracture",Injury or poisoning,83,90,73,0.084337349,-0.188888889,-0.120481928,603,551,636,-52,85,33
s32512d,s,"Fracture of superior rim of left pubis, subsequent encounter for fracture with routine healing",Injury or poisoning,30,24,19,-0.2,-0.208333333,-0.366666667,1005,1100,1225,95,125,220
s32591a,s,"Other specified fracture of right pubis, initial encounter for closed fracture",Injury or poisoning,249,258,241,0.036144578,-0.065891473,-0.032128514,349,332,352,-17,20,3
s32591d,s,"Other specified fracture of right pubis, subsequent encounter for fracture with routine healing",Injury or poisoning,65,51,42,-0.215384615,-0.176470588,-0.353846154,679,730,843,51,113,164
s32592a,s,"Other specified fracture of left pubis, initial encounter for closed fracture",Injury or poisoning,292,293,256,0.003424658,-0.126279863,-0.123287671,324,309,343,-15,34,19
s32592d,s,"Other specified fracture of left pubis, subsequent encounter for fracture with routine healing",Injury or poisoning,79,67,47,-0.151898734,-0.298507463,-0.405063291,619,642,789,23,147,170
s32599a,s,"Other specified fracture of unspecified pubis, initial encounter for closed fracture",Injury or poisoning,26,23,19,-0.115384615,-0.173913043,-0.269230769,1077,1121,1221,44,100,144
s32810a,s,"Multiple fractures of pelvis with stable disruption of pelvic ring, initial encounter for closed fracture",Injury or poisoning,78,85,90,0.08974359,0.058823529,0.153846154,621,565,571,-56,6,-50
s32810d,s,"Multiple fractures of pelvis with stable disruption of pelvic ring, subsequent encounter for fracture with routine healing",Injury or poisoning,35,40,44,0.142857143,0.1,0.257142857,922,838,818,-84,-20,-104
s32811a,s,"Multiple fractures of pelvis with unstable disruption of pelvic ring, initial encounter for closed fracture",Injury or poisoning,28,25,27,-0.107142857,0.08,-0.035714286,1036,1065,1039,29,-26,3
s3282xa,s,"Multiple fractures of pelvis without disruption of pelvic ring, initial encounter for closed fracture",Injury or poisoning,84,80,67,-0.047619048,-0.1625,-0.202380952,597,584,661,-13,77,64
s3282xd,s,"Multiple fractures of pelvis without disruption of pelvic ring, subsequent encounter for fracture with routine healing",Injury or poisoning,101,87,80,-0.138613861,-0.08045977,-0.207920792,544,559,603,15,44,59
s329xxa,s,"Fracture of unspecified parts of lumbosacral spine and pelvis, initial encounter for closed fracture",Injury or poisoning,41,36,36,-0.12195122,0,-0.12195122,847,878,891,31,13,44
s329xxd,s,"Fracture of unspecified parts of lumbosacral spine and pelvis, subsequent encounter for fracture with routine healing",Injury or poisoning,37,42,32,0.135135135,-0.238095238,-0.135135135,891,810,957,-81,147,66
s332xxa,s,"Dislocation of sacroiliac and sacrococcygeal joint, initial encounter",Injury or poisoning,19,21,20,0.105263158,-0.047619048,0.052631579,1231,1166,1188,-65,22,-43
s36030a,s,"Superficial (capsular) laceration of spleen, initial encounter",Injury or poisoning,36,37,41,0.027777778,0.108108108,0.138888889,902,869,847,-33,-22,-55
s36031a,s,"Moderate laceration of spleen, initial encounter",Injury or poisoning,87,95,80,0.091954023,-0.157894737,-0.08045977,588,534,603,-54,69,15
s36032a,s,"Major laceration of spleen, initial encounter",Injury or poisoning,59,47,67,-0.203389831,0.425531915,0.13559322,714,761,659,47,-102,-55
s36039a,s,"Unspecified laceration of spleen, initial encounter",Injury or poisoning,72,69,72,-0.041666667,0.043478261,0,643,627,634,-16,7,-9
s36039d,s,"Unspecified laceration of spleen, subsequent encounter",Injury or poisoning,13,19,15,0.461538462,-0.210526316,0.153846154,1420,1212,1316,-208,104,-104
s36112a,s,"Contusion of liver, initial encounter",Injury or poisoning,22,26,16,0.181818182,-0.384615385,-0.272727273,1161,1039,1289,-122,250,128
s36113a,s,"Laceration of liver, unspecified degree, initial encounter",Injury or poisoning,65,48,64,-0.261538462,0.333333333,-0.015384615,672,750,666,78,-84,-6
s36113d,s,"Laceration of liver, unspecified degree, subsequent encounter",Injury or poisoning,17,16,19,-0.058823529,0.1875,0.117647059,1283,1301,1208,18,-93,-75
s36114a,s,"Minor laceration of liver, initial encounter",Injury or poisoning,33,34,54,0.03030303,0.588235294,0.636363636,940,890,721,-50,-169,-219
s36115a,s,"Moderate laceration of liver, initial encounter",Injury or poisoning,56,55,66,-0.017857143,0.2,0.178571429,729,701,659,-28,-42,-70
s36116a,s,"Major laceration of liver, initial encounter",Injury or poisoning,79,72,93,-0.088607595,0.291666667,0.17721519,616,615,560,-1,-55,-56
s36116d,s,"Major laceration of liver, subsequent encounter",Injury or poisoning,19,12,18,-0.368421053,0.5,-0.052631579,1222,1424,1232,202,-192,10
s36420a,s,"Contusion of duodenum, initial encounter",Injury or poisoning,16,15,14,-0.0625,-0.066666667,-0.125,1309,1321,1343,12,22,34
s36438a,s,"Laceration of other part of small intestine, initial encounter",Injury or poisoning,37,27,33,-0.27027027,0.222222222,-0.108108108,885,1013,932,128,-81,47
s36439a,s,"Laceration of unspecified part of small intestine, initial encounter",Injury or poisoning,22,17,17,-0.227272727,0,-0.227272727,1156,1268,1257,112,-11,101
s36531a,s,"Laceration of transverse colon, initial encounter",Injury or poisoning,12,18,22,0.5,0.222222222,0.833333333,1436,1230,1133,-206,-97,-303
s36533a,s,"Laceration of sigmoid colon, initial encounter",Injury or poisoning,16,14,14,-0.125,0,-0.125,1307,1354,1340,47,-14,33
s3681xa,s,"Injury of peritoneum, initial encounter",Injury or poisoning,34,28,28,-0.176470588,0,-0.176470588,921,987,1009,66,22,88
s36892a,s,"Contusion of other intra-abdominal organs, initial encounter",Injury or poisoning,122,95,126,-0.221311475,0.326315789,0.032786885,496,534,471,38,-63,-25
s36893a,s,"Laceration of other intra-abdominal organs, initial encounter",Injury or poisoning,38,34,33,-0.105263158,-0.029411765,-0.131578947,874,887,931,13,44,57
s36898a,s,"Other injury of other intra-abdominal organs, initial encounter",Injury or poisoning,19,15,18,-0.210526316,0.2,-0.052631579,1217,1315,1227,98,-88,10
s36899a,s,"Unspecified injury of other intra-abdominal organs, initial encounter",Injury or poisoning,34,25,17,-0.264705882,-0.32,-0.5,919,1048,1252,129,204,333
s37011a,s,"Minor contusion of right kidney, initial encounter",Injury or poisoning,27,23,21,-0.148148148,-0.086956522,-0.222222222,1040,1100,1149,60,49,109
s37012a,s,"Minor contusion of left kidney, initial encounter",Injury or poisoning,30,28,23,-0.066666667,-0.178571429,-0.233333333,982,985,1105,3,120,123
s37031a,s,"Laceration of right kidney, unspecified degree, initial encounter",Injury or poisoning,18,23,15,0.277777778,-0.347826087,-0.166666667,1248,1099,1299,-149,200,51
s37032a,s,"Laceration of left kidney, unspecified degree, initial encounter",Injury or poisoning,18,24,19,0.333333333,-0.208333333,0.055555556,1248,1074,1198,-174,124,-50
s3710xa,s,"Unspecified injury of ureter, initial encounter",Injury or poisoning,13,15,13,0.153846154,-0.133333333,0,1400,1310,1365,-90,55,-35
s3729xa,s,"Other injury of bladder, initial encounter",Injury or poisoning,23,13,17,-0.434782609,0.307692308,-0.260869565,1125,1369,1249,244,-120,124
s3730xa,s,"Unspecified injury of urethra, initial encounter",Injury or poisoning,60,66,73,0.1,0.106060606,0.216666667,699,640,629,-59,-11,-70
s3739xa,s,"Other injury of urethra, initial encounter",Injury or poisoning,52,52,55,0,0.057692308,0.057692308,753,713,710,-40,-3,-43
s37812a,s,"Contusion of adrenal gland, initial encounter",Injury or poisoning,26,42,28,0.615384615,-0.333333333,0.076923077,1053,801,1005,-252,204,-48
s39012a,s,"Strain of muscle, fascia and tendon of lower back, initial encounter",Injury or poisoning,54,41,48,-0.240740741,0.170731707,-0.111111111,738,812,768,74,-44,30
s3991xa,s,"Unspecified injury of abdomen, initial encounter",Injury or poisoning,17,13,17,-0.235294118,0.307692308,0,1263,1365,1245,102,-120,-18
s40011a,s,"Contusion of right shoulder, initial encounter",Injury or poisoning,92,70,74,-0.239130435,0.057142857,-0.195652174,570,618,625,48,7,55
s40012a,s,"Contusion of left shoulder, initial encounter",Injury or poisoning,98,68,84,-0.306122449,0.235294118,-0.142857143,552,628,587,76,-41,35
s40021a,s,"Contusion of right upper arm, initial encounter",Injury or poisoning,104,81,77,-0.221153846,-0.049382716,-0.259615385,532,577,612,45,35,80
s40021d,s,"Contusion of right upper arm, subsequent encounter",Injury or poisoning,13,14,12,0.076923077,-0.142857143,-0.076923077,1391,1337,1390,-54,53,-1
s40022a,s,"Contusion of left upper arm, initial encounter",Injury or poisoning,99,85,94,-0.141414141,0.105882353,-0.050505051,544,562,555,18,-7,11
s40022d,s,"Contusion of left upper arm, subsequent encounter",Injury or poisoning,13,12,13,-0.076923077,0.083333333,0,1390,1398,1355,8,-43,-35
s40211a,s,"Abrasion of right shoulder, initial encounter",Injury or poisoning,78,64,94,-0.179487179,0.46875,0.205128205,612,643,555,31,-88,-57
s40212a,s,"Abrasion of left shoulder, initial encounter",Injury or poisoning,74,65,86,-0.121621622,0.323076923,0.162162162,628,640,576,12,-64,-52
s40811a,s,"Abrasion of right upper arm, initial encounter",Injury or poisoning,108,100,132,-0.074074074,0.32,0.222222222,526,521,456,-5,-65,-70
s40811d,s,"Abrasion of right upper arm, subsequent encounter",Injury or poisoning,16,11,21,-0.3125,0.909090909,0.3125,1285,1427,1137,142,-290,-148
s40812a,s,"Abrasion of left upper arm, initial encounter",Injury or poisoning,124,123,140,-0.008064516,0.138211382,0.129032258,490,474,438,-16,-36,-52
s40812d,s,"Abrasion of left upper arm, subsequent encounter",Injury or poisoning,15,16,23,0.066666667,0.4375,0.533333333,1313,1275,1093,-38,-182,-220
s41011a,s,"Laceration without foreign body of right shoulder, initial encounter",Injury or poisoning,27,14,16,-0.481481481,0.142857143,-0.407407407,1028,1331,1256,303,-75,228
s41012a,s,"Laceration without foreign body of left shoulder, initial encounter",Injury or poisoning,22,24,22,0.090909091,-0.083333333,0,1136,1062,1116,-74,54,-20
s41101a,s,"Unspecified open wound of right upper arm, initial encounter",Injury or poisoning,11,11,12,0,0.090909091,0.090909091,1430,1423,1380,-7,-43,-50
s41102a,s,"Unspecified open wound of left upper arm, initial encounter",Injury or poisoning,14,12,16,-0.142857143,0.333333333,0.142857143,1345,1391,1255,46,-136,-90
s41111a,s,"Laceration without foreign body of right upper arm, initial encounter",Injury or poisoning,132,120,114,-0.090909091,-0.05,-0.136363636,476,479,502,3,23,26
s41111d,s,"Laceration without foreign body of right upper arm, subsequent encounter",Injury or poisoning,19,14,22,-0.263157895,0.571428571,0.157894737,1198,1329,1115,131,-214,-83
s41112a,s,"Laceration without foreign body of left upper arm, initial encounter",Injury or poisoning,130,144,127,0.107692308,-0.118055556,-0.023076923,478,442,466,-36,24,-12
s41112d,s,"Laceration without foreign body of left upper arm, subsequent encounter",Injury or poisoning,33,25,45,-0.242424242,0.8,0.363636364,920,1033,785,113,-248,-135
s41119a,s,"Laceration without foreign body of unspecified upper arm, initial encounter",Injury or poisoning,12,21,19,0.75,-0.095238095,0.583333333,1400,1132,1179,-268,47,-221
s42001a,s,"Fracture of unspecified part of right clavicle, initial encounter for closed fracture",Injury or poisoning,59,42,41,-0.288135593,-0.023809524,-0.305084746,699,791,825,92,34,126
s42001d,s,"Fracture of unspecified part of right clavicle, subsequent encounter for fracture with routine healing",Injury or poisoning,36,30,36,-0.166666667,0.2,0,879,936,867,57,-69,-12
s42002a,s,"Fracture of unspecified part of left clavicle, initial encounter for closed fracture",Injury or poisoning,60,51,49,-0.15,-0.039215686,-0.183333333,689,708,747,19,39,58
s42002d,s,"Fracture of unspecified part of left clavicle, subsequent encounter for fracture with routine healing",Injury or poisoning,44,40,53,-0.090909091,0.325,0.204545455,803,812,712,9,-100,-91
s42021a,s,"Displaced fracture of shaft of right clavicle, initial encounter for closed fracture",Injury or poisoning,75,88,81,0.173333333,-0.079545455,0.08,615,549,587,-66,38,-28
s42022a,s,"Displaced fracture of shaft of left clavicle, initial encounter for closed fracture",Injury or poisoning,76,95,99,0.25,0.042105263,0.302631579,612,530,538,-82,8,-74
s42031a,s,"Displaced fracture of lateral end of right clavicle, initial encounter for closed fracture",Injury or poisoning,67,50,50,-0.253731343,0,-0.253731343,648,711,735,63,24,87
s42032a,s,"Displaced fracture of lateral end of left clavicle, initial encounter for closed fracture",Injury or poisoning,65,59,82,-0.092307692,0.389830508,0.261538462,657,662,583,5,-79,-74
s42034a,s,"Nondisplaced fracture of lateral end of right clavicle, initial encounter for closed fracture",Injury or poisoning,18,11,11,-0.388888889,0,-0.388888889,1221,1409,1400,188,-9,179
s42035a,s,"Nondisplaced fracture of lateral end of left clavicle, initial encounter for closed fracture",Injury or poisoning,17,14,14,-0.176470588,0,-0.176470588,1240,1318,1299,78,-19,59
s42101a,s,"Fracture of unspecified part of scapula, right shoulder, initial encounter for closed fracture",Injury or poisoning,38,33,48,-0.131578947,0.454545455,0.263157895,854,880,752,26,-128,-102
s42101d,s,"Fracture of unspecified part of scapula, right shoulder, subsequent encounter for fracture with routine healing",Injury or poisoning,24,25,21,0.041666667,-0.16,-0.125,1081,1024,1121,-57,97,40
s42102a,s,"Fracture of unspecified part of scapula, left shoulder, initial encounter for closed fracture",Injury or poisoning,33,36,47,0.090909091,0.305555556,0.424242424,911,848,758,-63,-90,-153
s42102d,s,"Fracture of unspecified part of scapula, left shoulder, subsequent encounter for fracture with routine healing",Injury or poisoning,24,29,33,0.208333333,0.137931034,0.375,1080,941,907,-139,-34,-173
s42111a,s,"Displaced fracture of body of scapula, right shoulder, initial encounter for closed fracture",Injury or poisoning,40,48,58,0.2,0.208333333,0.45,827,730,676,-97,-54,-151
s42112a,s,"Displaced fracture of body of scapula, left shoulder, initial encounter for closed fracture",Injury or poisoning,46,59,48,0.282608696,-0.186440678,0.043478261,780,662,751,-118,89,-29
s42141a,s,"Displaced fracture of glenoid cavity of scapula, right shoulder, initial encounter for closed fracture",Injury or poisoning,10,15,12,0.5,-0.2,0.2,1438,1278,1359,-160,81,-79
s42142a,s,"Displaced fracture of glenoid cavity of scapula, left shoulder, initial encounter for closed fracture",Injury or poisoning,12,17,13,0.416666667,-0.235294118,0.083333333,1384,1228,1326,-156,98,-58
s42201a,s,"Unspecified fracture of upper end of right humerus, initial encounter for closed fracture",Injury or poisoning,81,83,94,0.024691358,0.13253012,0.160493827,598,564,550,-34,-14,-48
s42201d,s,"Unspecified fracture of upper end of right humerus, subsequent encounter for fracture with routine healing",Injury or poisoning,35,40,24,0.142857143,-0.4,-0.314285714,883,805,1061,-78,256,178
s42202a,s,"Unspecified fracture of upper end of left humerus, initial encounter for closed fracture",Injury or poisoning,83,100,77,0.204819277,-0.23,-0.072289157,589,518,601,-71,83,12
s42202d,s,"Unspecified fracture of upper end of left humerus, subsequent encounter for fracture with routine healing",Injury or poisoning,30,28,35,-0.066666667,0.25,0.166666667,953,955,873,2,-82,-80
s42211a,s,"Unspecified displaced fracture of surgical neck of right humerus, initial encounter for closed fracture",Injury or poisoning,65,58,57,-0.107692308,-0.017241379,-0.123076923,655,665,683,10,18,28
s42212a,s,"Unspecified displaced fracture of surgical neck of left humerus, initial encounter for closed fracture",Injury or poisoning,62,70,68,0.129032258,-0.028571429,0.096774194,672,608,636,-64,28,-36
s42212d,s,"Unspecified displaced fracture of surgical neck of left humerus, subsequent encounter for fracture with routine healing",Injury or poisoning,15,12,11,-0.2,-0.083333333,-0.266666667,1285,1363,1385,78,22,100
s42231a,s,"3-part fracture of surgical neck of right humerus, initial encounter for closed fracture",Injury or poisoning,16,19,17,0.1875,-0.105263158,0.0625,1256,1161,1209,-95,48,-47
s42232a,s,"3-part fracture of surgical neck of left humerus, initial encounter for closed fracture",Injury or poisoning,13,14,15,0.076923077,0.071428571,0.153846154,1353,1303,1253,-50,-50,-100
s42241a,s,"4-part fracture of surgical neck of right humerus, initial encounter for closed fracture",Injury or poisoning,28,25,20,-0.107142857,-0.2,-0.285714286,986,1014,1134,28,120,148
s42242a,s,"4-part fracture of surgical neck of left humerus, initial encounter for closed fracture",Injury or poisoning,22,21,11,-0.045454545,-0.476190476,-0.5,1112,1111,1382,-1,271,270
s42251a,s,"Displaced fracture of greater tuberosity of right humerus, initial encounter for closed fracture",Injury or poisoning,44,23,34,-0.477272727,0.47826087,-0.227272727,794,1061,884,267,-177,90
s42252a,s,"Displaced fracture of greater tuberosity of left humerus, initial encounter for closed fracture",Injury or poisoning,39,29,25,-0.256410256,-0.137931034,-0.358974359,836,934,1028,98,94,192
s42291a,s,"Other displaced fracture of upper end of right humerus, initial encounter for closed fracture",Injury or poisoning,64,66,92,0.03125,0.393939394,0.4375,661,627,556,-34,-71,-105
s42291d,s,"Other displaced fracture of upper end of right humerus, subsequent encounter for fracture with routine healing",Injury or poisoning,11,21,12,0.909090909,-0.428571429,0.090909091,1393,1108,1346,-285,238,-47
s42292a,s,"Other displaced fracture of upper end of left humerus, initial encounter for closed fracture",Injury or poisoning,89,84,88,-0.056179775,0.047619048,-0.011235955,570,559,565,-11,6,-5
s42292d,s,"Other displaced fracture of upper end of left humerus, subsequent encounter for fracture with routine healing",Injury or poisoning,20,21,16,0.05,-0.238095238,-0.2,1149,1107,1224,-42,117,75
s42301a,s,"Unspecified fracture of shaft of humerus, right arm, initial encounter for closed fracture",Injury or poisoning,50,42,53,-0.16,0.261904762,0.06,745,778,702,33,-76,-43
s42301d,s,"Unspecified fracture of shaft of humerus, right arm, subsequent encounter for fracture with routine healing",Injury or poisoning,37,29,27,-0.216216216,-0.068965517,-0.27027027,851,931,986,80,55,135
s42302a,s,"Unspecified fracture of shaft of humerus, left arm, initial encounter for closed fracture",Injury or poisoning,56,57,52,0.017857143,-0.087719298,-0.071428571,704,668,710,-36,42,6
s42302d,s,"Unspecified fracture of shaft of humerus, left arm, subsequent encounter for fracture with routine healing",Injury or poisoning,44,45,28,0.022727273,-0.377777778,-0.363636364,790,746,970,-44,224,180
s42351a,s,"Displaced comminuted fracture of shaft of humerus, right arm, initial encounter for closed fracture",Injury or poisoning,29,22,29,-0.24137931,0.318181818,0,963,1076,951,113,-125,-12
s42352a,s,"Displaced comminuted fracture of shaft of humerus, left arm, initial encounter for closed fracture",Injury or poisoning,35,28,29,-0.2,0.035714286,-0.171428571,872,946,951,74,5,79
s42401a,s,"Unspecified fracture of lower end of right humerus, initial encounter for closed fracture",Injury or poisoning,26,33,31,0.269230769,-0.060606061,0.192307692,1011,867,930,-144,63,-81
s42402a,s,"Unspecified fracture of lower end of left humerus, initial encounter for closed fracture",Injury or poisoning,31,32,25,0.032258065,-0.21875,-0.193548387,926,881,1019,-45,138,93
s42411a,s,"Displaced simple supracondylar fracture without intercondylar fracture of right humerus, initial encounter for closed fracture",Injury or poisoning,15,18,11,0.2,-0.388888889,-0.266666667,1269,1168,1368,-101,200,99
s42412a,s,"Displaced simple supracondylar fracture without intercondylar fracture of left humerus, initial encounter for closed fracture",Injury or poisoning,19,19,21,0,0.105263158,0.105263158,1161,1145,1099,-16,-46,-62
s43004a,s,"Unspecified dislocation of right shoulder joint, initial encounter",Injury or poisoning,19,21,23,0.105263158,0.095238095,0.210526316,1161,1099,1059,-62,-40,-102
s43005a,s,"Unspecified dislocation of left shoulder joint, initial encounter",Injury or poisoning,21,17,14,-0.19047619,-0.176470588,-0.333333333,1117,1202,1269,85,67,152
s43014a,s,"Anterior dislocation of right humerus, initial encounter",Injury or poisoning,25,24,24,-0.04,0,-0.04,1033,1028,1045,-5,17,12
s43015a,s,"Anterior dislocation of left humerus, initial encounter",Injury or poisoning,19,18,19,-0.052631579,0.055555556,0,1159,1165,1143,6,-22,-16
s43101a,s,"Unspecified dislocation of right acromioclavicular joint, initial encounter",Injury or poisoning,25,18,15,-0.28,-0.166666667,-0.4,1033,1165,1235,132,70,202
s43102a,s,"Unspecified dislocation of left acromioclavicular joint, initial encounter",Injury or poisoning,21,18,17,-0.142857143,-0.055555556,-0.19047619,1115,1165,1192,50,27,77
s46011a,s,"Strain of muscle(s) and tendon(s) of the rotator cuff of right shoulder, initial encounter",Injury or poisoning,32,13,29,-0.59375,1.230769231,-0.09375,911,1299,950,388,-349,39
s46012a,s,"Strain of muscle(s) and tendon(s) of the rotator cuff of left shoulder, initial encounter",Injury or poisoning,16,19,15,0.1875,-0.210526316,-0.0625,1233,1143,1233,-90,90,0
s4992xa,s,"Unspecified injury of left shoulder and upper arm, initial encounter",Injury or poisoning,16,15,12,-0.0625,-0.2,-0.25,1233,1245,1327,12,82,94
s5001xa,s,"Contusion of right elbow, initial encounter",Injury or poisoning,64,52,43,-0.1875,-0.173076923,-0.328125,660,692,787,32,95,127
s5002xa,s,"Contusion of left elbow, initial encounter",Injury or poisoning,57,39,48,-0.315789474,0.230769231,-0.157894737,700,804,743,104,-61,43
s5011xa,s,"Contusion of right forearm, initial encounter",Injury or poisoning,49,35,36,-0.285714286,0.028571429,-0.265306122,747,841,847,94,6,100
s5012xa,s,"Contusion of left forearm, initial encounter",Injury or poisoning,51,29,39,-0.431372549,0.344827586,-0.235294118,736,924,817,188,-107,81
s50311a,s,"Abrasion of right elbow, initial encounter",Injury or poisoning,161,134,160,-0.167701863,0.194029851,-0.00621118,425,455,412,30,-43,-13
s50312a,s,"Abrasion of left elbow, initial encounter",Injury or poisoning,149,158,175,0.060402685,0.107594937,0.174496644,449,422,397,-27,-25,-52
s50811a,s,"Abrasion of right forearm, initial encounter",Injury or poisoning,103,82,128,-0.203883495,0.56097561,0.242718447,527,562,460,35,-102,-67
s50811d,s,"Abrasion of right forearm, subsequent encounter",Injury or poisoning,11,15,21,0.363636364,0.4,0.909090909,1365,1238,1089,-127,-149,-276
s50812a,s,"Abrasion of left forearm, initial encounter",Injury or poisoning,124,90,132,-0.274193548,0.466666667,0.064516129,486,539,453,53,-86,-33
s50812d,s,"Abrasion of left forearm, subsequent encounter",Injury or poisoning,14,15,22,0.071428571,0.466666667,0.571428571,1283,1237,1071,-46,-166,-212
s51001a,s,"Unspecified open wound of right elbow, initial encounter",Injury or poisoning,14,11,10,-0.214285714,-0.090909091,-0.285714286,1283,1354,1374,71,20,91
s51011a,s,"Laceration without foreign body of right elbow, initial encounter",Injury or poisoning,139,145,122,0.043165468,-0.15862069,-0.122302158,462,439,473,-23,34,11
s51012a,s,"Laceration without foreign body of left elbow, initial encounter",Injury or poisoning,152,143,128,-0.059210526,-0.104895105,-0.157894737,442,441,459,-1,18,17
s51801a,s,"Unspecified open wound of right forearm, initial encounter",Injury or poisoning,19,13,14,-0.315789474,0.076923077,-0.263157895,1146,1285,1251,139,-34,105
s51802a,s,"Unspecified open wound of left forearm, initial encounter",Injury or poisoning,21,22,15,0.047619048,-0.318181818,-0.285714286,1104,1062,1221,-42,159,117
s51802d,s,"Unspecified open wound of left forearm, subsequent encounter",Injury or poisoning,12,12,11,0,-0.083333333,-0.083333333,1335,1320,1344,-15,24,9
s51811a,s,"Laceration without foreign body of right forearm, initial encounter",Injury or poisoning,157,173,190,0.101910828,0.098265896,0.210191083,433,400,382,-33,-18,-51
s51811d,s,"Laceration without foreign body of right forearm, subsequent encounter",Injury or poisoning,57,63,53,0.105263158,-0.158730159,-0.070175439,693,632,695,-61,63,2
s51812a,s,"Laceration without foreign body of left forearm, initial encounter",Injury or poisoning,180,211,210,0.172222222,-0.004739336,0.166666667,402,369,368,-33,-1,-34
s51812d,s,"Laceration without foreign body of left forearm, subsequent encounter",Injury or poisoning,98,117,124,0.193877551,0.05982906,0.265306122,538,481,465,-57,-16,-73
s51851a,s,"Open bite of right forearm, initial encounter",Injury or poisoning,33,28,32,-0.151515152,0.142857143,-0.03030303,881,930,895,49,-35,14
s51852a,s,"Open bite of left forearm, initial encounter",Injury or poisoning,24,32,17,0.333333333,-0.46875,-0.291666667,1041,868,1174,-173,306,133
s52021a,s,"Displaced fracture of olecranon process without intraarticular extension of right ulna, initial encounter for closed fracture",Injury or poisoning,25,33,29,0.32,-0.121212121,0.16,1017,854,935,-163,81,-82
s52022a,s,"Displaced fracture of olecranon process without intraarticular extension of left ulna, initial encounter for closed fracture",Injury or poisoning,46,43,42,-0.065217391,-0.023255814,-0.086956522,758,754,785,-4,31,27
s52022b,s,"Displaced fracture of olecranon process without intraarticular extension of left ulna, initial encounter for open fracture type I or II",Injury or poisoning,17,13,14,-0.235294118,0.076923077,-0.176470588,1185,1276,1242,91,-34,57
s52121a,s,"Displaced fracture of head of right radius, initial encounter for closed fracture",Injury or poisoning,32,23,26,-0.28125,0.130434783,-0.1875,895,1032,982,137,-50,87
s52122a,s,"Displaced fracture of head of left radius, initial encounter for closed fracture",Injury or poisoning,36,29,35,-0.194444444,0.206896552,-0.027777778,843,911,852,68,-59,9
s52201a,s,"Unspecified fracture of shaft of right ulna, initial encounter for closed fracture",Injury or poisoning,28,28,25,0,-0.107142857,-0.107142857,956,926,999,-30,73,43
s52201b,s,"Unspecified fracture of shaft of right ulna, initial encounter for open fracture type I or II",Injury or poisoning,11,11,10,0,-0.090909091,-0.090909091,1345,1337,1357,-8,20,12
s52201d,s,"Unspecified fracture of shaft of right ulna, subsequent encounter for closed fracture with routine healing",Injury or poisoning,25,16,13,-0.36,-0.1875,-0.48,1013,1201,1269,188,68,256
s52202a,s,"Unspecified fracture of shaft of left ulna, initial encounter for closed fracture",Injury or poisoning,26,33,30,0.269230769,-0.090909091,0.153846154,990,853,926,-137,73,-64
s52301a,s,"Unspecified fracture of shaft of right radius, initial encounter for closed fracture",Injury or poisoning,33,11,16,-0.666666667,0.454545455,-0.515151515,879,1335,1186,456,-149,307
s52302a,s,"Unspecified fracture of shaft of left radius, initial encounter for closed fracture",Injury or poisoning,14,19,10,0.357142857,-0.473684211,-0.285714286,1264,1120,1354,-144,234,90
s52501a,s,"Unspecified fracture of the lower end of right radius, initial encounter for closed fracture",Injury or poisoning,73,84,93,0.150684932,0.107142857,0.273972603,613,551,542,-62,-9,-71
s52501b,s,"Unspecified fracture of the lower end of right radius, initial encounter for open fracture type I or II",Injury or poisoning,17,13,20,-0.235294118,0.538461538,0.176470588,1178,1269,1094,91,-175,-84
s52501d,s,"Unspecified fracture of the lower end of right radius, subsequent encounter for closed fracture with routine healing",Injury or poisoning,33,36,36,0.090909091,0,0.090909091,878,822,834,-56,12,-44
s52502a,s,"Unspecified fracture of the lower end of left radius, initial encounter for closed fracture",Injury or poisoning,115,121,120,0.052173913,-0.008264463,0.043478261,506,469,476,-37,7,-30
s52502b,s,"Unspecified fracture of the lower end of left radius, initial encounter for open fracture type I or II",Injury or poisoning,16,24,20,0.5,-0.166666667,0.25,1202,1004,1092,-198,88,-110
s52502d,s,"Unspecified fracture of the lower end of left radius, subsequent encounter for closed fracture with routine healing",Injury or poisoning,49,43,32,-0.12244898,-0.255813953,-0.346938776,734,752,890,18,138,156
s52511a,s,"Displaced fracture of right radial styloid process, initial encounter for closed fracture",Injury or poisoning,15,10,12,-0.333333333,0.2,-0.2,1226,1357,1292,131,-65,66
s52512a,s,"Displaced fracture of left radial styloid process, initial encounter for closed fracture",Injury or poisoning,14,12,16,-0.142857143,0.333333333,0.142857143,1257,1299,1180,42,-119,-77
s52532a,s,"Colles' fracture of left radius, initial encounter for closed fracture",Injury or poisoning,28,17,16,-0.392857143,-0.058823529,-0.428571429,951,1168,1180,217,12,229
s52571a,s,"Other intraarticular fracture of lower end of right radius, initial encounter for closed fracture",Injury or poisoning,75,65,86,-0.133333333,0.323076923,0.146666667,601,618,557,17,-61,-44
s52572a,s,"Other intraarticular fracture of lower end of left radius, initial encounter for closed fracture",Injury or poisoning,89,74,86,-0.168539326,0.162162162,-0.033707865,560,579,557,19,-22,-3
s52591a,s,"Other fractures of lower end of right radius, initial encounter for closed fracture",Injury or poisoning,14,16,14,0.142857143,-0.125,0,1254,1191,1227,-63,36,-27
s52592a,s,"Other fractures of lower end of left radius, initial encounter for closed fracture",Injury or poisoning,31,29,10,-0.064516129,-0.655172414,-0.677419355,900,904,1342,4,438,442
s52601a,s,"Unspecified fracture of lower end of right ulna, initial encounter for closed fracture",Injury or poisoning,27,18,39,-0.333333333,1.166666667,0.444444444,966,1132,802,166,-330,-164
s52601b,s,"Unspecified fracture of lower end of right ulna, initial encounter for open fracture type I or II",Injury or poisoning,16,15,12,-0.0625,-0.2,-0.25,1196,1209,1286,13,77,90
s52602a,s,"Unspecified fracture of lower end of left ulna, initial encounter for closed fracture",Injury or poisoning,38,45,32,0.184210526,-0.288888889,-0.157894737,821,731,887,-90,156,66
s52602b,s,"Unspecified fracture of lower end of left ulna, initial encounter for open fracture type I or II",Injury or poisoning,16,15,10,-0.0625,-0.333333333,-0.375,1195,1208,1339,13,131,144
s52611a,s,"Displaced fracture of right ulna styloid process, initial encounter for closed fracture",Injury or poisoning,43,51,54,0.186046512,0.058823529,0.255813953,778,682,683,-96,1,-95
s52611b,s,"Displaced fracture of right ulna styloid process, initial encounter for open fracture type I or II",Injury or poisoning,13,11,11,-0.153846154,0,-0.153846154,1279,1317,1313,38,-4,34
s52612a,s,"Displaced fracture of left ulna styloid process, initial encounter for closed fracture",Injury or poisoning,69,67,81,-0.028985507,0.208955224,0.173913043,625,609,569,-16,-40,-56
s52613a,s,"Displaced fracture of unspecified ulna styloid process, initial encounter for closed fracture",Injury or poisoning,16,16,10,0,-0.375,-0.375,1193,1186,1336,-7,150,143
s52614a,s,"Nondisplaced fracture of right ulna styloid process, initial encounter for closed fracture",Injury or poisoning,15,11,13,-0.266666667,0.181818182,-0.133333333,1215,1315,1252,100,-63,37
s52615a,s,"Nondisplaced fracture of left ulna styloid process, initial encounter for closed fracture",Injury or poisoning,16,12,11,-0.25,-0.083333333,-0.3125,1193,1287,1311,94,24,118
s5291xd,s,"Unspecified fracture of right forearm, subsequent encounter for closed fracture with routine healing",Injury or poisoning,11,12,12,0.090909091,0,0.090909091,1318,1287,1282,-31,-5,-36
s5292xd,s,"Unspecified fracture of left forearm, subsequent encounter for closed fracture with routine healing",Injury or poisoning,19,12,17,-0.368421053,0.416666667,-0.105263158,1119,1287,1156,168,-131,37
s56221a,s,"Laceration of other flexor muscle, fascia and tendon at forearm level, right arm, initial encounter",Injury or poisoning,11,13,15,0.181818182,0.153846154,0.363636364,1317,1253,1193,-64,-60,-124
s60211a,s,"Contusion of right wrist, initial encounter",Injury or poisoning,24,13,25,-0.458333333,0.923076923,0.041666667,1021,1253,988,232,-265,-33
s60212a,s,"Contusion of left wrist, initial encounter",Injury or poisoning,17,15,19,-0.117647059,0.266666667,0.117647059,1165,1205,1106,40,-99,-59
s60221a,s,"Contusion of right hand, initial encounter",Injury or poisoning,75,53,58,-0.293333333,0.094339623,-0.226666667,600,672,657,72,-15,57
s60222a,s,"Contusion of left hand, initial encounter",Injury or poisoning,49,42,57,-0.142857143,0.357142857,0.163265306,730,755,665,25,-90,-65
s60511a,s,"Abrasion of right hand, initial encounter",Injury or poisoning,124,118,134,-0.048387097,0.13559322,0.080645161,482,476,447,-6,-29,-35
s60512a,s,"Abrasion of left hand, initial encounter",Injury or poisoning,116,108,115,-0.068965517,0.064814815,-0.00862069,502,494,489,-8,-5,-13
s60512d,s,"Abrasion of left hand, subsequent encounter",Injury or poisoning,11,13,12,0.181818182,-0.076923077,0.090909091,1311,1248,1274,-63,26,-37
s60811a,s,"Abrasion of right wrist, initial encounter",Injury or poisoning,36,24,33,-0.333333333,0.375,-0.083333333,831,993,867,162,-126,36
s60812a,s,"Abrasion of left wrist, initial encounter",Injury or poisoning,29,32,39,0.103448276,0.21875,0.344827586,926,852,796,-74,-56,-130
s61011a,s,"Laceration without foreign body of right thumb without damage to nail, initial encounter",Injury or poisoning,21,25,26,0.19047619,0.04,0.238095238,1071,968,964,-103,-4,-107
s61012a,s,"Laceration without foreign body of left thumb without damage to nail, initial encounter",Injury or poisoning,13,22,21,0.692307692,-0.045454545,0.615384615,1265,1032,1056,-233,24,-209
s61210a,s,"Laceration without foreign body of right index finger without damage to nail, initial encounter",Injury or poisoning,26,23,24,-0.115384615,0.043478261,-0.076923077,971,1011,1005,40,-6,34
s61211a,s,"Laceration without foreign body of left index finger without damage to nail, initial encounter",Injury or poisoning,23,32,17,0.391304348,-0.46875,-0.260869565,1029,852,1145,-177,293,116
s61212a,s,"Laceration without foreign body of right middle finger without damage to nail, initial encounter",Injury or poisoning,28,27,18,-0.035714286,-0.333333333,-0.357142857,939,929,1120,-10,191,181
s61213a,s,"Laceration without foreign body of left middle finger without damage to nail, initial encounter",Injury or poisoning,25,26,25,0.04,-0.038461538,0,991,949,981,-42,32,-10
s61214a,s,"Laceration without foreign body of right ring finger without damage to nail, initial encounter",Injury or poisoning,23,21,23,-0.086956522,0.095238095,0,1027,1052,1016,25,-36,-11
s61215a,s,"Laceration without foreign body of left ring finger without damage to nail, initial encounter",Injury or poisoning,13,16,17,0.230769231,0.0625,0.307692308,1260,1173,1142,-87,-31,-118
s61216a,s,"Laceration without foreign body of right little finger without damage to nail, initial encounter",Injury or poisoning,19,13,18,-0.315789474,0.384615385,-0.052631579,1106,1238,1118,132,-120,12
s61401a,s,"Unspecified open wound of right hand, initial encounter",Injury or poisoning,11,12,19,0.090909091,0.583333333,0.727272727,1300,1268,1095,-32,-173,-205
s61402a,s,"Unspecified open wound of left hand, initial encounter",Injury or poisoning,14,20,20,0.428571429,0,0.428571429,1228,1073,1073,-155,0,-155
s61411a,s,"Laceration without foreign body of right hand, initial encounter",Injury or poisoning,128,120,119,-0.0625,-0.008333333,-0.0703125,476,471,479,-5,8,3
s61411d,s,"Laceration without foreign body of right hand, subsequent encounter",Injury or poisoning,18,17,19,-0.055555556,0.117647059,0.055555556,1132,1146,1093,14,-53,-39
s61412a,s,"Laceration without foreign body of left hand, initial encounter",Injury or poisoning,119,110,100,-0.075630252,-0.090909091,-0.159663866,495,489,519,-6,30,24
s61412d,s,"Laceration without foreign body of left hand, subsequent encounter",Injury or poisoning,18,14,14,-0.222222222,0,-0.222222222,1131,1214,1199,83,-15,68
s61431a,s,"Puncture wound without foreign body of right hand, initial encounter",Injury or poisoning,17,10,15,-0.411764706,0.5,-0.117647059,1148,1314,1171,166,-143,23
s61432a,s,"Puncture wound without foreign body of left hand, initial encounter",Injury or poisoning,10,13,22,0.3,0.692307692,1.2,1317,1233,1035,-84,-198,-282
s61451a,s,"Open bite of right hand, initial encounter",Injury or poisoning,82,79,57,-0.036585366,-0.278481013,-0.304878049,576,556,661,-20,105,85
s61452a,s,"Open bite of left hand, initial encounter",Injury or poisoning,68,46,64,-0.323529412,0.391304348,-0.058823529,620,718,626,98,-92,6
s61511a,s,"Laceration without foreign body of right wrist, initial encounter",Injury or poisoning,91,76,77,-0.164835165,0.013157895,-0.153846154,551,568,581,17,13,30
s61511d,s,"Laceration without foreign body of right wrist, subsequent encounter",Injury or poisoning,34,30,28,-0.117647059,-0.066666667,-0.176470588,847,877,926,30,49,79
s61512a,s,"Laceration without foreign body of left wrist, initial encounter",Injury or poisoning,129,130,122,0.007751938,-0.061538462,-0.054263566,473,458,468,-15,10,-5
s61512d,s,"Laceration without foreign body of left wrist, subsequent encounter",Injury or poisoning,68,64,61,-0.058823529,-0.046875,-0.102941176,618,610,637,-8,27,19
s62002a,s,"Unspecified fracture of navicular [scaphoid] bone of left wrist, initial encounter for closed fracture",Injury or poisoning,10,10,10,0,0,0,1311,1307,1299,-4,-8,-12
s62112a,s,"Displaced fracture of triquetrum [cuneiform] bone, left wrist, initial encounter for closed fracture",Injury or poisoning,15,14,12,-0.066666667,-0.142857143,-0.2,1187,1208,1249,21,41,62
s62306a,s,"Unspecified fracture of fifth metacarpal bone, right hand, initial encounter for closed fracture",Injury or poisoning,15,18,25,0.2,0.388888889,0.666666667,1187,1107,973,-80,-134,-214
s62336a,s,"Displaced fracture of neck of fifth metacarpal bone, right hand, initial encounter for closed fracture",Injury or poisoning,11,10,11,-0.090909091,0.1,0,1286,1305,1274,19,-31,-12
s62616a,s,"Displaced fracture of proximal phalanx of right little finger, initial encounter for closed fracture",Injury or poisoning,12,12,13,0,0.083333333,0.083333333,1264,1254,1218,-10,-36,-46
s63501a,s,"Unspecified sprain of right wrist, initial encounter",Injury or poisoning,14,22,15,0.571428571,-0.318181818,0.071428571,1215,1020,1163,-195,143,-52
s63502a,s,"Unspecified sprain of left wrist, initial encounter",Injury or poisoning,17,17,14,0,-0.176470588,-0.176470588,1142,1137,1189,-5,52,47
s6401xa,s,"Injury of ulnar nerve at wrist and hand level of right arm, initial encounter",Injury or poisoning,17,11,11,-0.352941176,0,-0.352941176,1142,1275,1271,133,-4,129
s6721xa,s,"Crushing injury of right hand, initial encounter",Injury or poisoning,12,21,22,0.75,0.047619048,0.833333333,1261,1043,1028,-218,-15,-233
s6722xa,s,"Crushing injury of left hand, initial encounter",Injury or poisoning,16,16,15,0,-0.0625,-0.0625,1164,1159,1162,-5,3,-2
s6991xa,s,"Unspecified injury of right wrist, hand and finger(s), initial encounter",Injury or poisoning,21,27,28,0.285714286,0.037037037,0.333333333,1058,921,924,-137,3,-134
s6992xa,s,"Unspecified injury of left wrist, hand and finger(s), initial encounter",Injury or poisoning,13,17,13,0.307692308,-0.235294118,0,1240,1135,1213,-105,78,-27
s7001xa,s,"Contusion of right hip, initial encounter",Injury or poisoning,136,118,125,-0.132352941,0.059322034,-0.080882353,465,474,460,9,-14,-5
s7001xd,s,"Contusion of right hip, subsequent encounter",Injury or poisoning,19,12,12,-0.368421053,0,-0.368421053,1096,1247,1240,151,-7,144
s7002xa,s,"Contusion of left hip, initial encounter",Injury or poisoning,139,118,144,-0.151079137,0.220338983,0.035971223,459,474,431,15,-43,-28
s7002xd,s,"Contusion of left hip, subsequent encounter",Injury or poisoning,21,11,13,-0.476190476,0.181818182,-0.380952381,1056,1268,1211,212,-57,155
s7011xa,s,"Contusion of right thigh, initial encounter",Injury or poisoning,129,97,110,-0.248062016,0.134020619,-0.147286822,471,511,495,40,-16,24
s7012xa,s,"Contusion of left thigh, initial encounter",Injury or poisoning,124,107,84,-0.137096774,-0.214953271,-0.322580645,477,490,555,13,65,78
s70211a,s,"Abrasion, right hip, initial encounter",Injury or poisoning,25,31,27,0.24,-0.129032258,0.08,979,851,932,-128,81,-47
s70212a,s,"Abrasion, left hip, initial encounter",Injury or poisoning,22,25,40,0.136363636,0.6,0.818181818,1036,951,780,-85,-171,-256
s70311a,s,"Abrasion, right thigh, initial encounter",Injury or poisoning,33,23,38,-0.303030303,0.652173913,0.151515152,854,993,794,139,-199,-60
s70312a,s,"Abrasion, left thigh, initial encounter",Injury or poisoning,36,26,46,-0.277777778,0.769230769,0.277777778,820,935,726,115,-209,-94
s71102a,s,"Unspecified open wound, left thigh, initial encounter",Injury or poisoning,11,13,13,0.181818182,0,0.181818182,1268,1211,1205,-57,-6,-63
s71111a,s,"Laceration without foreign body, right thigh, initial encounter",Injury or poisoning,34,37,51,0.088235294,0.378378378,0.5,840,793,686,-47,-107,-154
s71111d,s,"Laceration without foreign body, right thigh, subsequent encounter",Injury or poisoning,16,19,34,0.1875,0.789473684,1.125,1152,1075,836,-77,-239,-316
s71112a,s,"Laceration without foreign body, left thigh, initial encounter",Injury or poisoning,36,39,42,0.083333333,0.076923077,0.166666667,820,770,762,-50,-8,-58
s71112d,s,"Laceration without foreign body, left thigh, subsequent encounter",Injury or poisoning,17,12,23,-0.294117647,0.916666667,0.352941176,1129,1236,995,107,-241,-134
s71131a,s,"Puncture wound without foreign body, right thigh, initial encounter",Injury or poisoning,20,18,29,-0.1,0.611111111,0.45,1066,1093,899,27,-194,-167
s71132a,s,"Puncture wound without foreign body, left thigh, initial encounter",Injury or poisoning,12,33,27,1.75,-0.181818182,1.25,1243,827,925,-416,98,-318
s72001a,s,"Fracture of unspecified part of neck of right femur, initial encounter for closed fracture",Injury or poisoning,508,514,489,0.011811024,-0.048638132,-0.037401575,237,227,239,-10,12,2
s72001d,s,"Fracture of unspecified part of neck of right femur, subsequent encounter for closed fracture with routine healing",Injury or poisoning,128,159,114,0.2421875,-0.283018868,-0.109375,471,415,484,-56,69,13
s72002a,s,"Fracture of unspecified part of neck of left femur, initial encounter for closed fracture",Injury or poisoning,513,548,581,0.068226121,0.060218978,0.132553606,235,217,217,-18,0,-18
s72002d,s,"Fracture of unspecified part of neck of left femur, subsequent encounter for closed fracture with routine healing",Injury or poisoning,127,160,132,0.25984252,-0.175,0.039370079,470,413,447,-57,34,-23
s72009a,s,"Fracture of unspecified part of neck of unspecified femur, initial encounter for closed fracture",Injury or poisoning,71,44,56,-0.38028169,0.272727273,-0.211267606,599,722,654,123,-68,55
s72011a,s,"Unspecified intracapsular fracture of right femur, initial encounter for closed fracture",Injury or poisoning,273,330,286,0.208791209,-0.133333333,0.047619048,335,282,316,-53,34,-19
s72011d,s,"Unspecified intracapsular fracture of right femur, subsequent encounter for closed fracture with routine healing",Injury or poisoning,63,54,39,-0.142857143,-0.277777778,-0.380952381,630,649,775,19,126,145
s72012a,s,"Unspecified intracapsular fracture of left femur, initial encounter for closed fracture",Injury or poisoning,290,306,288,0.055172414,-0.058823529,-0.006896552,322,298,314,-24,16,-8
s72012d,s,"Unspecified intracapsular fracture of left femur, subsequent encounter for closed fracture with routine healing",Injury or poisoning,51,55,43,0.078431373,-0.218181818,-0.156862745,699,644,746,-55,102,47
s72031a,s,"Displaced midcervical fracture of right femur, initial encounter for closed fracture",Injury or poisoning,48,50,48,0.041666667,-0.04,0,715,664,704,-51,40,-11
s72032a,s,"Displaced midcervical fracture of left femur, initial encounter for closed fracture",Injury or poisoning,36,40,43,0.111111111,0.075,0.194444444,810,752,745,-58,-7,-65
s72041a,s,"Displaced fracture of base of neck of right femur, initial encounter for closed fracture",Injury or poisoning,22,32,35,0.454545455,0.09375,0.590909091,1021,827,812,-194,-15,-209
s72042a,s,"Displaced fracture of base of neck of left femur, initial encounter for closed fracture",Injury or poisoning,20,23,27,0.15,0.173913043,0.35,1054,977,913,-77,-64,-141
s72051a,s,"Unspecified fracture of head of right femur, initial encounter for closed fracture",Injury or poisoning,14,17,15,0.214285714,-0.117647059,0.071428571,1183,1109,1134,-74,25,-49
s72052a,s,"Unspecified fracture of head of left femur, initial encounter for closed fracture",Injury or poisoning,10,13,15,0.3,0.153846154,0.5,1269,1192,1134,-77,-58,-135
s72091a,s,"Other fracture of head and neck of right femur, initial encounter for closed fracture",Injury or poisoning,32,38,32,0.1875,-0.157894737,0,852,767,850,-85,83,-2
s72092a,s,"Other fracture of head and neck of left femur, initial encounter for closed fracture",Injury or poisoning,25,37,22,0.48,-0.405405405,-0.12,963,780,999,-183,219,36
s72111a,s,"Displaced fracture of greater trochanter of right femur, initial encounter for closed fracture",Injury or poisoning,59,77,52,0.305084746,-0.324675325,-0.118644068,651,551,672,-100,121,21
s72111d,s,"Displaced fracture of greater trochanter of right femur, subsequent encounter for closed fracture with routine healing",Injury or poisoning,16,14,11,-0.125,-0.214285714,-0.3125,1133,1171,1232,38,61,99
s72112a,s,"Displaced fracture of greater trochanter of left femur, initial encounter for closed fracture",Injury or poisoning,59,47,55,-0.203389831,0.170212766,-0.06779661,651,690,654,39,-36,3
s72114a,s,"Nondisplaced fracture of greater trochanter of right femur, initial encounter for closed fracture",Injury or poisoning,21,15,18,-0.285714286,0.2,-0.142857143,1032,1143,1072,111,-71,40
s72115a,s,"Nondisplaced fracture of greater trochanter of left femur, initial encounter for closed fracture",Injury or poisoning,18,25,17,0.388888889,-0.32,-0.055555556,1093,931,1094,-162,163,1
s72122a,s,"Displaced fracture of lesser trochanter of left femur, initial encounter for closed fracture",Injury or poisoning,13,17,16,0.307692308,-0.058823529,0.230769231,1204,1104,1108,-100,4,-96
s72141a,s,"Displaced intertrochanteric fracture of right femur, initial encounter for closed fracture",Injury or poisoning,652,749,684,0.148773006,-0.086782377,0.049079755,207,184,198,-23,14,-9
s72141d,s,"Displaced intertrochanteric fracture of right femur, subsequent encounter for closed fracture with routine healing",Injury or poisoning,147,182,135,0.238095238,-0.258241758,-0.081632653,443,385,439,-58,54,-4
s72142a,s,"Displaced intertrochanteric fracture of left femur, initial encounter for closed fracture",Injury or poisoning,718,825,642,0.14902507,-0.221818182,-0.105849582,198,172,202,-26,30,4
s72142d,s,"Displaced intertrochanteric fracture of left femur, subsequent encounter for closed fracture with routine healing",Injury or poisoning,149,199,146,0.33557047,-0.266331658,-0.020134228,440,371,423,-69,52,-17
s72144a,s,"Nondisplaced intertrochanteric fracture of right femur, initial encounter for closed fracture",Injury or poisoning,59,63,61,0.06779661,-0.031746032,0.033898305,647,602,623,-45,21,-24
s72145a,s,"Nondisplaced intertrochanteric fracture of left femur, initial encounter for closed fracture",Injury or poisoning,54,59,50,0.092592593,-0.152542373,-0.074074074,669,618,679,-51,61,10
s72145d,s,"Nondisplaced intertrochanteric fracture of left femur, subsequent encounter for closed fracture with routine healing",Injury or poisoning,11,22,12,1,-0.454545455,0.090909091,1234,984,1197,-250,213,-37
s7221xa,s,"Displaced subtrochanteric fracture of right femur, initial encounter for closed fracture",Injury or poisoning,96,99,123,0.03125,0.242424242,0.28125,522,494,455,-28,-39,-67
s7221xd,s,"Displaced subtrochanteric fracture of right femur, subsequent encounter for closed fracture with routine healing",Injury or poisoning,17,11,28,-0.352941176,1.545454545,0.647058824,1102,1224,891,122,-333,-211
s7222xa,s,"Displaced subtrochanteric fracture of left femur, initial encounter for closed fracture",Injury or poisoning,120,94,109,-0.216666667,0.159574468,-0.091666667,475,503,485,28,-18,10
s7222xd,s,"Displaced subtrochanteric fracture of left femur, subsequent encounter for closed fracture with routine healing",Injury or poisoning,19,20,12,0.052631579,-0.4,-0.368421053,1059,1024,1194,-35,170,135
s72301a,s,"Unspecified fracture of shaft of right femur, initial encounter for closed fracture",Injury or poisoning,60,63,73,0.05,0.158730159,0.216666667,636,600,576,-36,-24,-60
s72302a,s,"Unspecified fracture of shaft of left femur, initial encounter for closed fracture",Injury or poisoning,46,50,54,0.086956522,0.08,0.173913043,716,654,651,-62,-3,-65
s72302d,s,"Unspecified fracture of shaft of left femur, subsequent encounter for closed fracture with routine healing",Injury or poisoning,10,11,11,0.1,0,0.1,1248,1220,1215,-28,-5,-33
s72322a,s,"Displaced transverse fracture of shaft of left femur, initial encounter for closed fracture",Injury or poisoning,19,15,14,-0.210526316,-0.066666667,-0.263157895,1057,1129,1139,72,10,82
s72331a,s,"Displaced oblique fracture of shaft of right femur, initial encounter for closed fracture",Injury or poisoning,18,16,25,-0.111111111,0.5625,0.388888889,1081,1112,932,31,-180,-149
s72332a,s,"Displaced oblique fracture of shaft of left femur, initial encounter for closed fracture",Injury or poisoning,20,19,13,-0.05,-0.315789474,-0.35,1039,1043,1164,4,121,125
s72341a,s,"Displaced spiral fracture of shaft of right femur, initial encounter for closed fracture",Injury or poisoning,23,21,19,-0.086956522,-0.095238095,-0.173913043,985,1002,1039,17,37,54
s72342a,s,"Displaced spiral fracture of shaft of left femur, initial encounter for closed fracture",Injury or poisoning,21,25,18,0.19047619,-0.28,-0.142857143,1021,921,1059,-100,138,38
s72351a,s,"Displaced comminuted fracture of shaft of right femur, initial encounter for closed fracture",Injury or poisoning,42,52,61,0.238095238,0.173076923,0.452380952,744,646,620,-98,-26,-124
s72352a,s,"Displaced comminuted fracture of shaft of left femur, initial encounter for closed fracture",Injury or poisoning,33,34,53,0.03030303,0.558823529,0.606060606,827,787,654,-40,-133,-173
s72401a,s,"Unspecified fracture of lower end of right femur, initial encounter for closed fracture",Injury or poisoning,59,68,79,0.152542373,0.161764706,0.338983051,644,580,556,-64,-24,-88
s72401d,s,"Unspecified fracture of lower end of right femur, subsequent encounter for closed fracture with routine healing",Injury or poisoning,19,27,20,0.421052632,-0.259259259,0.052631579,1051,884,1015,-167,131,-36
s72402a,s,"Unspecified fracture of lower end of left femur, initial encounter for closed fracture",Injury or poisoning,60,76,70,0.266666667,-0.078947368,0.166666667,636,550,588,-86,38,-48
s72402d,s,"Unspecified fracture of lower end of left femur, subsequent encounter for closed fracture with routine healing",Injury or poisoning,16,18,24,0.125,0.333333333,0.5,1108,1054,949,-54,-105,-159
s72451a,s,"Displaced supracondylar fracture without intracondylar extension of lower end of right femur, initial encounter for closed fracture",Injury or poisoning,43,26,36,-0.395348837,0.384615385,-0.162790698,738,901,780,163,-121,42
s72452a,s,"Displaced supracondylar fracture without intracondylar extension of lower end of left femur, initial encounter for closed fracture",Injury or poisoning,27,38,23,0.407407407,-0.394736842,-0.148148148,911,752,959,-159,207,48
s72491a,s,"Other fracture of lower end of right femur, initial encounter for closed fracture",Injury or poisoning,19,20,27,0.052631579,0.35,0.421052632,1048,1013,894,-35,-119,-154
s72492a,s,"Other fracture of lower end of left femur, initial encounter for closed fracture",Injury or poisoning,26,25,18,-0.038461538,-0.28,-0.307692308,924,914,1050,-10,136,126
s7290xa,s,"Unspecified fracture of unspecified femur, initial encounter for closed fracture",Injury or poisoning,25,18,19,-0.28,0.055555556,-0.24,944,1050,1030,106,-20,86
s7291xa,s,"Unspecified fracture of right femur, initial encounter for closed fracture",Injury or poisoning,55,49,52,-0.109090909,0.06122449,-0.054545455,659,658,658,-1,0,-1
s7291xd,s,"Unspecified fracture of right femur, subsequent encounter for closed fracture with routine healing",Injury or poisoning,30,31,33,0.033333333,0.064516129,0.1,860,816,819,-44,3,-41
s7292xa,s,"Unspecified fracture of left femur, initial encounter for closed fracture",Injury or poisoning,52,36,46,-0.307692308,0.277777778,-0.115384615,676,768,700,92,-68,24
s7292xd,s,"Unspecified fracture of left femur, subsequent encounter for closed fracture with routine healing",Injury or poisoning,33,31,34,-0.060606061,0.096774194,0.03030303,822,815,804,-7,-11,-18
s73004a,s,"Unspecified dislocation of right hip, initial encounter",Injury or poisoning,14,15,15,0.071428571,0,0.071428571,1144,1110,1098,-34,-12,-46
s73014a,s,"Posterior dislocation of right hip, initial encounter",Injury or poisoning,15,20,25,0.333333333,0.25,0.666666667,1116,1008,922,-108,-86,-194
s73015a,s,"Posterior dislocation of left hip, initial encounter",Injury or poisoning,12,20,10,0.666666667,-0.5,-0.166666667,1187,1008,1212,-179,204,25
s76111a,s,"Strain of right quadriceps muscle, fascia and tendon, initial encounter",Injury or poisoning,29,31,33,0.068965517,0.064516129,0.137931034,877,815,817,-62,2,-60
s76112a,s,"Strain of left quadriceps muscle, fascia and tendon, initial encounter",Injury or poisoning,34,32,21,-0.058823529,-0.34375,-0.382352941,810,806,984,-4,178,174
s8001xa,s,"Contusion of right knee, initial encounter",Injury or poisoning,203,180,151,-0.113300493,-0.161111111,-0.256157635,379,384,418,5,34,39
s8001xd,s,"Contusion of right knee, subsequent encounter",Injury or poisoning,13,16,11,0.230769231,-0.3125,-0.153846154,1167,1089,1190,-78,101,23
s8002xa,s,"Contusion of left knee, initial encounter",Injury or poisoning,216,174,153,-0.194444444,-0.120689655,-0.291666667,369,388,412,19,24,43
s8002xd,s,"Contusion of left knee, subsequent encounter",Injury or poisoning,15,18,14,0.2,-0.222222222,-0.066666667,1112,1040,1115,-72,75,3
s8011xa,s,"Contusion of right lower leg, initial encounter",Injury or poisoning,176,123,129,-0.301136364,0.048780488,-0.267045455,399,454,442,55,-12,43
s8011xd,s,"Contusion of right lower leg, subsequent encounter",Injury or poisoning,19,20,14,0.052631579,-0.3,-0.263157895,1037,1003,1114,-34,111,77
s8012xa,s,"Contusion of left lower leg, initial encounter",Injury or poisoning,158,134,153,-0.151898734,0.141791045,-0.03164557,420,438,412,18,-26,-8
s8012xd,s,"Contusion of left lower leg, subsequent encounter",Injury or poisoning,21,21,10,0,-0.523809524,-0.523809524,1003,983,1203,-20,220,200
s80211a,s,"Abrasion, right knee, initial encounter",Injury or poisoning,352,327,391,-0.071022727,0.195718654,0.110795455,278,281,265,3,-16,-13
s80211d,s,"Abrasion, right knee, subsequent encounter",Injury or poisoning,27,26,34,-0.037037037,0.307692308,0.259259259,900,889,799,-11,-90,-101
s80212a,s,"Abrasion, left knee, initial encounter",Injury or poisoning,357,348,383,-0.025210084,0.100574713,0.072829132,276,272,267,-4,-5,-9
s80212d,s,"Abrasion, left knee, subsequent encounter",Injury or poisoning,24,26,33,0.083333333,0.269230769,0.375,949,888,810,-61,-78,-139
s80811a,s,"Abrasion, right lower leg, initial encounter",Injury or poisoning,138,120,140,-0.130434783,0.166666667,0.014492754,446,454,421,8,-33,-25
s80811d,s,"Abrasion, right lower leg, subsequent encounter",Injury or poisoning,23,20,19,-0.130434783,-0.05,-0.173913043,962,996,1014,34,18,52
s80812a,s,"Abrasion, left lower leg, initial encounter",Injury or poisoning,140,127,145,-0.092857143,0.141732283,0.035714286,442,445,418,3,-27,-24
s80812d,s,"Abrasion, left lower leg, subsequent encounter",Injury or poisoning,24,22,24,-0.083333333,0.090909091,0,947,955,931,8,-24,-16
s80822a,s,"Blister (nonthermal), left lower leg, initial encounter",Injury or poisoning,20,12,12,-0.4,0,-0.4,1010,1158,1154,148,-4,144
s81002a,s,"Unspecified open wound, left knee, initial encounter",Injury or poisoning,12,11,14,-0.083333333,0.272727273,0.166666667,1168,1178,1105,10,-73,-63
s81011a,s,"Laceration without foreign body, right knee, initial encounter",Injury or poisoning,93,78,81,-0.161290323,0.038461538,-0.129032258,518,533,540,15,7,22
s81012a,s,"Laceration without foreign body, left knee, initial encounter",Injury or poisoning,78,68,77,-0.128205128,0.132352941,-0.012820513,562,570,554,8,-16,-8
s81801a,s,"Unspecified open wound, right lower leg, initial encounter",Injury or poisoning,90,63,72,-0.3,0.142857143,-0.2,528,588,566,60,-22,38
s81801d,s,"Unspecified open wound, right lower leg, subsequent encounter",Injury or poisoning,33,29,23,-0.121212121,-0.206896552,-0.303030303,810,831,938,21,107,128
s81802a,s,"Unspecified open wound, left lower leg, initial encounter",Injury or poisoning,88,71,76,-0.193181818,0.070422535,-0.136363636,531,559,556,28,-3,25
s81802d,s,"Unspecified open wound, left lower leg, subsequent encounter",Injury or poisoning,27,33,23,0.222222222,-0.303030303,-0.148148148,892,783,937,-109,154,45
s81811a,s,"Laceration without foreign body, right lower leg, initial encounter",Injury or poisoning,139,94,152,-0.323741007,0.617021277,0.09352518,444,495,412,51,-83,-32
s81811d,s,"Laceration without foreign body, right lower leg, subsequent encounter",Injury or poisoning,24,31,20,0.291666667,-0.35483871,-0.166666667,940,800,985,-140,185,45
s81812a,s,"Laceration without foreign body, left lower leg, initial encounter",Injury or poisoning,146,111,144,-0.239726027,0.297297297,-0.01369863,435,466,417,31,-49,-18
s81812d,s,"Laceration without foreign body, left lower leg, subsequent encounter",Injury or poisoning,22,34,23,0.545454545,-0.323529412,0.045454545,971,768,935,-203,167,-36
s81831a,s,"Puncture wound without foreign body, right lower leg, initial encounter",Injury or poisoning,10,21,19,1.1,-0.095238095,0.9,1195,966,1002,-229,36,-193
s81832a,s,"Puncture wound without foreign body, left lower leg, initial encounter",Injury or poisoning,12,17,19,0.416666667,0.117647059,0.583333333,1158,1044,1002,-114,-42,-156
s81851a,s,"Open bite, right lower leg, initial encounter",Injury or poisoning,30,27,21,-0.1,-0.222222222,-0.3,842,858,964,16,106,122
s81852a,s,"Open bite, left lower leg, initial encounter",Injury or poisoning,28,25,20,-0.107142857,-0.2,-0.285714286,872,887,982,15,95,110
s82001a,s,"Unspecified fracture of right patella, initial encounter for closed fracture",Injury or poisoning,39,39,45,0,0.153846154,0.153846154,752,729,693,-23,-36,-59
s82001d,s,"Unspecified fracture of right patella, subsequent encounter for closed fracture with routine healing",Injury or poisoning,26,14,27,-0.461538462,0.928571429,0.038461538,898,1099,872,201,-227,-26
s82002a,s,"Unspecified fracture of left patella, initial encounter for closed fracture",Injury or poisoning,46,43,45,-0.065217391,0.046511628,-0.02173913,698,693,693,-5,0,-5
s82002d,s,"Unspecified fracture of left patella, subsequent encounter for closed fracture with routine healing",Injury or poisoning,34,23,24,-0.323529412,0.043478261,-0.294117647,794,923,922,129,-1,128
s82032a,s,"Displaced transverse fracture of left patella, initial encounter for closed fracture",Injury or poisoning,11,14,10,0.272727273,-0.285714286,-0.090909091,1168,1097,1175,-71,78,7
s82041a,s,"Displaced comminuted fracture of right patella, initial encounter for closed fracture",Injury or poisoning,18,17,22,-0.055555556,0.294117647,0.222222222,1031,1039,947,8,-92,-84
s82042a,s,"Displaced comminuted fracture of left patella, initial encounter for closed fracture",Injury or poisoning,23,16,25,-0.304347826,0.5625,0.086956522,945,1057,902,112,-155,-43
s82101a,s,"Unspecified fracture of upper end of right tibia, initial encounter for closed fracture",Injury or poisoning,24,17,19,-0.291666667,0.117647059,-0.208333333,933,1039,994,106,-45,61
s82102a,s,"Unspecified fracture of upper end of left tibia, initial encounter for closed fracture",Injury or poisoning,22,19,26,-0.136363636,0.368421053,0.181818182,963,994,885,31,-109,-78
s82141a,s,"Displaced bicondylar fracture of right tibia, initial encounter for closed fracture",Injury or poisoning,177,171,139,-0.033898305,-0.187134503,-0.214689266,395,387,418,-8,31,23
s82141d,s,"Displaced bicondylar fracture of right tibia, subsequent encounter for closed fracture with routine healing",Injury or poisoning,45,53,40,0.177777778,-0.245283019,-0.111111111,707,625,732,-82,107,25
s82142a,s,"Displaced bicondylar fracture of left tibia, initial encounter for closed fracture",Injury or poisoning,193,148,175,-0.233160622,0.182432432,-0.093264249,383,419,387,36,-32,4
s82142d,s,"Displaced bicondylar fracture of left tibia, subsequent encounter for closed fracture with routine healing",Injury or poisoning,46,38,36,-0.173913043,-0.052631579,-0.217391304,696,732,759,36,27,63
s82144a,s,"Nondisplaced bicondylar fracture of right tibia, initial encounter for closed fracture",Injury or poisoning,17,13,13,-0.235294118,0,-0.235294118,1038,1104,1102,66,-2,64
s82145a,s,"Nondisplaced bicondylar fracture of left tibia, initial encounter for closed fracture",Injury or poisoning,16,13,12,-0.1875,-0.076923077,-0.25,1057,1104,1126,47,22,69
s82201a,s,"Unspecified fracture of shaft of right tibia, initial encounter for closed fracture",Injury or poisoning,66,74,65,0.121212121,-0.121621622,-0.015151515,592,541,585,-51,44,-7
s82201b,s,"Unspecified fracture of shaft of right tibia, initial encounter for open fracture type I or II",Injury or poisoning,23,34,23,0.47826087,-0.323529412,0,939,761,924,-178,163,-15
s82201d,s,"Unspecified fracture of shaft of right tibia, subsequent encounter for closed fracture with routine healing",Injury or poisoning,19,19,21,0,0.105263158,0.105263158,1001,988,951,-13,-37,-50
s82202a,s,"Unspecified fracture of shaft of left tibia, initial encounter for closed fracture",Injury or poisoning,50,58,50,0.16,-0.137931034,0,671,600,653,-71,53,-18
s82202b,s,"Unspecified fracture of shaft of left tibia, initial encounter for open fracture type I or II",Injury or poisoning,30,31,30,0.033333333,-0.032258065,0,833,789,834,-44,45,1
s82202d,s,"Unspecified fracture of shaft of left tibia, subsequent encounter for closed fracture with routine healing",Injury or poisoning,21,25,35,0.19047619,0.4,0.666666667,968,877,771,-91,-106,-197
s82209a,s,"Unspecified fracture of shaft of unspecified tibia, initial encounter for closed fracture",Injury or poisoning,14,18,20,0.285714286,0.111111111,0.428571429,1093,1001,965,-92,-36,-128
s82251a,s,"Displaced comminuted fracture of shaft of right tibia, initial encounter for closed fracture",Injury or poisoning,34,42,36,0.235294118,-0.142857143,0.058823529,788,696,757,-92,61,-31
s82252a,s,"Displaced comminuted fracture of shaft of left tibia, initial encounter for closed fracture",Injury or poisoning,33,35,23,0.060606061,-0.342857143,-0.303030303,797,750,920,-47,170,123
s82252b,s,"Displaced comminuted fracture of shaft of left tibia, initial encounter for open fracture type I or II",Injury or poisoning,10,11,16,0.1,0.454545455,0.6,1168,1140,1029,-28,-111,-139
s82301a,s,"Unspecified fracture of lower end of right tibia, initial encounter for closed fracture",Injury or poisoning,34,28,36,-0.176470588,0.285714286,0.058823529,788,826,757,38,-69,-31
s82302a,s,"Unspecified fracture of lower end of left tibia, initial encounter for closed fracture",Injury or poisoning,25,27,27,0.08,0,0.08,905,845,861,-60,16,-44
s82391a,s,"Other fracture of lower end of right tibia, initial encounter for closed fracture",Injury or poisoning,17,13,21,-0.235294118,0.615384615,0.235294118,1028,1093,944,65,-149,-84
s82392a,s,"Other fracture of lower end of left tibia, initial encounter for closed fracture",Injury or poisoning,14,11,10,-0.214285714,-0.090909091,-0.285714286,1088,1137,1152,49,15,64
s82401a,s,"Unspecified fracture of shaft of right fibula, initial encounter for closed fracture",Injury or poisoning,72,51,62,-0.291666667,0.215686275,-0.138888889,573,628,599,55,-29,26
s82401b,s,"Unspecified fracture of shaft of right fibula, initial encounter for open fracture type I or II",Injury or poisoning,19,28,24,0.473684211,-0.142857143,0.263157895,993,825,908,-168,83,-85
s82401d,s,"Unspecified fracture of shaft of right fibula, subsequent encounter for closed fracture with routine healing",Injury or poisoning,29,33,25,0.137931034,-0.242424242,-0.137931034,846,768,889,-78,121,43
s82402a,s,"Unspecified fracture of shaft of left fibula, initial encounter for closed fracture",Injury or poisoning,60,50,64,-0.166666667,0.28,0.066666667,618,631,588,13,-43,-30
s82402b,s,"Unspecified fracture of shaft of left fibula, initial encounter for open fracture type I or II",Injury or poisoning,20,23,26,0.15,0.130434783,0.3,975,906,872,-69,-34,-103
s82402d,s,"Unspecified fracture of shaft of left fibula, subsequent encounter for closed fracture with routine healing",Injury or poisoning,28,30,29,0.071428571,-0.033333333,0.035714286,856,798,834,-58,36,-22
s82431a,s,"Displaced oblique fracture of shaft of right fibula, initial encounter for closed fracture",Injury or poisoning,11,11,21,0,0.909090909,0.909090909,1139,1131,938,-8,-193,-201
s82451a,s,"Displaced comminuted fracture of shaft of right fibula, initial encounter for closed fracture",Injury or poisoning,33,43,35,0.303030303,-0.186046512,0.060606061,794,686,767,-108,81,-27
s82451b,s,"Displaced comminuted fracture of shaft of right fibula, initial encounter for open fracture type I or II",Injury or poisoning,16,13,18,-0.1875,0.384615385,0.125,1039,1086,984,47,-102,-55
s82452a,s,"Displaced comminuted fracture of shaft of left fibula, initial encounter for closed fracture",Injury or poisoning,40,42,44,0.05,0.047619048,0.1,728,693,694,-35,1,-34
s82452b,s,"Displaced comminuted fracture of shaft of left fibula, initial encounter for open fracture type I or II",Injury or poisoning,12,10,10,-0.166666667,0,-0.166666667,1120,1147,1142,27,-5,22
s82491a,s,"Other fracture of shaft of right fibula, initial encounter for closed fracture",Injury or poisoning,17,18,20,0.058823529,0.111111111,0.176470588,1020,989,951,-31,-38,-69
s82492a,s,"Other fracture of shaft of left fibula, initial encounter for closed fracture",Injury or poisoning,12,11,21,-0.083333333,0.909090909,0.75,1119,1127,936,8,-191,-183
s8251xa,s,"Displaced fracture of medial malleolus of right tibia, initial encounter for closed fracture",Injury or poisoning,60,36,41,-0.4,0.138888889,-0.316666667,618,741,719,123,-22,101
s8252xa,s,"Displaced fracture of medial malleolus of left tibia, initial encounter for closed fracture",Injury or poisoning,34,39,29,0.147058824,-0.256410256,-0.147058824,784,718,831,-66,113,47
s8255xa,s,"Nondisplaced fracture of medial malleolus of left tibia, initial encounter for closed fracture",Injury or poisoning,14,13,10,-0.071428571,-0.230769231,-0.285714286,1076,1082,1138,6,56,62
s8261xa,s,"Displaced fracture of lateral malleolus of right fibula, initial encounter for closed fracture",Injury or poisoning,46,47,43,0.02173913,-0.085106383,-0.065217391,691,655,704,-36,49,13
s8262xa,s,"Displaced fracture of lateral malleolus of left fibula, initial encounter for closed fracture",Injury or poisoning,40,47,49,0.175,0.042553191,0.225,726,655,657,-71,2,-69
s8262xd,s,"Displaced fracture of lateral malleolus of left fibula, subsequent encounter for closed fracture with routine healing",Injury or poisoning,13,11,10,-0.153846154,-0.090909091,-0.230769231,1098,1122,1136,24,14,38
s8264xa,s,"Nondisplaced fracture of lateral malleolus of right fibula, initial encounter for closed fracture",Injury or poisoning,17,11,16,-0.352941176,0.454545455,-0.058823529,1016,1122,1010,106,-112,-6
s8265xa,s,"Nondisplaced fracture of lateral malleolus of left fibula, initial encounter for closed fracture",Injury or poisoning,17,10,11,-0.411764706,0.1,-0.352941176,1016,1138,1117,122,-21,101
s82831a,s,"Other fracture of upper and lower end of right fibula, initial encounter for closed fracture",Injury or poisoning,161,157,167,-0.02484472,0.063694268,0.037267081,411,406,394,-5,-12,-17
s82831b,s,"Other fracture of upper and lower end of right fibula, initial encounter for open fracture type I or II",Injury or poisoning,17,19,17,0.117647059,-0.105263158,0,1015,968,995,-47,27,-20
s82831d,s,"Other fracture of upper and lower end of right fibula, subsequent encounter for closed fracture with routine healing",Injury or poisoning,31,32,39,0.032258065,0.21875,0.258064516,807,769,725,-38,-44,-82
s82832a,s,"Other fracture of upper and lower end of left fibula, initial encounter for closed fracture",Injury or poisoning,140,138,143,-0.014285714,0.036231884,0.021428571,438,430,415,-8,-15,-23
s82832b,s,"Other fracture of upper and lower end of left fibula, initial encounter for open fracture type I or II",Injury or poisoning,15,13,13,-0.133333333,0,-0.133333333,1042,1076,1068,34,-8,26
s82832d,s,"Other fracture of upper and lower end of left fibula, subsequent encounter for closed fracture with routine healing",Injury or poisoning,30,27,32,-0.1,0.185185185,0.066666667,819,831,791,12,-40,-28
s82841a,s,"Displaced bimalleolar fracture of right lower leg, initial encounter for closed fracture",Injury or poisoning,106,88,110,-0.169811321,0.25,0.037735849,484,503,470,19,-33,-14
s82841b,s,"Displaced bimalleolar fracture of right lower leg, initial encounter for open fracture type I or II",Injury or poisoning,12,11,14,-0.083333333,0.272727273,0.166666667,1104,1115,1043,11,-72,-61
s82841d,s,"Displaced bimalleolar fracture of right lower leg, subsequent encounter for closed fracture with routine healing",Injury or poisoning,19,22,21,0.157894737,-0.045454545,0.105263158,978,910,927,-68,17,-51
s82842a,s,"Displaced bimalleolar fracture of left lower leg, initial encounter for closed fracture",Injury or poisoning,73,80,100,0.095890411,0.25,0.369863014,567,523,488,-44,-35,-79
s82842d,s,"Displaced bimalleolar fracture of left lower leg, subsequent encounter for closed fracture with routine healing",Injury or poisoning,11,15,17,0.363636364,0.133333333,0.545454545,1115,1033,989,-82,-44,-126
s82851a,s,"Displaced trimalleolar fracture of right lower leg, initial encounter for closed fracture",Injury or poisoning,120,102,123,-0.15,0.205882353,0.025,461,475,441,14,-34,-20
s82851b,s,"Displaced trimalleolar fracture of right lower leg, initial encounter for open fracture type I or II",Injury or poisoning,14,12,15,-0.142857143,0.25,0.071428571,1062,1091,1017,29,-74,-45
s82851d,s,"Displaced trimalleolar fracture of right lower leg, subsequent encounter for closed fracture with routine healing",Injury or poisoning,15,16,14,0.066666667,-0.125,-0.066666667,1037,1018,1038,-19,20,1
s82852a,s,"Displaced trimalleolar fracture of left lower leg, initial encounter for closed fracture",Injury or poisoning,93,88,92,-0.053763441,0.045454545,-0.010752688,510,502,508,-8,6,-2
s82852d,s,"Displaced trimalleolar fracture of left lower leg, subsequent encounter for closed fracture with routine healing",Injury or poisoning,15,23,13,0.533333333,-0.434782609,-0.133333333,1036,891,1058,-145,167,22
s82871a,s,"Displaced pilon fracture of right tibia, initial encounter for closed fracture",Injury or poisoning,47,34,43,-0.276595745,0.264705882,-0.085106383,678,744,697,66,-47,19
s82872a,s,"Displaced pilon fracture of left tibia, initial encounter for closed fracture",Injury or poisoning,44,25,36,-0.431818182,0.44,-0.181818182,696,853,743,157,-110,47
s82891a,s,"Other fracture of right lower leg, initial encounter for closed fracture",Injury or poisoning,42,46,39,0.095238095,-0.152173913,-0.071428571,706,657,719,-49,62,13
s82891d,s,"Other fracture of right lower leg, subsequent encounter for closed fracture with routine healing",Injury or poisoning,41,34,27,-0.170731707,-0.205882353,-0.341463415,710,743,841,33,98,131
s82892a,s,"Other fracture of left lower leg, initial encounter for closed fracture",Injury or poisoning,30,34,28,0.133333333,-0.176470588,-0.066666667,811,743,830,-68,87,19
s82892d,s,"Other fracture of left lower leg, subsequent encounter for closed fracture with routine healing",Injury or poisoning,28,18,31,-0.357142857,0.722222222,0.107142857,837,969,800,132,-169,-37
s83241a,s,"Other tear of medial meniscus, current injury, right knee, initial encounter",Injury or poisoning,10,13,12,0.3,-0.076923077,0.2,1121,1061,1074,-60,13,-47
s83242a,s,"Other tear of medial meniscus, current injury, left knee, initial encounter",Injury or poisoning,11,10,13,-0.090909091,0.3,0.181818182,1104,1115,1052,11,-63,-52
s83281a,s,"Other tear of lateral meniscus, current injury, right knee, initial encounter",Injury or poisoning,29,22,22,-0.24137931,0,-0.24137931,826,901,906,75,5,80
s83282a,s,"Other tear of lateral meniscus, current injury, left knee, initial encounter",Injury or poisoning,20,24,18,0.2,-0.25,-0.1,953,866,961,-87,95,8
s83411a,s,"Sprain of medial collateral ligament of right knee, initial encounter",Injury or poisoning,16,16,17,0,0.0625,0.0625,1013,1008,979,-5,-29,-34
s83511a,s,"Sprain of anterior cruciate ligament of right knee, initial encounter",Injury or poisoning,11,15,15,0.363636364,0,0.363636364,1101,1020,1007,-81,-13,-94
s8391xa,s,"Sprain of unspecified site of right knee, initial encounter",Injury or poisoning,15,12,20,-0.2,0.666666667,0.333333333,1027,1077,930,50,-147,-97
s8392xa,s,"Sprain of unspecified site of left knee, initial encounter",Injury or poisoning,14,17,25,0.214285714,0.470588235,0.785714286,1049,991,866,-58,-125,-183
s8991xa,s,"Unspecified injury of right lower leg, initial encounter",Injury or poisoning,20,20,11,0,-0.45,-0.45,953,936,1087,-17,151,134
s8992xa,s,"Unspecified injury of left lower leg, initial encounter",Injury or poisoning,28,24,18,-0.142857143,-0.25,-0.357142857,836,866,959,30,93,123
s9001xa,s,"Contusion of right ankle, initial encounter",Injury or poisoning,19,10,12,-0.473684211,0.2,-0.368421053,965,1107,1066,142,-41,101
s9002xa,s,"Contusion of left ankle, initial encounter",Injury or poisoning,20,18,20,-0.1,0.111111111,0,952,965,929,13,-36,-23
s9031xa,s,"Contusion of right foot, initial encounter",Injury or poisoning,36,34,25,-0.055555556,-0.264705882,-0.305555556,754,743,866,-11,123,112
s9032xa,s,"Contusion of left foot, initial encounter",Injury or poisoning,30,22,29,-0.266666667,0.318181818,-0.033333333,810,898,817,88,-81,7
s90511a,s,"Abrasion, right ankle, initial encounter",Injury or poisoning,26,19,26,-0.269230769,0.368421053,0,858,948,850,90,-98,-8
s90512a,s,"Abrasion, left ankle, initial encounter",Injury or poisoning,20,23,27,0.15,0.173913043,0.35,949,883,838,-66,-45,-111
s90811a,s,"Abrasion, right foot, initial encounter",Injury or poisoning,26,25,39,-0.038461538,0.56,0.5,858,849,719,-9,-130,-139
s90812a,s,"Abrasion, left foot, initial encounter",Injury or poisoning,26,16,31,-0.384615385,0.9375,0.192307692,858,999,799,141,-200,-59
s90821a,s,"Blister (nonthermal), right foot, initial encounter",Injury or poisoning,58,56,72,-0.034482759,0.285714286,0.24137931,623,601,555,-22,-46,-68
s90822a,s,"Blister (nonthermal), left foot, initial encounter",Injury or poisoning,71,63,65,-0.112676056,0.031746032,-0.084507042,568,576,578,8,2,10
s91001a,s,"Unspecified open wound, right ankle, initial encounter",Injury or poisoning,13,14,15,0.076923077,0.071428571,0.153846154,1059,1030,995,-29,-35,-64
s91002a,s,"Unspecified open wound, left ankle, initial encounter",Injury or poisoning,12,13,14,0.083333333,0.076923077,0.166666667,1073,1044,1014,-29,-30,-59
s91011a,s,"Laceration without foreign body, right ankle, initial encounter",Injury or poisoning,18,20,22,0.111111111,0.1,0.222222222,973,929,897,-44,-32,-76
s91012a,s,"Laceration without foreign body, left ankle, initial encounter",Injury or poisoning,14,17,29,0.214285714,0.705882353,1.071428571,1036,980,813,-56,-167,-223
s91301a,s,"Unspecified open wound, right foot, initial encounter",Injury or poisoning,48,41,41,-0.145833333,0,-0.145833333,671,688,708,17,20,37
s91301d,s,"Unspecified open wound, right foot, subsequent encounter",Injury or poisoning,12,13,10,0.083333333,-0.230769231,-0.166666667,1070,1041,1087,-29,46,17
s91302a,s,"Unspecified open wound, left foot, initial encounter",Injury or poisoning,53,39,36,-0.264150943,-0.076923077,-0.320754717,639,706,738,67,32,99
s91311a,s,"Laceration without foreign body, right foot, initial encounter",Injury or poisoning,32,25,42,-0.21875,0.68,0.3125,781,845,700,64,-145,-81
s91312a,s,"Laceration without foreign body, left foot, initial encounter",Injury or poisoning,27,35,38,0.296296296,0.085714286,0.407407407,842,731,721,-111,-10,-121
s91331a,s,"Puncture wound without foreign body, right foot, initial encounter",Injury or poisoning,34,26,63,-0.235294118,1.423076923,0.852941176,767,832,585,65,-247,-182
s91332a,s,"Puncture wound without foreign body, left foot, initial encounter",Injury or poisoning,44,18,19,-0.590909091,0.055555556,-0.568181818,692,952,928,260,-24,236
s92001a,s,"Unspecified fracture of right calcaneus, initial encounter for closed fracture",Injury or poisoning,40,34,50,-0.15,0.470588235,0.25,711,738,642,27,-96,-69
s92001d,s,"Unspecified fracture of right calcaneus, subsequent encounter for fracture with routine healing",Injury or poisoning,11,19,17,0.727272727,-0.105263158,0.545454545,1075,937,958,-138,21,-117
s92002a,s,"Unspecified fracture of left calcaneus, initial encounter for closed fracture",Injury or poisoning,29,32,34,0.103448276,0.0625,0.172413793,816,753,753,-63,0,-63
s92061a,s,"Displaced intraarticular fracture of right calcaneus, initial encounter for closed fracture",Injury or poisoning,18,10,18,-0.444444444,0.8,0,965,1084,940,119,-144,-25
s92062a,s,"Displaced intraarticular fracture of left calcaneus, initial encounter for closed fracture",Injury or poisoning,17,10,12,-0.411764706,0.2,-0.294117647,977,1084,1043,107,-41,66
s92101a,s,"Unspecified fracture of right talus, initial encounter for closed fracture",Injury or poisoning,16,12,12,-0.25,0,-0.25,990,1051,1043,61,-8,53
s92102a,s,"Unspecified fracture of left talus, initial encounter for closed fracture",Injury or poisoning,11,13,13,0.181818182,0,0.181818182,1071,1033,1022,-38,-11,-49
s92211a,s,"Displaced fracture of cuboid bone of right foot, initial encounter for closed fracture",Injury or poisoning,14,25,15,0.785714286,-0.4,0.071428571,1025,841,983,-184,142,-42
s92212a,s,"Displaced fracture of cuboid bone of left foot, initial encounter for closed fracture",Injury or poisoning,24,12,18,-0.5,0.5,-0.25,881,1049,940,168,-109,59
s92251a,s,"Displaced fracture of navicular [scaphoid] of right foot, initial encounter for closed fracture",Injury or poisoning,15,18,12,0.2,-0.333333333,-0.2,1002,948,1040,-54,92,38
s92252a,s,"Displaced fracture of navicular [scaphoid] of left foot, initial encounter for closed fracture",Injury or poisoning,12,10,14,-0.166666667,0.4,0.166666667,1057,1079,1000,22,-79,-57
s92311a,s,"Displaced fracture of first metatarsal bone, right foot, initial encounter for closed fracture",Injury or poisoning,14,23,20,0.642857143,-0.130434783,0.428571429,1023,872,912,-151,40,-111
s92312a,s,"Displaced fracture of first metatarsal bone, left foot, initial encounter for closed fracture",Injury or poisoning,15,13,11,-0.133333333,-0.153846154,-0.266666667,1002,1030,1054,28,24,52
s92321a,s,"Displaced fracture of second metatarsal bone, right foot, initial encounter for closed fracture",Injury or poisoning,53,39,43,-0.264150943,0.102564103,-0.188679245,639,706,693,67,-13,54
s92322a,s,"Displaced fracture of second metatarsal bone, left foot, initial encounter for closed fracture",Injury or poisoning,30,38,34,0.266666667,-0.105263158,0.133333333,801,710,752,-91,42,-49
s92331a,s,"Displaced fracture of third metatarsal bone, right foot, initial encounter for closed fracture",Injury or poisoning,41,38,45,-0.073170732,0.184210526,0.097560976,704,710,676,6,-34,-28
s92332a,s,"Displaced fracture of third metatarsal bone, left foot, initial encounter for closed fracture",Injury or poisoning,31,32,35,0.032258065,0.09375,0.129032258,787,750,742,-37,-8,-45
s92341a,s,"Displaced fracture of fourth metatarsal bone, right foot, initial encounter for closed fracture",Injury or poisoning,40,28,49,-0.3,0.75,0.225,709,793,647,84,-146,-62
s92342a,s,"Displaced fracture of fourth metatarsal bone, left foot, initial encounter for closed fracture",Injury or poisoning,30,31,31,0.033333333,0,0.033333333,798,755,785,-43,30,-13
s92351a,s,"Displaced fracture of fifth metatarsal bone, right foot, initial encounter for closed fracture",Injury or poisoning,56,38,49,-0.321428571,0.289473684,-0.125,625,710,647,85,-63,22
s92352a,s,"Displaced fracture of fifth metatarsal bone, left foot, initial encounter for closed fracture",Injury or poisoning,41,37,45,-0.097560976,0.216216216,0.097560976,703,718,674,15,-44,-29
s92352d,s,"Displaced fracture of fifth metatarsal bone, left foot, subsequent encounter for fracture with routine healing",Injury or poisoning,14,15,10,0.071428571,-0.333333333,-0.285714286,1014,986,1061,-28,75,47
s92354a,s,"Nondisplaced fracture of fifth metatarsal bone, right foot, initial encounter for closed fracture",Injury or poisoning,19,12,10,-0.368421053,-0.166666667,-0.473684211,939,1037,1061,98,24,122
s92411a,s,"Displaced fracture of proximal phalanx of right great toe, initial encounter for closed fracture",Injury or poisoning,12,12,13,0,0.083333333,0.083333333,1045,1037,1010,-8,-27,-35
s92412a,s,"Displaced fracture of proximal phalanx of left great toe, initial encounter for closed fracture",Injury or poisoning,14,11,14,-0.214285714,0.272727273,0,1013,1051,991,38,-60,-22
s92511a,s,"Displaced fracture of proximal phalanx of right lesser toe(s), initial encounter for closed fracture",Injury or poisoning,16,16,20,0,0.25,0.25,980,975,904,-5,-71,-76
s92512a,s,"Displaced fracture of proximal phalanx of left lesser toe(s), initial encounter for closed fracture",Injury or poisoning,15,16,12,0.066666667,-0.25,-0.2,992,975,1027,-17,52,35
s92911a,s,"Unspecified fracture of right toe(s), initial encounter for closed fracture",Injury or poisoning,15,13,11,-0.133333333,-0.153846154,-0.266666667,992,1019,1042,27,23,50
s9304xa,s,"Dislocation of right ankle joint, initial encounter",Injury or poisoning,38,25,40,-0.342105263,0.6,0.052631579,727,833,705,106,-128,-22
s9305xa,s,"Dislocation of left ankle joint, initial encounter",Injury or poisoning,26,25,21,-0.038461538,-0.16,-0.192307692,839,833,890,-6,57,51
s93401a,s,"Sprain of unspecified ligament of right ankle, initial encounter",Injury or poisoning,74,49,55,-0.337837838,0.12244898,-0.256756757,562,629,615,67,-14,53
s93401d,s,"Sprain of unspecified ligament of right ankle, subsequent encounter",Injury or poisoning,17,14,16,-0.176470588,0.142857143,-0.058823529,964,1002,952,38,-50,-12
s93402a,s,"Sprain of unspecified ligament of left ankle, initial encounter",Injury or poisoning,57,49,53,-0.140350877,0.081632653,-0.070175439,623,629,623,6,-6,0
s93402d,s,"Sprain of unspecified ligament of left ankle, subsequent encounter",Injury or poisoning,17,19,18,0.117647059,-0.052631579,0.058823529,963,922,926,-41,4,-37
s93431a,s,"Sprain of tibiofibular ligament of right ankle, initial encounter",Injury or poisoning,28,21,31,-0.25,0.476190476,0.107142857,814,891,780,77,-111,-34
s93432a,s,"Sprain of tibiofibular ligament of left ankle, initial encounter",Injury or poisoning,35,23,31,-0.342857143,0.347826087,-0.114285714,748,860,780,112,-80,32
s99911a,s,"Unspecified injury of right ankle, initial encounter",Injury or poisoning,10,18,14,0.8,-0.222222222,0.4,1055,932,982,-123,50,-73
s99921a,s,"Unspecified injury of right foot, initial encounter",Injury or poisoning,10,11,19,0.1,0.727272727,0.9,1055,1039,910,-16,-129,-145
s99922a,s,"Unspecified injury of left foot, initial encounter",Injury or poisoning,10,12,18,0.2,0.5,0.8,1055,1025,923,-30,-102,-132
t07xxxa,t,"Unspecified multiple injuries, initial encounter",Injury or poisoning,111,85,58,-0.234234234,-0.317647059,-0.477477477,476,508,600,32,92,124
t148xxa,t,"Other injury of unspecified body region, initial encounter",Injury or poisoning,159,118,148,-0.257861635,0.254237288,-0.06918239,414,452,412,38,-40,-2
t148xxd,t,"Other injury of unspecified body region, subsequent encounter",Injury or poisoning,45,41,103,-0.088888889,1.512195122,1.288888889,682,684,476,2,-208,-206
t148xxs,t,"Other injury of unspecified body region, sequela",Injury or poisoning,53,32,32,-0.396226415,0,-0.396226415,634,743,761,109,18,127
t1490xa,t,"Injury, unspecified, initial encounter",Injury or poisoning,121,95,81,-0.214876033,-0.147368421,-0.330578512,455,486,528,31,42,73
t1490xs,t,"Injury, unspecified, sequela",Injury or poisoning,24,23,25,-0.041666667,0.086956522,0.041666667,862,855,833,-7,-22,-29
t1491xa,t,"Suicide attempt, initial encounter",Injury or poisoning,125,110,102,-0.12,-0.072727273,-0.184,451,462,479,11,17,28
t1491xd,t,"Suicide attempt, subsequent encounter",Injury or poisoning,381,346,267,-0.091863517,-0.228323699,-0.299212598,267,272,327,5,55,60
t17590a,t,"Other foreign object in bronchus causing asphyxiation, initial encounter",Injury or poisoning,93,43,33,-0.537634409,-0.23255814,-0.64516129,505,668,748,163,80,243
t17890a,t,"Other foreign object in other parts of respiratory tract causing asphyxiation, initial encounter",Injury or poisoning,78,41,42,-0.474358974,0.024390244,-0.461538462,545,680,685,135,5,140
t17918a,t,"Gastric contents in respiratory tract, part unspecified causing other injury, initial encounter",Injury or poisoning,39,33,32,-0.153846154,-0.03030303,-0.179487179,707,729,756,22,27,49
t17920a,t,"Food in respiratory tract, part unspecified causing asphyxiation, initial encounter",Injury or poisoning,32,22,21,-0.3125,-0.045454545,-0.34375,759,861,875,102,14,116
t17928a,t,"Food in respiratory tract, part unspecified causing other injury, initial encounter",Injury or poisoning,10,15,15,0.5,0,0.5,1043,964,950,-79,-14,-93
t17990a,t,"Other foreign object in respiratory tract, part unspecified in causing asphyxiation, initial encounter",Injury or poisoning,66,27,19,-0.590909091,-0.296296296,-0.712121212,576,795,898,219,103,322
t18108a,t,"Unspecified foreign body in esophagus causing other injury, initial encounter",Injury or poisoning,10,13,13,0.3,0,0.3,1042,996,983,-46,-13,-59
t18128a,t,"Food in esophagus causing other injury, initial encounter",Injury or poisoning,52,53,77,0.019230769,0.452830189,0.480769231,634,609,539,-25,-70,-95
t18198a,t,"Other foreign object in esophagus causing other injury, initial encounter",Injury or poisoning,15,14,20,-0.066666667,0.428571429,0.333333333,970,982,885,12,-97,-85
t182xxa,t,"Foreign body in stomach, initial encounter",Injury or poisoning,43,61,59,0.418604651,-0.032786885,0.372093023,683,577,589,-106,12,-94
t183xxa,t,"Foreign body in small intestine, initial encounter",Injury or poisoning,35,23,28,-0.342857143,0.217391304,-0.2,735,847,791,112,-56,56
t184xxa,t,"Foreign body in colon, initial encounter",Injury or poisoning,14,28,28,1,0,1,985,776,791,-209,15,-194
t185xxa,t,"Foreign body in anus and rectum, initial encounter",Injury or poisoning,23,21,27,-0.086956522,0.285714286,0.173913043,861,873,799,12,-74,-62
t189xxa,t,"Foreign body of alimentary tract, part unspecified, initial encounter",Injury or poisoning,25,27,37,0.08,0.37037037,0.48,835,792,707,-43,-85,-128
t2024xa,t,"Burn of second degree of nose (septum), initial encounter",Injury or poisoning,18,22,16,0.222222222,-0.272727273,-0.111111111,931,855,926,-76,71,-5
t2026xa,t,"Burn of second degree of forehead and cheek, initial encounter",Injury or poisoning,25,30,17,0.2,-0.433333333,-0.32,835,752,916,-83,164,81
t2027xa,t,"Burn of second degree of neck, initial encounter",Injury or poisoning,13,20,23,0.538461538,0.15,0.769230769,997,885,845,-112,-40,-152
t2121xa,t,"Burn of second degree of chest wall, initial encounter",Injury or poisoning,27,33,22,0.222222222,-0.333333333,-0.185185185,810,727,858,-83,131,48
t2122xa,t,"Burn of second degree of abdominal wall, initial encounter",Injury or poisoning,36,34,32,-0.055555556,-0.058823529,-0.111111111,727,721,753,-6,32,26
t2123xa,t,"Burn of second degree of upper back, initial encounter",Injury or poisoning,18,19,20,0.055555556,0.052631579,0.111111111,928,896,877,-32,-19,-51
t2124xa,t,"Burn of second degree of lower back, initial encounter",Injury or poisoning,18,26,36,0.444444444,0.384615385,1,928,802,716,-126,-86,-212
t2125xa,t,"Burn of second degree of buttock, initial encounter",Injury or poisoning,26,20,39,-0.230769231,0.95,0.5,818,882,696,64,-186,-122
t2131xa,t,"Burn of third degree of chest wall, initial encounter",Injury or poisoning,20,18,21,-0.1,0.166666667,0.05,900,905,864,5,-41,-36
t2132xa,t,"Burn of third degree of abdominal wall, initial encounter",Injury or poisoning,27,21,26,-0.222222222,0.238095238,-0.037037037,809,867,805,58,-62,-4
t2133xa,t,"Burn of third degree of upper back, initial encounter",Injury or poisoning,18,16,23,-0.111111111,0.4375,0.277777778,925,938,841,13,-97,-84
t2134xa,t,"Burn of third degree of lower back, initial encounter",Injury or poisoning,23,21,27,-0.086956522,0.285714286,0.173913043,855,867,795,12,-72,-60
t2135xa,t,"Burn of third degree of buttock, initial encounter",Injury or poisoning,21,24,45,0.142857143,0.875,1.142857143,884,823,664,-61,-159,-220
t22211a,t,"Burn of second degree of right forearm, initial encounter",Injury or poisoning,40,36,41,-0.1,0.138888889,0.025,693,710,688,17,-22,-5
t22212a,t,"Burn of second degree of left forearm, initial encounter",Injury or poisoning,38,28,35,-0.263157895,0.25,-0.078947368,711,772,722,61,-50,11
t22231a,t,"Burn of second degree of right upper arm, initial encounter",Injury or poisoning,26,37,28,0.423076923,-0.243243243,0.076923077,815,706,784,-109,78,-31
t22232a,t,"Burn of second degree of left upper arm, initial encounter",Injury or poisoning,23,30,34,0.304347826,0.133333333,0.47826087,852,748,729,-104,-19,-123
t22311a,t,"Burn of third degree of right forearm, initial encounter",Injury or poisoning,43,22,42,-0.488372093,0.909090909,-0.023255814,683,846,682,163,-164,-1
t22312a,t,"Burn of third degree of left forearm, initial encounter",Injury or poisoning,27,26,31,-0.037037037,0.192307692,0.148148148,806,798,759,-8,-39,-47
t22331a,t,"Burn of third degree of right upper arm, initial encounter",Injury or poisoning,30,18,33,-0.4,0.833333333,0.1,773,896,737,123,-159,-36
t22332a,t,"Burn of third degree of left upper arm, initial encounter",Injury or poisoning,25,21,27,-0.16,0.285714286,0.08,825,860,787,35,-73,-38
t23201a,t,"Burn of second degree of right hand, unspecified site, initial encounter",Injury or poisoning,13,10,15,-0.230769231,0.5,0.153846154,979,1008,921,29,-87,-58
t23202a,t,"Burn of second degree of left hand, unspecified site, initial encounter",Injury or poisoning,14,12,19,-0.142857143,0.583333333,0.357142857,963,982,872,19,-110,-91
t23241a,t,"Burn of second degree of multiple right fingers (nail), including thumb, initial encounter",Injury or poisoning,11,12,13,0.090909091,0.083333333,0.181818182,999,982,953,-17,-29,-46
t23251a,t,"Burn of second degree of right palm, initial encounter",Injury or poisoning,10,17,20,0.7,0.176470588,1,1011,913,862,-98,-51,-149
t23252a,t,"Burn of second degree of left palm, initial encounter",Injury or poisoning,15,15,12,0,-0.2,-0.2,946,935,969,-11,34,23
t23261a,t,"Burn of second degree of back of right hand, initial encounter",Injury or poisoning,25,21,18,-0.16,-0.142857143,-0.28,825,860,882,35,22,57
t23351a,t,"Burn of third degree of right palm, initial encounter",Injury or poisoning,16,11,10,-0.3125,-0.090909091,-0.375,933,990,996,57,6,63
t23352a,t,"Burn of third degree of left palm, initial encounter",Injury or poisoning,12,15,11,0.25,-0.266666667,-0.083333333,987,934,982,-53,48,-5
t24211a,t,"Burn of second degree of right thigh, initial encounter",Injury or poisoning,29,29,32,0,0.103448276,0.103448276,784,757,745,-27,-12,-39
t24212a,t,"Burn of second degree of left thigh, initial encounter",Injury or poisoning,25,29,32,0.16,0.103448276,0.28,824,757,745,-67,-12,-79
t24231a,t,"Burn of second degree of right lower leg, initial encounter",Injury or poisoning,20,21,38,0.05,0.80952381,0.9,886,858,698,-28,-160,-188
t24232a,t,"Burn of second degree of left lower leg, initial encounter",Injury or poisoning,30,15,29,-0.5,0.933333333,-0.033333333,773,931,767,158,-164,-6
t24311a,t,"Burn of third degree of right thigh, initial encounter",Injury or poisoning,45,28,41,-0.377777778,0.464285714,-0.088888889,674,768,687,94,-81,13
t24312a,t,"Burn of third degree of left thigh, initial encounter",Injury or poisoning,26,28,25,0.076923077,-0.107142857,-0.038461538,809,768,803,-41,35,-6
t24322a,t,"Burn of third degree of left knee, initial encounter",Injury or poisoning,12,12,12,0,0,0,981,972,962,-9,-10,-19
t24331a,t,"Burn of third degree of right lower leg, initial encounter",Injury or poisoning,35,26,51,-0.257142857,0.961538462,0.457142857,730,794,625,64,-169,-105
t24332a,t,"Burn of third degree of left lower leg, initial encounter",Injury or poisoning,27,24,32,-0.111111111,0.333333333,0.185185185,801,813,742,12,-71,-59
t25021a,t,"Burn of unspecified degree of right foot, initial encounter",Injury or poisoning,17,10,22,-0.411764706,1.2,0.294117647,914,992,835,78,-157,-79
t25221a,t,"Burn of second degree of right foot, initial encounter",Injury or poisoning,35,24,50,-0.314285714,1.083333333,0.428571429,730,813,631,83,-182,-99
t25222a,t,"Burn of second degree of left foot, initial encounter",Injury or poisoning,31,29,44,-0.064516129,0.517241379,0.419354839,758,757,666,-1,-91,-92
t25321a,t,"Burn of third degree of right foot, initial encounter",Injury or poisoning,26,22,39,-0.153846154,0.772727273,0.5,805,837,689,32,-148,-116
t25322a,t,"Burn of third degree of left foot, initial encounter",Injury or poisoning,28,14,28,-0.5,1,0,787,941,770,154,-171,-17
t300,t,"Burn of unspecified body region, unspecified degree",Injury or poisoning,88,61,133,-0.306818182,1.180327869,0.511363636,516,577,424,61,-153,-92
t310,t,Burns involving less than 10% of body surface,Injury or poisoning,314,281,400,-0.105095541,0.423487544,0.27388535,301,306,258,5,-48,-43
t3110,t,Burns involving 10-19% of body surface with 0% to 9% third degree burns,Injury or poisoning,52,40,70,-0.230769231,0.75,0.346153846,632,685,557,53,-128,-75
t3111,t,Burns involving 10-19% of body surface with 10-19% third degree burns,Injury or poisoning,32,29,53,-0.09375,0.827586207,0.65625,745,754,612,9,-142,-133
t3120,t,Burns involving 20-29% of body surface with 0% to 9% third degree burns,Injury or poisoning,17,26,10,0.529411765,-0.615384615,-0.411764706,906,789,977,-117,188,71
t320,t,Corrosions involving less than 10% of body surface,Injury or poisoning,14,14,11,0,-0.214285714,-0.214285714,942,936,964,-6,28,22
t360x5a,t,"Adverse effect of penicillins, initial encounter",Injury or poisoning,228,224,191,-0.01754386,-0.147321429,-0.162280702,351,351,369,0,18,18
t361x5a,t,"Adverse effect of cephalosporins and other beta-lactam antibiotics, initial encounter",Injury or poisoning,275,289,237,0.050909091,-0.179930796,-0.138181818,326,304,342,-22,38,16
t363x5a,t,"Adverse effect of macrolides, initial encounter",Injury or poisoning,43,48,32,0.11627907,-0.333333333,-0.255813953,677,626,733,-51,107,56
t364x5a,t,"Adverse effect of tetracyclines, initial encounter",Injury or poisoning,47,31,39,-0.340425532,0.258064516,-0.170212766,655,729,683,74,-46,28
t367x5a,t,"Adverse effect of antifungal antibiotics, systemically used, initial encounter",Injury or poisoning,22,34,19,0.545454545,-0.441176471,-0.136363636,843,713,850,-130,137,7
t368x5a,t,"Adverse effect of other systemic antibiotics, initial encounter",Injury or poisoning,813,709,687,-0.127921279,-0.031029619,-0.15498155,179,194,196,15,2,17
t3695xa,t,"Adverse effect of unspecified systemic antibiotic, initial encounter",Injury or poisoning,248,269,243,0.084677419,-0.096654275,-0.02016129,337,311,337,-26,26,0
t373x5a,t,"Adverse effect of other antiprotozoal drugs, initial encounter",Injury or poisoning,22,23,26,0.045454545,0.130434783,0.181818182,841,815,774,-26,-41,-67
t375x5a,t,"Adverse effect of antiviral drugs, initial encounter",Injury or poisoning,46,54,69,0.173913043,0.277777778,0.5,658,597,555,-61,-42,-103
t375x6a,t,"Underdosing of antiviral drugs, initial encounter",Injury or poisoning,16,13,12,-0.1875,-0.076923077,-0.25,906,937,942,31,5,36
t378x5a,t,"Adverse effect of other specified systemic anti-infectives and antiparasitics, initial encounter",Injury or poisoning,53,73,53,0.377358491,-0.273972603,0,622,533,607,-89,74,-15
t380x5a,t,"Adverse effect of glucocorticoids and synthetic analogues, initial encounter",Injury or poisoning,3984,4093,5564,0.027359438,0.359394087,0.396586345,62,59,47,-3,-12,-15
t380x5d,t,"Adverse effect of glucocorticoids and synthetic analogues, subsequent encounter",Injury or poisoning,33,41,36,0.242424242,-0.12195122,0.090909091,729,668,694,-61,26,-35
t380x5s,t,"Adverse effect of glucocorticoids and synthetic analogues, sequela",Injury or poisoning,14,16,14,0.142857143,-0.125,0,929,899,905,-30,6,-24
t380x6a,t,"Underdosing of glucocorticoids and synthetic analogues, initial encounter",Injury or poisoning,14,13,13,-0.071428571,0,-0.071428571,929,933,921,4,-12,-8
t381x5a,t,"Adverse effect of thyroid hormones and substitutes, initial encounter",Injury or poisoning,23,20,18,-0.130434783,-0.1,-0.217391304,822,844,853,22,9,31
t381x6a,t,"Underdosing of thyroid hormones and substitutes, initial encounter",Injury or poisoning,34,28,28,-0.176470588,0,-0.176470588,723,752,756,29,4,33
t383x1a,t,"Poisoning by insulin and oral hypoglycemic [antidiabetic] drugs, accidental (unintentional), initial encounter",Injury or poisoning,46,40,40,-0.130434783,0,-0.130434783,656,676,676,20,0,20
t383x2a,t,"Poisoning by insulin and oral hypoglycemic [antidiabetic] drugs, intentional self-harm, initial encounter",Injury or poisoning,52,40,33,-0.230769231,-0.175,-0.365384615,626,676,717,50,41,91
t383x5a,t,"Adverse effect of insulin and oral hypoglycemic [antidiabetic] drugs, initial encounter",Injury or poisoning,216,185,185,-0.143518519,0,-0.143518519,360,373,373,13,0,13
t383x6a,t,"Underdosing of insulin and oral hypoglycemic [antidiabetic] drugs, initial encounter",Injury or poisoning,429,359,448,-0.163170163,0.247910864,0.044289044,244,266,241,22,-25,-3
t387x5a,t,"Adverse effect of androgens and anabolic congeners, initial encounter",Injury or poisoning,25,16,22,-0.36,0.375,-0.12,796,893,811,97,-82,15
t38895a,t,"Adverse effect of other hormones and synthetic substitutes, initial encounter",Injury or poisoning,23,14,14,-0.391304348,0,-0.391304348,816,916,898,100,-18,82
t39011a,t,"Poisoning by aspirin, accidental (unintentional), initial encounter",Injury or poisoning,12,12,15,0,0.25,0.25,945,937,882,-8,-55,-63
t39012a,t,"Poisoning by aspirin, intentional self-harm, initial encounter",Injury or poisoning,50,45,41,-0.1,-0.088888889,-0.18,633,637,671,4,34,38
t39015a,t,"Adverse effect of aspirin, initial encounter",Injury or poisoning,67,70,47,0.044776119,-0.328571429,-0.298507463,563,535,632,-28,97,69
t39016a,t,"Underdosing of aspirin, initial encounter",Injury or poisoning,23,22,11,-0.043478261,-0.5,-0.52173913,814,813,938,-1,125,124
t39092a,t,"Poisoning by salicylates, intentional self-harm, initial encounter",Injury or poisoning,14,10,10,-0.285714286,0,-0.285714286,918,955,949,37,-6,31
t391x1a,t,"Poisoning by 4-Aminophenol derivatives, accidental (unintentional), initial encounter",Injury or poisoning,80,77,73,-0.0375,-0.051948052,-0.0875,532,513,539,-19,26,7
t391x2a,t,"Poisoning by 4-Aminophenol derivatives, intentional self-harm, initial encounter",Injury or poisoning,267,240,257,-0.101123596,0.070833333,-0.037453184,326,333,328,7,-5,2
t391x2d,t,"Poisoning by 4-Aminophenol derivatives, intentional self-harm, subsequent encounter",Injury or poisoning,45,19,17,-0.577777778,-0.105263158,-0.622222222,655,845,854,190,9,199
t391x5a,t,"Adverse effect of 4-Aminophenol derivatives, initial encounter",Injury or poisoning,50,45,32,-0.1,-0.288888889,-0.36,630,634,718,4,84,88
t39312a,t,"Poisoning by propionic acid derivatives, intentional self-harm, initial encounter",Injury or poisoning,91,66,78,-0.274725275,0.181818182,-0.142857143,501,548,526,47,-22,25
t39312d,t,"Poisoning by propionic acid derivatives, intentional self-harm, subsequent encounter",Injury or poisoning,21,11,13,-0.476190476,0.181818182,-0.380952381,832,938,905,106,-33,73
t39315a,t,"Adverse effect of propionic acid derivatives, initial encounter",Injury or poisoning,121,106,99,-0.123966942,-0.066037736,-0.181818182,444,455,477,11,22,33
t39395a,t,"Adverse effect of other nonsteroidal anti-inflammatory drugs [NSAID], initial encounter",Injury or poisoning,425,344,332,-0.190588235,-0.034883721,-0.218823529,246,269,280,23,11,34
t398x5a,t,"Adverse effect of other nonopioid analgesics and antipyretics, not elsewhere classified, initial encounter",Injury or poisoning,37,25,31,-0.324324324,0.24,-0.162162162,689,772,723,83,-49,34
t3995xa,t,"Adverse effect of unspecified nonopioid analgesic, antipyretic and antirheumatic, initial encounter",Injury or poisoning,41,24,23,-0.414634146,-0.041666667,-0.43902439,662,782,790,120,8,128
t400x5a,t,"Adverse effect of opium, initial encounter",Injury or poisoning,26,28,14,0.076923077,-0.5,-0.461538462,774,740,886,-34,146,112
t401x1a,t,"Poisoning by heroin, accidental (unintentional), initial encounter",Injury or poisoning,91,74,67,-0.186813187,-0.094594595,-0.263736264,499,518,553,19,35,54
t402x1a,t,"Poisoning by other opioids, accidental (unintentional), initial encounter",Injury or poisoning,272,276,301,0.014705882,0.09057971,0.106617647,323,304,300,-19,-4,-23
t402x2a,t,"Poisoning by other opioids, intentional self-harm, initial encounter",Injury or poisoning,99,66,63,-0.333333333,-0.045454545,-0.363636364,478,544,561,66,17,83
t402x4a,t,"Poisoning by other opioids, undetermined, initial encounter",Injury or poisoning,19,11,13,-0.421052632,0.181818182,-0.315789474,845,930,897,85,-33,52
t402x5a,t,"Adverse effect of other opioids, initial encounter",Injury or poisoning,1593,1371,1468,-0.139359699,0.070751276,-0.078468299,116,130,125,14,-5,9
t402x5d,t,"Adverse effect of other opioids, subsequent encounter",Injury or poisoning,88,101,127,0.147727273,0.257425743,0.443181818,500,459,419,-41,-40,-81
t403x1a,t,"Poisoning by methadone, accidental (unintentional), initial encounter",Injury or poisoning,36,33,33,-0.083333333,0,-0.083333333,691,694,703,3,9,12
t403x5a,t,"Adverse effect of methadone, initial encounter",Injury or poisoning,25,20,26,-0.2,0.3,0.04,778,821,750,43,-71,-28
t405x1a,t,"Poisoning by cocaine, accidental (unintentional), initial encounter",Injury or poisoning,48,47,55,-0.020833333,0.170212766,0.145833333,631,615,586,-16,-29,-45
t40601a,t,"Poisoning by unspecified narcotics, accidental (unintentional), initial encounter",Injury or poisoning,154,133,122,-0.136363636,-0.082706767,-0.207792208,404,421,425,17,4,21
t40602a,t,"Poisoning by unspecified narcotics, intentional self-harm, initial encounter",Injury or poisoning,13,18,19,0.384615385,0.055555556,0.461538462,908,839,818,-69,-21,-90
t40605a,t,"Adverse effect of unspecified narcotics, initial encounter",Injury or poisoning,788,654,587,-0.170050761,-0.102446483,-0.255076142,182,199,209,17,10,27
t407x1a,t,"Poisoning by cannabis (derivatives), accidental (unintentional), initial encounter",Injury or poisoning,79,89,93,0.126582278,0.04494382,0.17721519,523,478,483,-45,5,-40
t407x5a,t,"Adverse effect of cannabis (derivatives), initial encounter",Injury or poisoning,49,43,16,-0.12244898,-0.627906977,-0.673469388,621,637,844,16,207,223
t410x5a,t,"Adverse effect of inhaled anesthetics, initial encounter",Injury or poisoning,15,13,18,-0.133333333,0.384615385,0.2,878,899,825,21,-74,-53
t411x5a,t,"Adverse effect of intravenous anesthetics, initial encounter",Injury or poisoning,26,28,44,0.076923077,0.571428571,0.692307692,763,729,638,-34,-91,-125
t41205a,t,"Adverse effect of unspecified general anesthetics, initial encounter",Injury or poisoning,60,67,74,0.116666667,0.104477612,0.233333333,579,535,526,-44,-9,-53
t41295a,t,"Adverse effect of other general anesthetics, initial encounter",Injury or poisoning,56,74,65,0.321428571,-0.121621622,0.160714286,591,512,548,-79,36,-43
t413x5a,t,"Adverse effect of local anesthetics, initial encounter",Injury or poisoning,49,46,43,-0.06122449,-0.065217391,-0.12244898,619,617,644,-2,27,25
t4145xa,t,"Adverse effect of unspecified anesthetic, initial encounter",Injury or poisoning,81,88,72,0.086419753,-0.181818182,-0.111111111,516,481,528,-35,47,12
t420x5a,t,"Adverse effect of hydantoin derivatives, initial encounter",Injury or poisoning,23,22,30,-0.043478261,0.363636364,0.304347826,787,788,714,1,-74,-73
t421x5a,t,"Adverse effect of iminostilbenes, initial encounter",Injury or poisoning,53,57,46,0.075471698,-0.192982456,-0.132075472,602,565,624,-37,59,22
t421x6a,t,"Underdosing of iminostilbenes, initial encounter",Injury or poisoning,18,14,10,-0.222222222,-0.285714286,-0.444444444,844,883,916,39,33,72
t424x1a,t,"Poisoning by benzodiazepines, accidental (unintentional), initial encounter",Injury or poisoning,149,127,117,-0.147651007,-0.078740157,-0.214765101,415,426,435,11,9,20
t424x2a,t,"Poisoning by benzodiazepines, intentional self-harm, initial encounter",Injury or poisoning,151,143,120,-0.052980132,-0.160839161,-0.205298013,412,408,429,-4,21,17
t424x2d,t,"Poisoning by benzodiazepines, intentional self-harm, subsequent encounter",Injury or poisoning,36,24,13,-0.333333333,-0.458333333,-0.638888889,679,762,877,83,115,198
t424x5a,t,"Adverse effect of benzodiazepines, initial encounter",Injury or poisoning,293,262,217,-0.105802048,-0.171755725,-0.259385666,309,309,342,0,33,33
t424x6a,t,"Underdosing of benzodiazepines, initial encounter",Injury or poisoning,18,22,11,0.222222222,-0.5,-0.388888889,840,783,901,-57,118,61
t426x1a,t,"Poisoning by other antiepileptic and sedative-hypnotic drugs, accidental (unintentional), initial encounter",Injury or poisoning,39,40,46,0.025641026,0.15,0.179487179,657,648,621,-9,-27,-36
t426x2a,t,"Poisoning by other antiepileptic and sedative-hypnotic drugs, intentional self-harm, initial encounter",Injury or poisoning,108,91,93,-0.157407407,0.021978022,-0.138888889,457,472,480,15,8,23
t426x2d,t,"Poisoning by other antiepileptic and sedative-hypnotic drugs, intentional self-harm, subsequent encounter",Injury or poisoning,13,10,10,-0.230769231,0,-0.230769231,889,914,909,25,-5,20
t426x5a,t,"Adverse effect of other antiepileptic and sedative-hypnotic drugs, initial encounter",Injury or poisoning,320,271,269,-0.153125,-0.007380074,-0.159375,289,304,316,15,12,27
t426x6a,t,"Underdosing of other antiepileptic and sedative-hypnotic drugs, initial encounter",Injury or poisoning,86,103,96,0.197674419,-0.067961165,0.11627907,496,449,473,-47,24,-23
t4275xa,t,"Adverse effect of unspecified antiepileptic and sedative-hypnotic drugs, initial encounter",Injury or poisoning,86,115,174,0.337209302,0.513043478,1.023255814,496,436,372,-60,-64,-124
t428x1a,t,"Poisoning by antiparkinsonism drugs and other central muscle-tone depressants, accidental (unintentional), initial encounter",Injury or poisoning,36,34,36,-0.055555556,0.058823529,0,673,672,661,-1,-11,-12
t428x2a,t,"Poisoning by antiparkinsonism drugs and other central muscle-tone depressants, intentional self-harm, initial encounter",Injury or poisoning,49,42,34,-0.142857143,-0.19047619,-0.306122449,610,630,675,20,45,65
t428x5a,t,"Adverse effect of antiparkinsonism drugs and other central muscle-tone depressants, initial encounter",Injury or poisoning,103,77,83,-0.252427184,0.077922078,-0.194174757,460,496,496,36,0,36
t43011a,t,"Poisoning by tricyclic antidepressants, accidental (unintentional), initial encounter",Injury or poisoning,13,14,16,0.076923077,0.142857143,0.230769231,883,870,825,-13,-45,-58
t43012a,t,"Poisoning by tricyclic antidepressants, intentional self-harm, initial encounter",Injury or poisoning,17,19,20,0.117647059,0.052631579,0.176470588,838,806,789,-32,-17,-49
t43015a,t,"Adverse effect of tricyclic antidepressants, initial encounter",Injury or poisoning,14,15,18,0.071428571,0.2,0.285714286,871,852,806,-19,-46,-65
t43211a,t,"Poisoning by selective serotonin and norepinephrine reuptake inhibitors, accidental (unintentional), initial encounter",Injury or poisoning,23,20,19,-0.130434783,-0.05,-0.173913043,774,796,797,22,1,23
t43212a,t,"Poisoning by selective serotonin and norepinephrine reuptake inhibitors, intentional self-harm, initial encounter",Injury or poisoning,81,66,65,-0.185185185,-0.015151515,-0.197530864,508,528,539,20,11,31
t43215a,t,"Adverse effect of selective serotonin and norepinephrine reuptake inhibitors, initial encounter",Injury or poisoning,83,49,51,-0.409638554,0.040816327,-0.385542169,501,584,586,83,2,85
t43216a,t,"Underdosing of selective serotonin and norepinephrine reuptake inhibitors, initial encounter",Injury or poisoning,47,41,33,-0.127659574,-0.195121951,-0.29787234,614,632,680,18,48,66
t43221a,t,"Poisoning by selective serotonin reuptake inhibitors, accidental (unintentional), initial encounter",Injury or poisoning,10,12,14,0.2,0.166666667,0.4,904,882,847,-22,-35,-57
t43222a,t,"Poisoning by selective serotonin reuptake inhibitors, intentional self-harm, initial encounter",Injury or poisoning,92,54,57,-0.413043478,0.055555556,-0.380434783,486,566,564,80,-2,78
t43222d,t,"Poisoning by selective serotonin reuptake inhibitors, intentional self-harm, subsequent encounter",Injury or poisoning,21,11,13,-0.476190476,0.181818182,-0.380952381,791,889,859,98,-30,68
t43225a,t,"Adverse effect of selective serotonin reuptake inhibitors, initial encounter",Injury or poisoning,83,72,75,-0.13253012,0.041666667,-0.096385542,500,511,515,11,4,15
t43226a,t,"Underdosing of selective serotonin reuptake inhibitors, initial encounter",Injury or poisoning,93,74,70,-0.204301075,-0.054054054,-0.247311828,483,503,528,20,25,45
t43292a,t,"Poisoning by other antidepressants, intentional self-harm, initial encounter",Injury or poisoning,37,48,36,0.297297297,-0.25,-0.027027027,657,588,655,-69,67,-2
t43295a,t,"Adverse effect of other antidepressants, initial encounter",Injury or poisoning,13,20,12,0.538461538,-0.4,-0.076923077,872,789,868,-83,79,-4
t43296a,t,"Underdosing of other antidepressants, initial encounter",Injury or poisoning,24,27,22,0.125,-0.185185185,-0.083333333,758,716,765,-42,49,7
t433x5a,t,"Adverse effect of phenothiazine antipsychotics and neuroleptics, initial encounter",Injury or poisoning,19,21,23,0.105263158,0.095238095,0.210526316,807,778,754,-29,-24,-53
t434x5a,t,"Adverse effect of butyrophenone and thiothixene neuroleptics, initial encounter",Injury or poisoning,46,35,44,-0.239130435,0.257142857,-0.043478261,615,656,620,41,-36,5
t43505a,t,"Adverse effect of unspecified antipsychotics and neuroleptics, initial encounter",Injury or poisoning,31,42,37,0.35483871,-0.119047619,0.193548387,692,623,645,-69,22,-47
t43591a,t,"Poisoning by other antipsychotics and neuroleptics, accidental (unintentional), initial encounter",Injury or poisoning,28,35,34,0.25,-0.028571429,0.214285714,720,655,666,-65,11,-54
t43592a,t,"Poisoning by other antipsychotics and neuroleptics, intentional self-harm, initial encounter",Injury or poisoning,153,121,111,-0.209150327,-0.082644628,-0.274509804,405,428,442,23,14,37
t43592d,t,"Poisoning by other antipsychotics and neuroleptics, intentional self-harm, subsequent encounter",Injury or poisoning,30,24,15,-0.2,-0.375,-0.5,701,741,822,40,81,121
t43595a,t,"Adverse effect of other antipsychotics and neuroleptics, initial encounter",Injury or poisoning,210,178,210,-0.152380952,0.179775281,0,355,367,346,12,-21,-9
t43596a,t,"Underdosing of other antipsychotics and neuroleptics, initial encounter",Injury or poisoning,154,220,189,0.428571429,-0.140909091,0.227272727,400,340,359,-60,19,-41
t43621a,t,"Poisoning by amphetamines, accidental (unintentional), initial encounter",Injury or poisoning,259,269,306,0.038610039,0.137546468,0.181467181,321,304,293,-17,-11,-28
t43622a,t,"Poisoning by amphetamines, intentional self-harm, initial encounter",Injury or poisoning,32,49,31,0.53125,-0.367346939,-0.03125,679,577,682,-102,105,3
t43624a,t,"Poisoning by amphetamines, undetermined, initial encounter",Injury or poisoning,12,20,15,0.666666667,-0.25,0.25,869,778,818,-91,40,-51
t43625a,t,"Adverse effect of amphetamines, initial encounter",Injury or poisoning,80,74,74,-0.075,0,-0.075,503,499,513,-4,14,10
t443x2a,t,"Poisoning by other parasympatholytics [anticholinergics and antimuscarinics] and spasmolytics, intentional self-harm, initial encounter",Injury or poisoning,13,15,14,0.153846154,-0.066666667,0.076923077,860,830,830,-30,0,-30
t443x5a,t,"Adverse effect of other parasympatholytics [anticholinergics and antimuscarinics] and spasmolytics, initial encounter",Injury or poisoning,37,45,44,0.216216216,-0.022222222,0.189189189,651,597,615,-54,18,-36
t445x5a,t,"Adverse effect of predominantly beta-adrenoreceptor agonists, initial encounter",Injury or poisoning,30,27,21,-0.1,-0.222222222,-0.3,695,706,760,11,54,65
t446x5a,t,"Adverse effect of alpha-adrenoreceptor antagonists, initial encounter",Injury or poisoning,26,31,14,0.192307692,-0.548387097,-0.461538462,727,666,828,-61,162,101
t447x1a,t,"Poisoning by beta-adrenoreceptor antagonists, accidental (unintentional), initial encounter",Injury or poisoning,19,14,16,-0.263157895,0.142857143,-0.157894737,794,842,802,48,-40,8
t447x2a,t,"Poisoning by beta-adrenoreceptor antagonists, intentional self-harm, initial encounter",Injury or poisoning,32,37,28,0.15625,-0.243243243,-0.125,677,642,698,-35,56,21
t447x5a,t,"Adverse effect of beta-adrenoreceptor antagonists, initial encounter",Injury or poisoning,370,297,270,-0.197297297,-0.090909091,-0.27027027,263,292,312,29,20,49
t447x6a,t,"Underdosing of beta-adrenoreceptor antagonists, initial encounter",Injury or poisoning,61,40,57,-0.344262295,0.425,-0.06557377,555,626,556,71,-70,1
t450x1a,t,"Poisoning by antiallergic and antiemetic drugs, accidental (unintentional), initial encounter",Injury or poisoning,20,16,29,-0.2,0.8125,0.45,782,818,687,36,-131,-95
t450x2a,t,"Poisoning by antiallergic and antiemetic drugs, intentional self-harm, initial encounter",Injury or poisoning,103,103,92,0,-0.106796117,-0.106796117,455,443,474,-12,31,19
t450x5a,t,"Adverse effect of antiallergic and antiemetic drugs, initial encounter",Injury or poisoning,65,60,52,-0.076923077,-0.133333333,-0.2,535,534,570,-1,36,35
t451x5a,t,"Adverse effect of antineoplastic and immunosuppressive drugs, initial encounter",Injury or poisoning,4180,3781,3844,-0.095454545,0.016662259,-0.080382775,59,61,65,2,4,6
t451x5d,t,"Adverse effect of antineoplastic and immunosuppressive drugs, subsequent encounter",Injury or poisoning,40,45,26,0.125,-0.422222222,-0.35,624,593,704,-31,111,80
t451x5s,t,"Adverse effect of antineoplastic and immunosuppressive drugs, sequela",Injury or poisoning,59,68,58,0.152542373,-0.147058824,-0.016949153,559,512,547,-47,35,-12
t452x5a,t,"Adverse effect of vitamins, initial encounter",Injury or poisoning,16,12,13,-0.25,0.083333333,-0.1875,812,850,829,38,-21,17
t45511a,t,"Poisoning by anticoagulants, accidental (unintentional), initial encounter",Injury or poisoning,12,15,16,0.25,0.066666667,0.333333333,853,818,793,-35,-25,-60
t45515a,t,"Adverse effect of anticoagulants, initial encounter",Injury or poisoning,1420,1380,1270,-0.028169014,-0.079710145,-0.105633803,125,126,134,1,8,9
t45516a,t,"Underdosing of anticoagulants, initial encounter",Injury or poisoning,89,74,97,-0.168539326,0.310810811,0.08988764,479,495,464,16,-31,-15
t45525a,t,"Adverse effect of antithrombotic drugs, initial encounter",Injury or poisoning,163,155,157,-0.049079755,0.012903226,-0.036809816,386,388,381,2,-7,-5
t45526a,t,"Underdosing of antithrombotic drugs, initial encounter",Injury or poisoning,28,21,35,-0.25,0.666666667,0.25,700,754,644,54,-110,-56
t45615a,t,"Adverse effect of thrombolytic drugs, initial encounter",Injury or poisoning,45,30,44,-0.333333333,0.466666667,-0.022222222,606,666,606,60,-60,0
t458x5a,t,"Adverse effect of other primarily systemic and hematological agents, initial encounter",Injury or poisoning,103,69,72,-0.330097087,0.043478261,-0.300970874,452,505,508,53,3,56
t460x5a,t,"Adverse effect of cardiac-stimulant glycosides and drugs of similar action, initial encounter",Injury or poisoning,52,49,52,-0.057692308,0.06122449,0,578,567,564,-11,-3,-14
t461x2a,t,"Poisoning by calcium-channel blockers, intentional self-harm, initial encounter",Injury or poisoning,16,17,18,0.0625,0.058823529,0.125,805,792,769,-13,-23,-36
t461x5a,t,"Adverse effect of calcium-channel blockers, initial encounter",Injury or poisoning,162,140,124,-0.135802469,-0.114285714,-0.234567901,388,402,412,14,10,24
t461x6a,t,"Underdosing of calcium-channel blockers, initial encounter",Injury or poisoning,19,15,29,-0.210526316,0.933333333,0.526315789,777,809,675,32,-134,-102
t462x5a,t,"Adverse effect of other antidysrhythmic drugs, initial encounter",Injury or poisoning,134,161,120,0.201492537,-0.254658385,-0.104477612,415,379,418,-36,39,3
t463x5a,t,"Adverse effect of coronary vasodilators, initial encounter",Injury or poisoning,49,43,38,-0.12244898,-0.11627907,-0.224489796,586,598,621,12,23,35
t464x5a,t,"Adverse effect of angiotensin-converting-enzyme inhibitors, initial encounter",Injury or poisoning,317,291,242,-0.082018927,-0.16838488,-0.23659306,288,294,326,6,32,38
t464x6a,t,"Underdosing of angiotensin-converting-enzyme inhibitors, initial encounter",Injury or poisoning,29,50,51,0.724137931,0.02,0.75862069,685,558,564,-127,6,-121
t465x1a,t,"Poisoning by other antihypertensive drugs, accidental (unintentional), initial encounter",Injury or poisoning,18,18,11,0,-0.388888889,-0.388888889,785,770,836,-15,66,51
t465x2a,t,"Poisoning by other antihypertensive drugs, intentional self-harm, initial encounter",Injury or poisoning,29,29,21,0,-0.275862069,-0.275862069,685,667,738,-18,71,53
t465x5a,t,"Adverse effect of other antihypertensive drugs, initial encounter",Injury or poisoning,201,214,158,0.064676617,-0.261682243,-0.213930348,355,338,377,-17,39,22
t465x6a,t,"Underdosing of other antihypertensive drugs, initial encounter",Injury or poisoning,75,73,82,-0.026666667,0.123287671,0.093333333,497,493,484,-4,-9,-13
t466x5a,t,"Adverse effect of antihyperlipidemic and antiarteriosclerotic drugs, initial encounter",Injury or poisoning,54,60,53,0.111111111,-0.116666667,-0.018518519,565,523,556,-42,33,-9
t466x6a,t,"Underdosing of antihyperlipidemic and antiarteriosclerotic drugs, initial encounter",Injury or poisoning,21,17,24,-0.19047619,0.411764706,0.142857143,750,782,711,32,-71,-39
t471x5a,t,"Adverse effect of other antacids and anti-gastric-secretion drugs, initial encounter",Injury or poisoning,37,41,32,0.108108108,-0.219512195,-0.135135135,631,601,651,-30,50,20
t473x5a,t,"Adverse effect of saline and osmotic laxatives, initial encounter",Injury or poisoning,32,25,32,-0.21875,0.28,0,656,699,651,43,-48,-5
t473x6a,t,"Underdosing of saline and osmotic laxatives, initial encounter",Injury or poisoning,33,28,16,-0.151515152,-0.428571429,-0.515151515,650,671,772,21,101,122
t474x5a,t,"Adverse effect of other laxatives, initial encounter",Injury or poisoning,41,38,26,-0.073170732,-0.315789474,-0.365853659,607,613,685,6,72,78
t481x2a,t,"Poisoning by skeletal muscle relaxants [neuromuscular blocking agents], intentional self-harm, initial encounter",Injury or poisoning,14,19,17,0.357142857,-0.105263158,0.214285714,812,753,763,-59,10,-49
t481x5a,t,"Adverse effect of skeletal muscle relaxants [neuromuscular blocking agents], initial encounter",Injury or poisoning,28,16,27,-0.428571429,0.6875,-0.035714286,684,789,677,105,-112,-7
t486x5a,t,"Adverse effect of antiasthmatics, initial encounter",Injury or poisoning,75,64,39,-0.146666667,-0.390625,-0.48,497,509,613,12,104,116
t490x5a,t,"Adverse effect of local antifungal, anti-infective and anti-inflammatory drugs, initial encounter",Injury or poisoning,22,12,18,-0.454545455,0.5,-0.181818182,733,822,753,89,-69,20
t500x5a,t,"Adverse effect of mineralocorticoids and their antagonists, initial encounter",Injury or poisoning,84,87,78,0.035714286,-0.103448276,-0.071428571,481,461,495,-20,34,14
t501x5a,t,"Adverse effect of loop [high-ceiling] diuretics, initial encounter",Injury or poisoning,410,378,362,-0.07804878,-0.042328042,-0.117073171,248,257,267,9,10,19
t501x6a,t,"Underdosing of loop [high-ceiling] diuretics, initial encounter",Injury or poisoning,63,82,68,0.301587302,-0.170731707,0.079365079,531,471,513,-60,42,-18
t502x5a,t,"Adverse effect of carbonic-anhydrase inhibitors, benzothiadiazides and other diuretics, initial encounter",Injury or poisoning,1484,1395,1346,-0.059973046,-0.035125448,-0.092991914,122,125,131,3,6,9
t502x6a,t,"Underdosing of carbonic-anhydrase inhibitors, benzothiadiazides and other diuretics, initial encounter",Injury or poisoning,11,17,14,0.545454545,-0.176470588,0.272727273,825,772,786,-53,14,-39
t503x5a,t,"Adverse effect of electrolytic, caloric and water-balance agents, initial encounter",Injury or poisoning,46,31,50,-0.326086957,0.612903226,0.086956522,587,638,561,51,-77,-26
t504x5a,t,"Adverse effect of drugs affecting uric acid metabolism, initial encounter",Injury or poisoning,21,20,23,-0.047619048,0.15,0.095238095,738,740,708,2,-32,-30
t507x5a,t,"Adverse effect of analeptics and opioid receptor antagonists, initial encounter",Injury or poisoning,24,19,13,-0.208333333,-0.315789474,-0.458333333,710,746,794,36,48,84
t508x5a,t,"Adverse effect of diagnostic agents, initial encounter",Injury or poisoning,595,613,580,0.030252101,-0.053833605,-0.025210084,207,200,208,-7,8,1
t50z15a,t,"Adverse effect of immunoglobulin, initial encounter",Injury or poisoning,28,19,15,-0.321428571,-0.210526316,-0.464285714,677,745,770,68,25,93
t50901a,t,"Poisoning by unspecified drugs, medicaments and biological substances, accidental (unintentional), initial encounter",Injury or poisoning,154,115,101,-0.253246753,-0.12173913,-0.344155844,389,421,442,32,21,53
t50902a,t,"Poisoning by unspecified drugs, medicaments and biological substances, intentional self-harm, initial encounter",Injury or poisoning,82,89,81,0.085365854,-0.08988764,-0.012195122,480,454,481,-26,27,1
t50905a,t,"Adverse effect of unspecified drugs, medicaments and biological substances, initial encounter",Injury or poisoning,427,416,361,-0.025761124,-0.132211538,-0.154566745,239,240,265,1,25,26
t50906a,t,"Underdosing of unspecified drugs, medicaments and biological substances, initial encounter",Injury or poisoning,29,15,29,-0.482758621,0.933333333,0,668,779,656,111,-123,-12
t50911a,t,"Poisoning by multiple unspecified drugs, medicaments and biological substances, accidental (unintentional), initial encounter",Injury or poisoning,11,25,39,1.272727273,0.56,2.545454545,816,687,604,-129,-83,-212
t50915a,t,"Adverse effect of multiple unspecified drugs, medicaments and biological substances, initial encounter",Injury or poisoning,46,93,108,1.02173913,0.161290323,1.347826087,583,447,430,-136,-17,-153
t50916a,t,"Underdosing of multiple unspecified drugs, medicaments and biological substances, initial encounter",Injury or poisoning,11,27,49,1.454545455,0.814814815,3.454545455,815,668,559,-147,-109,-256
t50991a,t,"Poisoning by other drugs, medicaments and biological substances, accidental (unintentional), initial encounter",Injury or poisoning,17,17,19,0,0.117647059,0.117647059,764,761,731,-3,-30,-33
t50992a,t,"Poisoning by other drugs, medicaments and biological substances, intentional self-harm, initial encounter",Injury or poisoning,23,18,19,-0.217391304,0.055555556,-0.173913043,710,745,731,35,-14,21
t50995a,t,"Adverse effect of other drugs, medicaments and biological substances, initial encounter",Injury or poisoning,269,229,218,-0.148698885,-0.048034934,-0.189591078,311,327,331,16,4,20
t50996a,t,"Underdosing of other drugs, medicaments and biological substances, initial encounter",Injury or poisoning,46,47,49,0.02173913,0.042553191,0.065217391,582,560,558,-22,-2,-24
t510x1a,t,"Toxic effect of ethanol, accidental (unintentional), initial encounter",Injury or poisoning,160,177,183,0.10625,0.033898305,0.14375,383,355,353,-28,-2,-30
t510x2a,t,"Toxic effect of ethanol, intentional self-harm, initial encounter",Injury or poisoning,77,55,46,-0.285714286,-0.163636364,-0.402597403,484,529,574,45,45,90
t59811a,t,"Toxic effect of smoke, accidental (unintentional), initial encounter",Injury or poisoning,15,26,20,0.733333333,-0.230769231,0.333333333,774,674,719,-100,45,-55
t63011a,t,"Toxic effect of rattlesnake venom, accidental (unintentional), initial encounter",Injury or poisoning,101,67,87,-0.336633663,0.298507463,-0.138613861,446,494,466,48,-28,20
t63301a,t,"Toxic effect of unspecified spider venom, accidental (unintentional), initial encounter",Injury or poisoning,53,35,36,-0.339622642,0.028571429,-0.320754717,555,610,609,55,-1,54
t65891a,t,"Toxic effect of other specified substances, accidental (unintentional), initial encounter",Injury or poisoning,15,16,12,0.066666667,-0.25,-0.2,772,763,786,-9,23,14
t6591xa,t,"Toxic effect of unspecified substance, accidental (unintentional), initial encounter",Injury or poisoning,31,13,13,-0.580645161,0,-0.580645161,643,784,776,141,-8,133
t66xxxa,t,"Radiation sickness, unspecified, initial encounter",Injury or poisoning,30,23,20,-0.233333333,-0.130434783,-0.333333333,652,698,717,46,19,65
t675xxa,t,"Heat exhaustion, unspecified, initial encounter",Injury or poisoning,226,67,285,-0.703539823,3.253731343,0.261061947,332,494,296,162,-198,-36
t68xxxa,t,"Hypothermia, initial encounter",Injury or poisoning,115,127,106,0.104347826,-0.165354331,-0.07826087,428,406,427,-22,21,-1
t7029xa,t,"Other effects of high altitude, initial encounter",Injury or poisoning,62,39,63,-0.370967742,0.615384615,0.016129032,523,592,511,69,-81,-12
t71162a,t,"Asphyxiation due to hanging, intentional self-harm, initial encounter",Injury or poisoning,32,27,32,-0.15625,0.185185185,0,634,659,629,25,-30,-5
t730xxa,t,"Starvation, initial encounter",Injury or poisoning,65,50,80,-0.230769231,0.6,0.230769231,511,539,475,28,-64,-36
t7411xa,t,"Adult physical abuse, confirmed, initial encounter",Injury or poisoning,20,11,24,-0.45,1.181818182,0.2,725,794,682,69,-112,-43
t7421xa,t,"Adult sexual abuse, confirmed, initial encounter",Injury or poisoning,16,16,17,0,0.0625,0.0625,756,757,730,1,-27,-26
t751xxa,t,"Unspecified effects of drowning and nonfatal submersion, initial encounter",Injury or poisoning,33,25,36,-0.242424242,0.44,0.090909091,628,673,605,45,-68,-23
t7601xa,t,"Adult neglect or abandonment, suspected, initial encounter",Injury or poisoning,19,23,38,0.210526316,0.652173913,1,731,692,594,-39,-98,-137
t7611xa,t,"Adult physical abuse, suspected, initial encounter",Injury or poisoning,22,21,15,-0.045454545,-0.285714286,-0.318181818,705,710,744,5,34,39
t7612xa,t,"Child physical abuse, suspected, initial encounter",Injury or poisoning,73,69,57,-0.054794521,-0.173913043,-0.219178082,490,488,528,-2,40,38
t781xxa,t,"Other adverse food reactions, not elsewhere classified, initial encounter",Injury or poisoning,14,14,19,0,0.357142857,0.357142857,772,767,714,-5,-53,-58
t782xxa,t,"Anaphylactic shock, unspecified, initial encounter",Injury or poisoning,68,45,55,-0.338235294,0.222222222,-0.191176471,501,561,532,60,-29,31
t783xxa,t,"Angioneurotic edema, initial encounter",Injury or poisoning,249,210,204,-0.156626506,-0.028571429,-0.180722892,317,334,335,17,1,18
t7840xa,t,"Allergy, unspecified, initial encounter",Injury or poisoning,89,64,57,-0.280898876,-0.109375,-0.359550562,462,493,527,31,34,65
t7840xd,t,"Allergy, unspecified, subsequent encounter",Injury or poisoning,17,28,17,0.647058824,-0.392857143,0,742,645,723,-97,78,-19
t7849xa,t,"Other allergy, initial encounter",Injury or poisoning,15,11,12,-0.266666667,0.090909091,-0.2,755,784,768,29,-16,13
t794xxa,t,"Traumatic shock, initial encounter",Injury or poisoning,244,217,268,-0.110655738,0.235023041,0.098360656,318,331,307,13,-24,-11
t796xxa,t,"Traumatic ischemia of muscle, initial encounter",Injury or poisoning,194,181,215,-0.067010309,0.187845304,0.108247423,350,351,330,1,-21,-20
t796xxd,t,"Traumatic ischemia of muscle, subsequent encounter",Injury or poisoning,19,26,24,0.368421053,-0.076923077,0.263157895,724,660,674,-64,14,-50
t797xxa,t,"Traumatic subcutaneous emphysema, initial encounter",Injury or poisoning,283,314,331,0.109540636,0.054140127,0.169611307,301,275,272,-26,-3,-29
t79a0xa,t,"Compartment syndrome, unspecified, initial encounter",Injury or poisoning,15,14,15,-0.066666667,0.071428571,0,751,759,734,8,-25,-17
t79a11a,t,"Traumatic compartment syndrome of right upper extremity, initial encounter",Injury or poisoning,28,27,18,-0.035714286,-0.333333333,-0.357142857,651,650,712,-1,62,61
t79a12a,t,"Traumatic compartment syndrome of left upper extremity, initial encounter",Injury or poisoning,16,22,24,0.375,0.090909091,0.5,743,689,673,-54,-16,-70
t79a21a,t,"Traumatic compartment syndrome of right lower extremity, initial encounter",Injury or poisoning,44,29,52,-0.340909091,0.793103448,0.181818182,569,634,535,65,-99,-34
t79a22a,t,"Traumatic compartment syndrome of left lower extremity, initial encounter",Injury or poisoning,46,38,35,-0.173913043,-0.078947368,-0.239130435,567,587,600,20,13,33
t79a3xa,t,"Traumatic compartment syndrome of abdomen, initial encounter",Injury or poisoning,11,12,17,0.090909091,0.416666667,0.545454545,777,769,715,-8,-54,-62
t801xxa,t,"Vascular complications following infusion, transfusion and therapeutic injection, initial encounter",Injury or poisoning,47,42,47,-0.106382979,0.119047619,0,563,572,552,9,-20,-11
t80211a,t,"Bloodstream infection due to central venous catheter, initial encounter",Injury or poisoning,346,307,392,-0.112716763,0.276872964,0.132947977,265,279,253,14,-26,-12
t80212a,t,"Local infection due to central venous catheter, initial encounter",Injury or poisoning,56,47,49,-0.160714286,0.042553191,-0.125,532,547,543,15,-4,11
t80219a,t,"Unspecified infection due to central venous catheter, initial encounter",Injury or poisoning,62,57,54,-0.080645161,-0.052631579,-0.129032258,514,512,528,-2,16,14
t8029xa,t,"Infection following other infusion, transfusion and therapeutic injection, initial encounter",Injury or poisoning,29,23,23,-0.206896552,0,-0.206896552,640,676,671,36,-5,31
t80818a,t,"Extravasation of other vesicant agent, initial encounter",Injury or poisoning,47,41,42,-0.127659574,0.024390244,-0.106382979,560,572,573,12,1,13
t8089xa,t,"Other complications following infusion, transfusion and therapeutic injection, initial encounter",Injury or poisoning,122,116,125,-0.049180328,0.077586207,0.024590164,409,411,395,2,-16,-14
t8092xa,t,"Unspecified transfusion reaction, initial encounter",Injury or poisoning,29,27,38,-0.068965517,0.407407407,0.310344828,638,642,580,4,-62,-58
t8110xa,t,"Postprocedural shock unspecified, initial encounter",Injury or poisoning,20,18,12,-0.1,-0.333333333,-0.4,705,708,750,3,42,45
t8111xa,t,"Postprocedural cardiogenic shock, initial encounter",Injury or poisoning,81,50,74,-0.382716049,0.48,-0.086419753,470,530,482,60,-48,12
t8112xa,t,"Postprocedural septic shock, initial encounter",Injury or poisoning,38,25,37,-0.342105263,0.48,-0.026315789,588,653,580,65,-73,-8
t8119xa,t,"Other postprocedural shock, initial encounter",Injury or poisoning,126,82,103,-0.349206349,0.256097561,-0.182539683,406,456,427,50,-29,21
t8130xa,t,"Disruption of wound, unspecified, initial encounter",Injury or poisoning,280,241,247,-0.139285714,0.024896266,-0.117857143,303,313,315,10,2,12
t8131xa,t,"Disruption of external operation (surgical) wound, not elsewhere classified, initial encounter",Injury or poisoning,795,646,797,-0.187421384,0.23374613,0.002515723,177,197,174,20,-23,-3
t8131xd,t,"Disruption of external operation (surgical) wound, not elsewhere classified, subsequent encounter",Injury or poisoning,22,29,11,0.318181818,-0.620689655,-0.5,682,623,753,-59,130,71
t8132xa,t,"Disruption of internal operation (surgical) wound, not elsewhere classified, initial encounter",Injury or poisoning,324,317,296,-0.021604938,-0.066246057,-0.086419753,276,271,291,-5,20,15
t8133xa,t,"Disruption of traumatic injury wound repair, initial encounter",Injury or poisoning,15,22,25,0.466666667,0.136363636,0.666666667,731,672,644,-59,-28,-87
t8140xa,t,"Infection following a procedure, unspecified, initial encounter",Injury or poisoning,251,196,190,-0.219123506,-0.030612245,-0.243027888,310,337,338,27,1,28
t8141xa,t,"Infection following a procedure, superficial incisional surgical site, initial encounter",Injury or poisoning,736,518,590,-0.296195652,0.138996139,-0.198369565,185,214,204,29,-10,19
t8142xa,t,"Infection following a procedure, deep incisional surgical site, initial encounter",Injury or poisoning,188,158,174,-0.159574468,0.101265823,-0.074468085,346,364,348,18,-16,2
t8143xa,t,"Infection following a procedure, organ and space surgical site, initial encounter",Injury or poisoning,315,278,320,-0.117460317,0.151079137,0.015873016,281,288,273,7,-15,-8
t8144xa,t,"Sepsis following a procedure, initial encounter",Injury or poisoning,434,337,416,-0.223502304,0.234421365,-0.041474654,235,261,241,26,-20,6
t8149xa,t,"Infection following a procedure, other surgical site, initial encounter",Injury or poisoning,490,371,420,-0.242857143,0.132075472,-0.142857143,226,254,240,28,-14,14
t8149xd,t,"Infection following a procedure, other surgical site, subsequent encounter",Injury or poisoning,27,20,16,-0.259259259,-0.2,-0.407407407,635,682,698,47,16,63
t81718a,t,"Complication of other artery following a procedure, not elsewhere classified, initial encounter",Injury or poisoning,107,86,125,-0.196261682,0.453488372,0.168224299,420,437,386,17,-51,-34
t8172xa,t,"Complication of vein following a procedure, not elsewhere classified, initial encounter",Injury or poisoning,21,23,20,0.095238095,-0.130434783,-0.047619048,681,659,676,-22,17,-5
t8182xa,t,"Emphysema (subcutaneous) resulting from a procedure, initial encounter",Injury or poisoning,144,104,111,-0.277777778,0.067307692,-0.229166667,380,412,408,32,-4,28
t8183xa,t,"Persistent postprocedural fistula, initial encounter",Injury or poisoning,84,63,49,-0.25,-0.222222222,-0.416666667,452,481,528,29,47,76
t8189xa,t,"Other complications of procedures, not elsewhere classified, initial encounter",Injury or poisoning,221,166,194,-0.248868778,0.168674699,-0.122171946,322,348,330,26,-18,8
t8189xd,t,"Other complications of procedures, not elsewhere classified, subsequent encounter",Injury or poisoning,14,18,11,0.285714286,-0.388888889,-0.214285714,729,688,739,-41,51,10
t8203xa,t,"Leakage of heart valve prosthesis, initial encounter",Injury or poisoning,23,19,26,-0.173913043,0.368421053,0.130434783,661,682,625,21,-57,-36
t82110a,t,"Breakdown (mechanical) of cardiac electrode, initial encounter",Injury or poisoning,39,37,26,-0.051282051,-0.297297297,-0.333333333,567,572,625,5,53,58
t82120a,t,"Displacement of cardiac electrode, initial encounter",Injury or poisoning,48,44,36,-0.083333333,-0.181818182,-0.25,541,543,573,2,30,32
t82190a,t,"Other mechanical complication of cardiac electrode, initial encounter",Injury or poisoning,30,29,25,-0.033333333,-0.137931034,-0.166666667,613,610,631,-3,21,18
t82198a,t,"Other mechanical complication of other cardiac electronic device, initial encounter",Injury or poisoning,16,18,10,0.125,-0.444444444,-0.375,709,684,742,-25,58,33
t82330a,t,"Leakage of aortic (bifurcation) graft (replacement), initial encounter",Injury or poisoning,54,47,55,-0.12962963,0.170212766,0.018518519,522,530,511,8,-19,-11
t8241xa,t,"Breakdown (mechanical) of vascular dialysis catheter, initial encounter",Injury or poisoning,84,100,117,0.19047619,0.17,0.392857143,451,415,396,-36,-19,-55
t8242xa,t,"Displacement of vascular dialysis catheter, initial encounter",Injury or poisoning,18,13,24,-0.277777778,0.846153846,0.333333333,696,722,641,26,-81,-55
t8249xa,t,"Other complication of vascular dialysis catheter, initial encounter",Injury or poisoning,29,33,35,0.137931034,0.060606061,0.206896552,617,580,574,-37,-6,-43
t82510a,t,"Breakdown (mechanical) of surgically created arteriovenous fistula, initial encounter",Injury or poisoning,60,54,68,-0.1,0.259259259,0.133333333,503,504,480,1,-24,-23
t82514a,t,"Breakdown (mechanical) of infusion catheter, initial encounter",Injury or poisoning,15,30,22,1,-0.266666667,0.466666667,709,598,650,-111,52,-59
t82524a,t,"Displacement of infusion catheter, initial encounter",Injury or poisoning,61,53,72,-0.131147541,0.358490566,0.180327869,500,506,468,6,-38,-32
t82528a,t,"Displacement of other cardiac and vascular devices and implants, initial encounter",Injury or poisoning,14,16,13,0.142857143,-0.1875,-0.071428571,717,700,711,-17,11,-6
t82590a,t,"Other mechanical complication of surgically created arteriovenous fistula, initial encounter",Injury or poisoning,35,39,41,0.114285714,0.051282051,0.171428571,581,558,557,-23,-1,-24
t82594a,t,"Other mechanical complication of infusion catheter, initial encounter",Injury or poisoning,21,24,42,0.142857143,0.75,1,668,634,553,-34,-81,-115
t82598a,t,"Other mechanical complication of other cardiac and vascular devices and implants, initial encounter",Injury or poisoning,30,18,26,-0.4,0.444444444,-0.133333333,608,676,617,68,-59,9
t826xxa,t,"Infection and inflammatory reaction due to cardiac valve prosthesis, initial encounter",Injury or poisoning,40,48,44,0.2,-0.083333333,0.1,553,521,545,-32,24,-8
t827xxa,t,"Infection and inflammatory reaction due to other cardiac and vascular devices, implants and grafts, initial encounter",Injury or poisoning,420,340,341,-0.19047619,0.002941176,-0.188095238,236,259,263,23,4,27
t82818a,t,"Embolism due to vascular prosthetic devices, implants and grafts, initial encounter",Injury or poisoning,49,59,47,0.204081633,-0.203389831,-0.040816327,533,486,528,-47,42,-5
t82838a,t,"Hemorrhage due to vascular prosthetic devices, implants and grafts, initial encounter",Injury or poisoning,142,133,180,-0.063380282,0.353383459,0.267605634,379,384,337,5,-47,-42
t82847a,t,"Pain due to cardiac prosthetic devices, implants and grafts, initial encounter",Injury or poisoning,11,10,12,-0.090909091,0.2,0.090909091,727,731,712,4,-19,-15
t82848a,t,"Pain due to vascular prosthetic devices, implants and grafts, initial encounter",Injury or poisoning,40,28,45,-0.3,0.607142857,0.125,550,604,538,54,-66,-12
t82855a,t,"Stenosis of coronary artery stent, initial encounter",Injury or poisoning,615,612,582,-0.004878049,-0.049019608,-0.053658537,202,199,205,-3,6,3
t82856a,t,"Stenosis of peripheral vascular stent, initial encounter",Injury or poisoning,121,105,96,-0.132231405,-0.085714286,-0.20661157,394,407,426,13,19,32
t82857a,t,"Stenosis of other cardiac prosthetic devices, implants and grafts, initial encounter",Injury or poisoning,127,113,114,-0.11023622,0.008849558,-0.102362205,391,400,398,9,-2,7
t82858a,t,"Stenosis of other vascular prosthetic devices, implants and grafts, initial encounter",Injury or poisoning,135,126,121,-0.066666667,-0.03968254,-0.103703704,384,388,385,4,-3,1
t82867a,t,"Thrombosis due to cardiac prosthetic devices, implants and grafts, initial encounter",Injury or poisoning,111,117,117,0.054054054,0,0.054054054,408,395,392,-13,-3,-16
t82868a,t,"Thrombosis due to vascular prosthetic devices, implants and grafts, initial encounter",Injury or poisoning,527,499,533,-0.05313093,0.068136273,0.011385199,220,217,214,-3,-3,-6
t82897a,t,"Other specified complication of cardiac prosthetic devices, implants and grafts, initial encounter",Injury or poisoning,67,62,56,-0.074626866,-0.096774194,-0.164179104,472,473,498,1,25,26
t82898a,t,"Other specified complication of vascular prosthetic devices, implants and grafts, initial encounter",Injury or poisoning,217,188,225,-0.133640553,0.196808511,0.036866359,324,337,315,13,-22,-9
t829xxa,t,"Unspecified complication of cardiac and vascular prosthetic device, implant and graft, initial encounter",Injury or poisoning,31,23,26,-0.258064516,0.130434783,-0.161290323,586,632,604,46,-28,18
t83012a,t,"Breakdown (mechanical) of nephrostomy catheter, initial encounter",Injury or poisoning,23,33,18,0.434782609,-0.454545455,-0.217391304,637,565,655,-72,90,18
t83021a,t,"Displacement of indwelling urethral catheter, initial encounter",Injury or poisoning,35,27,44,-0.228571429,0.62962963,0.257142857,568,602,533,34,-69,-35
t83022a,t,"Displacement of nephrostomy catheter, initial encounter",Injury or poisoning,65,78,63,0.2,-0.192307692,-0.030769231,476,439,478,-37,39,2
t83028a,t,"Displacement of other urinary catheter, initial encounter",Injury or poisoning,20,18,21,-0.1,0.166666667,0.05,657,659,635,2,-24,-22
t83030a,t,"Leakage of cystostomy catheter, initial encounter",Injury or poisoning,18,22,16,0.222222222,-0.272727273,-0.111111111,672,633,661,-39,28,-11
t83031a,t,"Leakage of indwelling urethral catheter, initial encounter",Injury or poisoning,32,30,35,-0.0625,0.166666667,0.09375,579,582,555,3,-27,-24
t83032a,t,"Leakage of nephrostomy catheter, initial encounter",Injury or poisoning,14,17,18,0.214285714,0.058823529,0.285714286,694,667,651,-27,-16,-43
t83090a,t,"Other mechanical complication of cystostomy catheter, initial encounter",Injury or poisoning,24,26,25,0.083333333,-0.038461538,0.041666667,627,606,606,-21,0,-21
t83091a,t,"Other mechanical complication of indwelling urethral catheter, initial encounter",Injury or poisoning,71,71,82,0,0.154929577,0.154929577,460,453,444,-7,-9,-16
t83092a,t,"Other mechanical complication of nephrostomy catheter, initial encounter",Injury or poisoning,31,31,25,0,-0.193548387,-0.193548387,582,571,605,-11,34,23
t83098a,t,"Other mechanical complication of other urinary catheter, initial encounter",Injury or poisoning,33,26,35,-0.212121212,0.346153846,0.060606061,574,604,554,30,-50,-20
t83122a,t,"Displacement of indwelling ureteral stent, initial encounter",Injury or poisoning,30,21,14,-0.3,-0.333333333,-0.533333333,588,636,673,48,37,85
t8332xa,t,"Displacement of intrauterine contraceptive device, initial encounter",Injury or poisoning,19,14,14,-0.263157895,0,-0.263157895,656,684,673,28,-11,17
t83510a,t,"Infection and inflammatory reaction due to cystostomy catheter, initial encounter",Injury or poisoning,104,119,121,0.144230769,0.016806723,0.163461538,410,391,383,-19,-8,-27
t83511a,t,"Infection and inflammatory reaction due to indwelling urethral catheter, initial encounter",Injury or poisoning,825,765,844,-0.072727273,0.103267974,0.023030303,171,176,165,5,-11,-6
t83512a,t,"Infection and inflammatory reaction due to nephrostomy catheter, initial encounter",Injury or poisoning,92,78,86,-0.152173913,0.102564103,-0.065217391,431,437,434,6,-3,3
t83518a,t,"Infection and inflammatory reaction due to other urinary catheter, initial encounter",Injury or poisoning,535,529,524,-0.011214953,-0.009451796,-0.020560748,213,206,214,-7,8,1
t83592a,t,"Infection and inflammatory reaction due to indwelling ureteral stent, initial encounter",Injury or poisoning,60,31,32,-0.483333333,0.032258065,-0.466666667,486,567,564,81,-3,78
t83593a,t,"Infection and inflammatory reaction due to other urinary stents, initial encounter",Injury or poisoning,25,24,28,-0.04,0.166666667,0.12,608,608,583,0,-25,-25
t8383xa,t,"Hemorrhage due to genitourinary prosthetic devices, implants and grafts, initial encounter",Injury or poisoning,179,145,186,-0.189944134,0.282758621,0.039106145,342,367,330,25,-37,-12
t8384xa,t,"Pain due to genitourinary prosthetic devices, implants and grafts, initial encounter",Injury or poisoning,37,38,35,0.027027027,-0.078947368,-0.054054054,551,541,549,-10,8,-2
t8389xa,t,"Other specified complication of genitourinary prosthetic devices, implants and grafts, initial encounter",Injury or poisoning,36,35,23,-0.027777778,-0.342857143,-0.361111111,555,550,609,-5,59,54
t84020a,t,"Dislocation of internal right hip prosthesis, initial encounter",Injury or poisoning,103,108,99,0.048543689,-0.083333333,-0.038834951,407,396,412,-11,16,5
t84021a,t,"Dislocation of internal left hip prosthesis, initial encounter",Injury or poisoning,113,101,103,-0.10619469,0.01980198,-0.088495575,400,399,402,-1,3,2
t84022a,t,"Instability of internal right knee prosthesis, initial encounter",Injury or poisoning,97,77,79,-0.206185567,0.025974026,-0.18556701,417,434,441,17,7,24
t84023a,t,"Instability of internal left knee prosthesis, initial encounter",Injury or poisoning,89,83,111,-0.06741573,0.337349398,0.247191011,427,426,394,-1,-32,-33
t84028a,t,"Dislocation of other internal joint prosthesis, initial encounter",Injury or poisoning,50,47,46,-0.06,-0.021276596,-0.08,510,504,515,-6,11,5
t84030a,t,"Mechanical loosening of internal right hip prosthetic joint, initial encounter",Injury or poisoning,58,38,51,-0.344827586,0.342105263,-0.120689655,488,536,495,48,-41,7
t84031a,t,"Mechanical loosening of internal left hip prosthetic joint, initial encounter",Injury or poisoning,52,43,42,-0.173076923,-0.023255814,-0.192307692,501,520,526,19,6,25
t84032a,t,"Mechanical loosening of internal right knee prosthetic joint, initial encounter",Injury or poisoning,64,58,71,-0.09375,0.224137931,0.109375,469,469,453,0,-16,-16
t84033a,t,"Mechanical loosening of internal left knee prosthetic joint, initial encounter",Injury or poisoning,80,64,52,-0.2,-0.1875,-0.35,439,454,492,15,38,53
t84038a,t,"Mechanical loosening of other internal prosthetic joint, initial encounter",Injury or poisoning,77,68,53,-0.116883117,-0.220588235,-0.311688312,439,450,490,11,40,51
t84060a,t,"Wear of articular bearing surface of internal prosthetic right hip joint, initial encounter",Injury or poisoning,15,13,10,-0.133333333,-0.230769231,-0.333333333,660,668,684,8,16,24
t84090a,t,"Other mechanical complication of internal right hip prosthesis, initial encounter",Injury or poisoning,59,44,37,-0.254237288,-0.159090909,-0.372881356,480,512,529,32,17,49
t84091a,t,"Other mechanical complication of internal left hip prosthesis, initial encounter",Injury or poisoning,51,33,48,-0.352941176,0.454545455,-0.058823529,500,545,501,45,-44,1
t84092a,t,"Other mechanical complication of internal right knee prosthesis, initial encounter",Injury or poisoning,66,60,43,-0.090909091,-0.283333333,-0.348484848,461,462,519,1,57,58
t84093a,t,"Other mechanical complication of internal left knee prosthesis, initial encounter",Injury or poisoning,63,52,36,-0.174603175,-0.307692308,-0.428571429,469,481,533,12,52,64
t84098a,t,"Other mechanical complication of other internal joint prosthesis, initial encounter",Injury or poisoning,53,48,37,-0.094339623,-0.229166667,-0.301886792,492,494,527,2,33,35
t84216a,t,"Breakdown (mechanical) of internal fixation device of vertebrae, initial encounter",Injury or poisoning,65,46,71,-0.292307692,0.543478261,0.092307692,463,501,453,38,-48,-10
t84226a,t,"Displacement of internal fixation device of vertebrae, initial encounter",Injury or poisoning,95,74,100,-0.221052632,0.351351351,0.052631579,421,439,406,18,-33,-15
t84296a,t,"Other mechanical complication of internal fixation device of vertebrae, initial encounter",Injury or poisoning,38,31,32,-0.184210526,0.032258065,-0.157894737,530,547,545,17,-2,15
t84498a,t,"Other mechanical complication of other internal orthopedic devices, implants and grafts, initial encounter",Injury or poisoning,27,19,26,-0.296296296,0.368421053,-0.037037037,574,620,573,46,-47,-1
t8451xa,t,"Infection and inflammatory reaction due to internal right hip prosthesis, initial encounter",Injury or poisoning,102,100,100,-0.019607843,0,-0.019607843,408,400,406,-8,6,-2
t8452xa,t,"Infection and inflammatory reaction due to internal left hip prosthesis, initial encounter",Injury or poisoning,94,86,89,-0.085106383,0.034883721,-0.053191489,420,418,423,-2,5,3
t8453xa,t,"Infection and inflammatory reaction due to internal right knee prosthesis, initial encounter",Injury or poisoning,193,164,189,-0.150259067,0.152439024,-0.020725389,334,343,328,9,-15,-6
t8453xd,t,"Infection and inflammatory reaction due to internal right knee prosthesis, subsequent encounter",Injury or poisoning,19,10,15,-0.473684211,0.5,-0.210526316,625,676,632,51,-44,7
t8454xa,t,"Infection and inflammatory reaction due to internal left knee prosthesis, initial encounter",Injury or poisoning,195,163,176,-0.164102564,0.079754601,-0.097435897,332,347,331,15,-16,-1
t8454xd,t,"Infection and inflammatory reaction due to internal left knee prosthesis, subsequent encounter",Injury or poisoning,13,17,12,0.307692308,-0.294117647,-0.076923077,659,630,656,-29,26,-3
t8459xa,t,"Infection and inflammatory reaction due to other internal joint prosthesis, initial encounter",Injury or poisoning,68,56,58,-0.176470588,0.035714286,-0.147058824,452,465,472,13,7,20
t84622a,t,"Infection and inflammatory reaction due to internal fixation device of right tibia, initial encounter",Injury or poisoning,30,22,25,-0.266666667,0.136363636,-0.166666667,557,596,572,39,-24,15
t84623a,t,"Infection and inflammatory reaction due to internal fixation device of left tibia, initial encounter",Injury or poisoning,22,21,18,-0.045454545,-0.142857143,-0.181818182,602,603,613,1,10,11
t84629a,t,"Infection and inflammatory reaction due to internal fixation device of unspecified bone of leg, initial encounter",Injury or poisoning,14,13,11,-0.071428571,-0.153846154,-0.214285714,651,651,659,0,8,8
t8463xa,t,"Infection and inflammatory reaction due to internal fixation device of spine, initial encounter",Injury or poisoning,20,28,30,0.4,0.071428571,0.5,616,560,548,-56,-12,-68
t8469xa,t,"Infection and inflammatory reaction due to internal fixation device of other site, initial encounter",Injury or poisoning,44,55,46,0.25,-0.163636364,0.045454545,501,470,503,-31,33,2
t847xxa,t,"Infection and inflammatory reaction due to other internal orthopedic prosthetic devices, implants and grafts, initial encounter",Injury or poisoning,40,31,45,-0.225,0.451612903,0.125,511,541,505,30,-36,-6
t8482xa,t,"Fibrosis due to internal orthopedic prosthetic devices, implants and grafts, initial encounter",Injury or poisoning,16,10,13,-0.375,0.3,-0.1875,635,667,642,32,-25,7
t8484xa,t,"Pain due to internal orthopedic prosthetic devices, implants and grafts, initial encounter",Injury or poisoning,346,233,283,-0.326589595,0.214592275,-0.182080925,256,310,283,54,-27,27
t8489xa,t,"Other specified complication of internal orthopedic prosthetic devices, implants and grafts, initial encounter",Injury or poisoning,75,59,75,-0.213333333,0.271186441,0,435,457,441,22,-16,6
t8501xa,t,"Breakdown (mechanical) of ventricular intracranial (communicating) shunt, initial encounter",Injury or poisoning,73,85,92,0.164383562,0.082352941,0.260273973,440,416,415,-24,-1,-25
t8509xa,t,"Other mechanical complication of ventricular intracranial (communicating) shunt, initial encounter",Injury or poisoning,31,30,34,-0.032258065,0.133333333,0.096774194,545,544,523,-1,-21,-22
t85520a,t,"Displacement of bile duct prosthesis, initial encounter",Injury or poisoning,28,29,35,0.035714286,0.206896552,0.25,556,549,522,-7,-27,-34
t85528a,t,"Displacement of other gastrointestinal prosthetic devices, implants and grafts, initial encounter",Injury or poisoning,26,44,58,0.692307692,0.318181818,1.230769231,565,498,469,-67,-29,-96
t85590a,t,"Other mechanical complication of bile duct prosthesis, initial encounter",Injury or poisoning,49,47,49,-0.040816327,0.042553191,0,491,488,487,-3,-1,-4
t85598a,t,"Other mechanical complication of other gastrointestinal prosthetic devices, implants and grafts, initial encounter",Injury or poisoning,19,19,20,0,0.052631579,0.052631579,611,603,593,-8,-10,-18
t85611a,t,"Breakdown (mechanical) of intraperitoneal dialysis catheter, initial encounter",Injury or poisoning,42,47,47,0.119047619,0,0.119047619,501,488,491,-13,3,-10
t85615a,t,"Breakdown (mechanical) of other nervous system device, implant or graft, initial encounter",Injury or poisoning,14,11,13,-0.214285714,0.181818182,-0.071428571,638,651,633,13,-18,-5
t85618a,t,"Breakdown (mechanical) of other specified internal prosthetic devices, implants and grafts, initial encounter",Injury or poisoning,21,23,21,0.095238095,-0.086956522,0,599,581,585,-18,4,-14
t85628a,t,"Displacement of other specified internal prosthetic devices, implants and grafts, initial encounter",Injury or poisoning,55,49,62,-0.109090909,0.265306122,0.127272727,476,479,459,3,-20,-17
t85638a,t,"Leakage of other specified internal prosthetic devices, implants and grafts, initial encounter",Injury or poisoning,19,20,24,0.052631579,0.2,0.263157895,608,595,569,-13,-26,-39
t85694a,t,"Other mechanical complication of insulin pump, initial encounter",Injury or poisoning,17,22,23,0.294117647,0.045454545,0.352941176,617,583,571,-34,-12,-46
t85698a,t,"Other mechanical complication of other specified internal prosthetic devices, implants and grafts, initial encounter",Injury or poisoning,29,31,36,0.068965517,0.161290323,0.24137931,551,534,516,-17,-18,-35
t8571xa,t,"Infection and inflammatory reaction due to peritoneal dialysis catheter, initial encounter",Injury or poisoning,52,41,51,-0.211538462,0.243902439,-0.019230769,483,504,480,21,-24,-3
t85730a,t,"Infection and inflammatory reaction due to ventricular intracranial (communicating) shunt, initial encounter",Injury or poisoning,24,24,25,0,0.041666667,0.041666667,576,568,558,-8,-10,-18
t8579xa,t,"Infection and inflammatory reaction due to other internal prosthetic devices, implants and grafts, initial encounter",Injury or poisoning,161,140,138,-0.130434783,-0.014285714,-0.142857143,355,368,359,13,-9,4
t85848a,t,"Pain due to other internal prosthetic devices, implants and grafts, initial encounter",Injury or poisoning,38,29,23,-0.236842105,-0.206896552,-0.394736842,515,542,567,27,25,52
t85858a,t,"Stenosis due to other internal prosthetic devices, implants and grafts, initial encounter",Injury or poisoning,22,14,27,-0.363636364,0.928571429,0.227272727,586,627,546,41,-81,-40
t85898a,t,"Other specified complication of other internal prosthetic devices, implants and grafts, initial encounter",Injury or poisoning,60,58,53,-0.033333333,-0.086206897,-0.116666667,465,457,477,-8,20,12
t859xxa,t,"Unspecified complication of internal prosthetic device, implant and graft, initial encounter",Injury or poisoning,25,27,29,0.08,0.074074074,0.16,564,550,536,-14,-14,-28
t8609,t,Other complications of bone marrow transplant,Injury or poisoning,38,26,23,-0.315789474,-0.115384615,-0.394736842,514,555,564,41,9,50
t8611,t,Kidney transplant rejection,Injury or poisoning,151,156,154,0.033112583,-0.012820513,0.01986755,365,352,348,-13,-4,-17
t8612,t,Kidney transplant failure,Injury or poisoning,356,328,320,-0.078651685,-0.024390244,-0.101123596,253,257,266,4,9,13
t8613,t,Kidney transplant infection,Injury or poisoning,111,94,77,-0.153153153,-0.180851064,-0.306306306,396,402,434,6,32,38
t8619,t,Other complication of kidney transplant,Injury or poisoning,739,659,728,-0.108254398,0.104704097,-0.01488498,183,193,184,10,-9,1
t8621,t,Heart transplant rejection,Injury or poisoning,21,22,10,0.047619048,-0.545454545,-0.523809524,585,571,634,-14,63,49
t86290,t,Cardiac allograft vasculopathy,Injury or poisoning,31,35,28,0.129032258,-0.2,-0.096774194,533,514,537,-19,23,4
t86298,t,Other complications of heart transplant,Injury or poisoning,22,20,22,-0.090909091,0.1,0,578,580,563,2,-17,-15
t8641,t,Liver transplant rejection,Injury or poisoning,67,70,66,0.044776119,-0.057142857,-0.014925373,445,432,446,-13,14,1
t8642,t,Liver transplant failure,Injury or poisoning,23,12,19,-0.47826087,0.583333333,-0.173913043,570,625,576,55,-49,6
t8649,t,Other complications of liver transplant,Injury or poisoning,81,63,78,-0.222222222,0.238095238,-0.037037037,426,444,432,18,-12,6
t865,t,Complications of stem cell transplant,Injury or poisoning,132,114,98,-0.136363636,-0.140350877,-0.257575758,374,384,404,10,20,30
t86810,t,Lung transplant rejection,Injury or poisoning,59,45,69,-0.237288136,0.533333333,0.169491525,459,480,440,21,-40,-19
t86812,t,Lung transplant infection,Injury or poisoning,36,31,64,-0.138888889,1.064516129,0.777777778,511,522,444,11,-78,-67
t86818,t,Other complications of lung transplant,Injury or poisoning,75,79,79,0.053333333,0,0.053333333,428,418,428,-10,10,0
t86819,t,Unspecified complication of lung transplant,Injury or poisoning,51,36,17,-0.294117647,-0.527777778,-0.666666667,474,506,578,32,72,104
t86821,t,Skin graft (allograft) (autograft) failure,Injury or poisoning,40,18,37,-0.55,1.055555556,-0.075,492,579,498,87,-81,6
t86822,t,Skin graft (allograft) (autograft) infection,Injury or poisoning,28,18,16,-0.357142857,-0.111111111,-0.428571429,534,579,580,45,1,46
t86828,t,Other complications of skin graft (allograft) (autograft),Injury or poisoning,10,17,15,0.7,-0.117647059,0.5,628,587,587,-41,0,-41
t86891,t,Other transplanted tissue failure,Injury or poisoning,17,18,10,0.058823529,-0.444444444,-0.411764706,591,579,621,-12,42,30
t8743,t,"Infection of amputation stump, right lower extremity",Injury or poisoning,187,148,139,-0.20855615,-0.060810811,-0.256684492,331,359,352,28,-7,21
t8744,t,"Infection of amputation stump, left lower extremity",Injury or poisoning,164,159,135,-0.030487805,-0.150943396,-0.176829268,348,346,359,-2,13,11
t8753,t,"Necrosis of amputation stump, right lower extremity",Injury or poisoning,31,25,18,-0.193548387,-0.28,-0.419354839,523,543,572,20,29,49
t8754,t,"Necrosis of amputation stump, left lower extremity",Injury or poisoning,26,10,15,-0.615384615,0.5,-0.423076923,539,622,584,83,-38,45
t8781,t,Dehiscence of amputation stump,Injury or poisoning,163,150,158,-0.079754601,0.053333333,-0.030674847,349,355,342,6,-13,-7
t8789,t,Other complications of amputation stump,Injury or poisoning,110,121,116,0.1,-0.041322314,0.054545455,391,376,377,-15,1,-14
t884xxa,t,"Failed or difficult intubation, initial encounter",Injury or poisoning,250,244,100,-0.024,-0.590163934,-0.6,298,298,395,0,97,97
t8859xa,t,"Other complications of anesthesia, initial encounter",Injury or poisoning,81,42,33,-0.481481481,-0.214285714,-0.592592593,420,485,504,65,19,84
t886xxa,t,"Anaphylactic reaction due to adverse effect of correct drug or medicament properly administered, initial encounter",Injury or poisoning,86,81,72,-0.058139535,-0.111111111,-0.162790698,413,410,428,-3,18,15
t887xxa,t,"Unspecified adverse effect of drug or medicament, initial encounter",Injury or poisoning,12,10,10,-0.166666667,0,-0.166666667,607,617,612,10,-5,5
t888xxa,t,"Other specified complications of surgical and medical care, not elsewhere classified, initial encounter",Injury or poisoning,31,13,15,-0.580645161,0.153846154,-0.516129032,518,600,579,82,-21,61
z00129,z,Encounter for routine child health examination without abnormal findings,Other health services,91,103,22,0.131868132,-0.786407767,-0.758241758,409,384,549,-25,165,140
z006,z,Encounter for examination for normal comparison and control in clinical research program,Other health services,1996,1989,2474,-0.003507014,0.243841126,0.239478958,92,89,76,-3,-13,-16
z0110,z,Encounter for examination of ears and hearing without abnormal findings,Other health services,1501,1709,1543,0.138574284,-0.097132826,0.027981346,120,109,120,-11,11,0
z01118,z,Encounter for examination of ears and hearing with other abnormal findings,Other health services,37,85,79,1.297297297,-0.070588235,1.135135135,494,402,421,-92,19,-73
z01810,z,Encounter for preprocedural cardiovascular examination,Other health services,70,70,43,0,-0.385714286,-0.385714286,425,420,481,-5,61,56
z01811,z,Encounter for preprocedural respiratory examination,Other health services,29,29,22,0,-0.24137931,-0.24137931,519,517,545,-2,28,26
z01812,z,Encounter for preprocedural laboratory examination,Other health services,10,14,167,0.4,10.92857143,15.7,610,592,333,-18,-259,-277
z01818,z,Encounter for other preprocedural examination,Other health services,70,81,64,0.157142857,-0.209876543,-0.085714286,425,406,433,-19,27,8
z029,z,"Encounter for administrative examinations, unspecified",Other health services,240,237,118,-0.0125,-0.502109705,-0.508333333,299,303,371,4,68,72
z0389,z,Encounter for observation for other suspected diseases and conditions ruled out,Other health services,21,52,25,1.476190476,-0.519230769,0.19047619,555,448,528,-107,80,-27
z046,z,"Encounter for general psychiatric examination, requested by authority",Other health services,34,45,49,0.323529412,0.088888889,0.441176471,499,465,461,-34,-4,-38
z050,z,Observation and evaluation of newborn for suspected cardiac condition ruled out,Other health services,48,56,44,0.166666667,-0.214285714,-0.083333333,465,439,474,-26,35,9
z051,z,Observation and evaluation of newborn for suspected infectious condition ruled out,Other health services,4623,4328,5305,-0.063811378,0.225739372,0.147523253,56,58,52,2,-6,-4
z052,z,Observation and evaluation of newborn for suspected neurological condition ruled out,Other health services,12,20,12,0.666666667,-0.4,0,594,553,586,-41,33,-8
z053,z,Observation and evaluation of newborn for suspected respiratory condition ruled out,Other health services,18,19,17,0.055555556,-0.105263158,-0.055555556,566,555,556,-11,1,-10
z0542,z,Observation and evaluation of newborn for suspected metabolic condition ruled out,Other health services,317,406,803,0.280757098,0.977832512,1.533123028,267,236,168,-31,-68,-99
z056,z,Observation and evaluation of newborn for suspected genitourinary condition ruled out,Other health services,14,17,18,0.214285714,0.058823529,0.285714286,583,563,553,-20,-10,-30
z0572,z,Observation and evaluation of newborn for suspected musculoskeletal condition ruled out,Other health services,22,18,38,-0.181818182,1.111111111,0.727272727,546,556,480,10,-76,-66
z058,z,Observation and evaluation of newborn for other specified suspected condition ruled out,Other health services,228,263,276,0.153508772,0.049429658,0.210526316,303,279,279,-24,0,-24
z09,z,Encounter for follow-up examination after completed treatment for conditions other than malignant neoplasm,Other health services,20,38,134,0.9,2.526315789,5.7,553,481,352,-72,-129,-201
z111,z,Encounter for screening for respiratory tuberculosis,Other health services,498,761,863,0.52811245,0.134034166,0.732931727,216,173,161,-43,-12,-55
z113,z,Encounter for screening for infections with a predominantly sexual mode of transmission,Other health services,26,43,46,0.653846154,0.069767442,0.769230769,519,467,465,-52,-2,-54
z114,z,Encounter for screening for human immunodeficiency virus [HIV],Other health services,229,533,1120,1.327510917,1.101313321,3.890829694,301,200,137,-101,-63,-164
z1159,z,Encounter for screening for other viral diseases,Other health services,219,6883,8005,30.42922374,0.163010315,35.55251142,308,39,34,-269,-5,-274
z13228,z,Encounter for screening for other metabolic disorders,Other health services,1447,1049,1085,-0.275051831,0.034318398,-0.250172771,120,142,140,22,-2,20
z141,z,Cystic fibrosis carrier,Other health services,53,49,66,-0.075471698,0.346938776,0.245283019,450,447,423,-3,-24,-27
z148,z,Genetic carrier of other disease,Other health services,54,69,72,0.277777778,0.043478261,0.333333333,448,413,415,-35,2,-33
z1501,z,Genetic susceptibility to malignant neoplasm of breast,Other health services,124,76,88,-0.387096774,0.157894737,-0.290322581,363,403,398,40,-5,35
z1509,z,Genetic susceptibility to other malignant neoplasm,Other health services,42,55,47,0.30952381,-0.145454545,0.119047619,463,434,453,-29,19,-10
z1589,z,Genetic susceptibility to other disease,Other health services,16,25,21,0.5625,-0.16,0.3125,559,514,527,-45,13,-32
z1611,z,Resistance to penicillins,Other health services,391,375,387,-0.040920716,0.032,-0.010230179,236,239,237,3,-2,1
z1612,z,Extended spectrum beta lactamase (ESBL) resistance,Other health services,811,828,763,0.020961776,-0.078502415,-0.05918619,170,160,171,-10,11,1
z1619,z,Resistance to other specified beta lactam antibiotics,Other health services,161,150,160,-0.068322981,0.066666667,-0.00621118,337,342,328,5,-14,-9
z1620,z,Resistance to unspecified antibiotic,Other health services,15,15,28,0,0.866666667,0.866666667,559,554,497,-5,-57,-62
z1621,z,Resistance to vancomycin,Other health services,308,372,344,0.207792208,-0.075268817,0.116883117,265,238,245,-27,7,-20
z1622,z,Resistance to vancomycin related antibiotics,Other health services,32,33,40,0.03125,0.212121212,0.25,490,479,463,-11,-16,-27
z1623,z,Resistance to quinolones and fluoroquinolones,Other health services,298,254,302,-0.147651007,0.188976378,0.013422819,272,274,264,2,-10,-8
z1624,z,Resistance to multiple antibiotics,Other health services,1164,1252,1312,0.075601375,0.047923323,0.127147766,132,127,128,-5,1,-4
z1629,z,Resistance to other single specified antibiotic,Other health services,171,204,190,0.192982456,-0.068627451,0.111111111,328,302,310,-26,8,-18
z1630,z,Resistance to unspecified antimicrobial drugs,Other health services,62,58,120,-0.064516129,1.068965517,0.935483871,424,420,354,-4,-66,-70
z1635,z,Resistance to multiple antimicrobial drugs,Other health services,63,60,44,-0.047619048,-0.266666667,-0.301587302,422,417,453,-5,36,31
z1639,z,Resistance to other specified antimicrobial drug,Other health services,70,50,72,-0.285714286,0.44,0.028571429,409,432,406,23,-26,-3
z170,z,Estrogen receptor positive status [ER+],Other health services,352,280,245,-0.204545455,-0.125,-0.303977273,244,265,287,21,22,43
z171,z,Estrogen receptor negative status [ER-],Other health services,121,111,121,-0.082644628,0.09009009,0,356,362,351,6,-11,-5
z1810,z,"Retained metal fragments, unspecified",Other health services,28,22,34,-0.214285714,0.545454545,0.214285714,491,517,461,26,-56,-30
z1889,z,Other specified retained foreign body fragments,Other health services,25,21,32,-0.16,0.523809524,0.28,503,521,470,18,-51,-33
z201,z,Contact with and (suspected) exposure to tuberculosis,Other health services,42,48,23,0.142857143,-0.520833333,-0.452380952,451,435,505,-16,70,54
z202,z,Contact with and (suspected) exposure to infections with a predominantly sexual mode of transmission,Other health services,65,62,95,-0.046153846,0.532258065,0.461538462,414,412,379,-2,-33,-35
z205,z,Contact with and (suspected) exposure to viral hepatitis,Other health services,70,58,76,-0.171428571,0.310344828,0.085714286,407,416,400,9,-16,-7
z206,z,Contact with and (suspected) exposure to human immunodeficiency virus [HIV],Other health services,35,35,36,0,0.028571429,0.028571429,469,463,458,-6,-5,-11
z20818,z,Contact with and (suspected) exposure to other bacterial communicable diseases,Other health services,697,1117,1643,0.602582496,0.470904208,1.357245337,184,133,110,-51,-23,-74
z20828,z,Contact with and (suspected) exposure to other viral communicable diseases,Other health services,69,17474,96083,252.2463768,4.498626531,1391.507246,407,11,2,-396,-9,-405
z2089,z,Contact with and (suspected) exposure to other communicable diseases,Other health services,24,24,11,0,-0.541666667,-0.541666667,504,499,553,-5,54,49
z21,z,Asymptomatic human immunodeficiency virus [HIV] infection status,Other health services,929,977,932,0.051668461,-0.046059365,0.003229279,148,143,148,-5,5,0
z221,z,Carrier of other intestinal infectious diseases,Other health services,88,50,54,-0.431818182,0.08,-0.386363636,387,425,425,38,0,38
z22321,z,Carrier or suspected carrier of Methicillin susceptible Staphylococcus aureus,Other health services,32,37,30,0.15625,-0.189189189,-0.0625,474,456,470,-18,14,-4
z22322,z,Carrier or suspected carrier of Methicillin resistant Staphylococcus aureus,Other health services,383,299,273,-0.219321149,-0.086956522,-0.287206266,234,255,271,21,16,37
z22330,z,Carrier of Group B streptococcus,Other health services,76,51,17,-0.328947368,-0.666666667,-0.776315789,394,421,515,27,94,121
z2239,z,Carrier of other specified bacterial diseases,Other health services,116,76,68,-0.344827586,-0.105263158,-0.413793103,362,390,403,28,13,41
z224,z,Carrier of infections with a predominantly sexual mode of transmission,Other health services,12,12,16,0,0.333333333,0.333333333,549,547,515,-2,-32,-34
z227,z,Latent tuberculosis,Other health services,87,193,127,1.218390805,-0.341968912,0.459770115,385,306,343,-79,37,-42
z228,z,Carrier of other infectious diseases,Other health services,26,15,16,-0.423076923,0.066666667,-0.384615385,485,528,514,43,-14,29
z23,z,Encounter for immunization,Other health services,52421,42832,49784,-0.182922874,0.162308554,-0.050304267,3,4,4,1,0,1
z2809,z,Immunization not carried out because of other contraindication,Other health services,220,241,255,0.095454545,0.058091286,0.159090909,296,279,280,-17,1,-16
z2820,z,Immunization not carried out because of patient decision for unspecified reason,Other health services,17,17,27,0,0.588235294,0.588235294,523,519,473,-4,-46,-50
z2821,z,Immunization not carried out because of patient refusal,Other health services,3346,2873,3297,-0.141362821,0.147580926,-0.014644351,63,68,64,5,-4,1
z283,z,Underimmunization status,Other health services,219,241,156,0.100456621,-0.352697095,-0.287671233,295,278,319,-17,41,24
z2881,z,Immunization not carried out due to patient having had the disease,Other health services,19,15,15,-0.210526316,0,-0.210526316,513,523,514,10,-9,1
z2882,z,Immunization not carried out because of caregiver refusal,Other health services,1986,1734,2261,-0.126888218,0.303921569,0.138469285,89,101,83,12,-18,-6
z2889,z,Immunization not carried out for other reason,Other health services,179,200,121,0.117318436,-0.395,-0.324022346,311,293,341,-18,48,30
z289,z,Immunization not carried out for unspecified reason,Other health services,71,47,60,-0.338028169,0.276595745,-0.154929577,392,422,400,30,-22,8
z2913,z,Encounter for prophylactic Rho(D) immune globulin,Other health services,15,16,12,0.066666667,-0.25,-0.2,523,519,530,-4,11,7
z298,z,Encounter for other specified prophylactic measures,Other health services,15,10,13,-0.333333333,0.3,-0.133333333,523,544,524,21,-20,1
z30017,z,Encounter for initial prescription of implantable subdermal contraceptive,Other health services,33,40,26,0.212121212,-0.35,-0.212121212,460,438,473,-22,35,13
z302,z,Encounter for sterilization,Other health services,2143,1828,2032,-0.146990201,0.111597374,-0.051796547,84,96,92,12,-4,8
z30430,z,Encounter for insertion of intrauterine contraceptive device,Other health services,103,112,132,0.087378641,0.178571429,0.281553398,361,349,331,-12,-18,-30
z30432,z,Encounter for removal of intrauterine contraceptive device,Other health services,11,11,11,0,0,0,534,535,530,1,-5,-4
z331,z,"Pregnant state, incidental",Other health services,34,44,50,0.294117647,0.136363636,0.470588235,454,425,418,-29,-7,-36
z3403,z,"Encounter for supervision of normal first pregnancy, third trimester",Other health services,2259,1794,2052,-0.205843293,0.143812709,-0.091633466,83,96,91,13,-5,8
z3482,z,"Encounter for supervision of other normal pregnancy, second trimester",Other health services,21,13,23,-0.380952381,0.769230769,0.095238095,498,524,481,26,-43,-17
z3483,z,"Encounter for supervision of other normal pregnancy, third trimester",Other health services,5603,4389,5280,-0.216669641,0.203007519,-0.057647689,47,54,49,7,-5,2
z3490,z,"Encounter for supervision of normal pregnancy, unspecified, unspecified trimester",Other health services,19,30,27,0.578947368,-0.1,0.421052632,503,455,463,-48,8,-40
z3493,z,"Encounter for supervision of normal pregnancy, unspecified, third trimester",Other health services,74,56,24,-0.243243243,-0.571428571,-0.675675676,385,401,477,16,76,92
z3a00,z,Weeks of gestation of pregnancy not specified,Other health services,146,124,113,-0.150684932,-0.088709677,-0.226027397,330,341,343,11,2,13
z3a01,z,Less than 8 weeks gestation of pregnancy,Other health services,117,91,124,-0.222222222,0.362637363,0.05982906,350,363,335,13,-28,-15
z3a08,z,8 weeks gestation of pregnancy,Other health services,39,45,47,0.153846154,0.044444444,0.205128205,435,416,419,-19,3,-16
z3a09,z,9 weeks gestation of pregnancy,Other health services,28,40,26,0.428571429,-0.35,-0.071428571,461,429,464,-32,35,3
z3a10,z,10 weeks gestation of pregnancy,Other health services,31,30,29,-0.032258065,-0.033333333,-0.064516129,455,450,454,-5,4,-1
z3a11,z,11 weeks gestation of pregnancy,Other health services,40,24,34,-0.4,0.416666667,-0.15,430,472,436,42,-36,6
z3a12,z,12 weeks gestation of pregnancy,Other health services,36,30,33,-0.166666667,0.1,-0.083333333,443,450,440,7,-10,-3
z3a13,z,13 weeks gestation of pregnancy,Other health services,39,28,26,-0.282051282,-0.071428571,-0.333333333,434,454,461,20,7,27
z3a14,z,14 weeks gestation of pregnancy,Other health services,39,30,32,-0.230769231,0.066666667,-0.179487179,434,450,443,16,-7,9
z3a15,z,15 weeks gestation of pregnancy,Other health services,32,49,45,0.53125,-0.081632653,0.40625,449,409,424,-40,15,-25
z3a16,z,16 weeks gestation of pregnancy,Other health services,55,51,54,-0.072727273,0.058823529,-0.018181818,408,406,409,-2,3,1
z3a17,z,17 weeks gestation of pregnancy,Other health services,62,56,56,-0.096774194,0,-0.096774194,396,399,407,3,8,11
z3a18,z,18 weeks gestation of pregnancy,Other health services,68,68,70,0,0.029411765,0.029411765,387,386,387,-1,1,0
z3a19,z,19 weeks gestation of pregnancy,Other health services,64,61,64,-0.046875,0.049180328,0,391,394,389,3,-5,-2
z3a20,z,20 weeks gestation of pregnancy,Other health services,82,86,96,0.048780488,0.11627907,0.170731707,377,367,360,-10,-7,-17
z3a21,z,21 weeks gestation of pregnancy,Other health services,64,73,69,0.140625,-0.054794521,0.078125,390,380,386,-10,6,-4
z3a22,z,22 weeks gestation of pregnancy,Other health services,99,89,99,-0.101010101,0.112359551,0,360,364,357,4,-7,-3
z3a23,z,23 weeks gestation of pregnancy,Other health services,86,84,101,-0.023255814,0.202380952,0.174418605,373,367,352,-6,-15,-21
z3a24,z,24 weeks gestation of pregnancy,Other health services,121,109,116,-0.099173554,0.064220183,-0.041322314,343,346,339,3,-7,-4
z3a25,z,25 weeks gestation of pregnancy,Other health services,99,93,90,-0.060606061,-0.032258065,-0.090909091,359,359,362,0,3,3
z3a26,z,26 weeks gestation of pregnancy,Other health services,113,103,103,-0.088495575,0,-0.088495575,352,348,350,-4,2,-2
z3a27,z,27 weeks gestation of pregnancy,Other health services,130,81,128,-0.376923077,0.580246914,-0.015384615,340,366,332,26,-34,-8
z3a28,z,28 weeks gestation of pregnancy,Other health services,163,132,139,-0.190184049,0.053030303,-0.147239264,319,336,321,17,-15,2
z3a29,z,29 weeks gestation of pregnancy,Other health services,172,137,147,-0.203488372,0.072992701,-0.145348837,314,332,319,18,-13,5
z3a30,z,30 weeks gestation of pregnancy,Other health services,211,164,195,-0.222748815,0.18902439,-0.075829384,293,308,294,15,-14,1
z3a31,z,31 weeks gestation of pregnancy,Other health services,240,200,216,-0.166666667,0.08,-0.1,280,290,285,10,-5,5
z3a32,z,32 weeks gestation of pregnancy,Other health services,329,272,309,-0.17325228,0.136029412,-0.060790274,243,257,250,14,-7,7
z3a33,z,33 weeks gestation of pregnancy,Other health services,404,349,379,-0.136138614,0.085959885,-0.061881188,221,231,227,10,-4,6
z3a34,z,34 weeks gestation of pregnancy,Other health services,606,554,550,-0.085808581,-0.007220217,-0.092409241,186,184,187,-2,3,1
z3a35,z,35 weeks gestation of pregnancy,Other health services,881,742,818,-0.157775255,0.102425876,-0.071509648,151,160,151,9,-9,0
z3a36,z,36 weeks gestation of pregnancy,Other health services,1679,1452,1608,-0.135199524,0.107438017,-0.042287076,105,110,108,5,-2,3
z3a37,z,37 weeks gestation of pregnancy,Other health services,4098,3778,4103,-0.078086872,0.086024352,0.001220107,56,56,58,0,2,2
z3a38,z,38 weeks gestation of pregnancy,Other health services,7192,6542,6685,-0.090378198,0.021858759,-0.070494994,38,38,37,0,-1,-1
z3a39,z,39 weeks gestation of pregnancy,Other health services,15684,14258,14803,-0.090920683,0.038224155,-0.056171895,13,13,14,0,1,1
z3a40,z,40 weeks gestation of pregnancy,Other health services,7133,6347,6814,-0.110192065,0.073578068,-0.044721716,37,37,35,0,-2,-2
z3a41,z,41 weeks gestation of pregnancy,Other health services,1733,1611,1816,-0.070398153,0.127250155,0.047893826,98,99,92,1,-7,-6
z3a42,z,42 weeks gestation of pregnancy,Other health services,52,41,50,-0.211538462,0.219512195,-0.038461538,387,398,388,11,-10,1
z3a49,z,Greater than 42 weeks gestation of pregnancy,Other health services,10,17,13,0.7,-0.235294118,0.3,497,469,478,-28,9,-19
z370,z,Single live birth,Other health services,38772,35075,37060,-0.095352316,0.056593015,-0.044155576,4,4,4,0,0,0
z371,z,Single stillbirth,Other health services,294,292,302,-0.006802721,0.034246575,0.027210884,252,241,243,-11,2,-9
z372,z,"Twins, both liveborn",Other health services,596,539,556,-0.095637584,0.031539889,-0.067114094,178,177,178,-1,1,0
z373,z,"Twins, one liveborn and one stillborn",Other health services,17,13,10,-0.235294118,-0.230769231,-0.411764706,468,480,487,12,7,19
z3800,z,"Single liveborn infant, delivered vaginally",Other health services,28096,25401,26595,-0.095921128,0.047006023,-0.053423975,6,6,6,0,0,0
z3801,z,"Single liveborn infant, delivered by cesarean",Other health services,10652,9620,10457,-0.096883214,0.087006237,-0.018306421,20,23,20,3,-3,0
z381,z,"Single liveborn infant, born outside hospital",Other health services,134,117,120,-0.126865672,0.025641026,-0.104477612,319,325,316,6,-9,-3
z382,z,"Single liveborn infant, unspecified as to place of birth",Other health services,40,42,29,0.05,-0.30952381,-0.275,397,390,417,-7,27,20
z3830,z,"Twin liveborn infant, delivered vaginally",Other health services,305,229,266,-0.249180328,0.161572052,-0.127868852,241,266,253,25,-13,12
z3831,z,"Twin liveborn infant, delivered by cesarean",Other health services,875,834,825,-0.046857143,-0.010791367,-0.057142857,142,140,140,-2,0,-2
z3862,z,"Triplet liveborn infant, delivered by cesarean",Other health services,27,15,19,-0.444444444,0.266666667,-0.296296296,421,464,445,43,-19,24
z390,z,Encounter for care and examination of mother immediately after delivery,Other health services,116,85,94,-0.267241379,0.105882353,-0.189655172,327,341,334,14,-7,7
z4001,z,Encounter for prophylactic removal of breast,Other health services,25,15,12,-0.4,-0.2,-0.52,427,463,471,36,8,44
z412,z,Encounter for routine and ritual male circumcision,Other health services,330,195,304,-0.409090909,0.558974359,-0.078787879,228,276,237,48,-39,9
z421,z,Encounter for breast reconstruction following mastectomy,Other health services,46,39,58,-0.152173913,0.487179487,0.260869565,385,390,368,5,-22,-17
z428,z,Encounter for other plastic and reconstructive surgery following medical procedure or healed injury,Other health services,37,22,30,-0.405405405,0.363636364,-0.189189189,399,439,410,40,-29,11
z430,z,Encounter for attention to tracheostomy,Other health services,577,652,708,0.129982669,0.085889571,0.227036395,177,166,157,-11,-9,-20
z431,z,Encounter for attention to gastrostomy,Other health services,724,736,777,0.016574586,0.055706522,0.07320442,160,152,147,-8,-5,-13
z432,z,Encounter for attention to ileostomy,Other health services,326,292,275,-0.104294479,-0.058219178,-0.156441718,228,235,243,7,8,15
z433,z,Encounter for attention to colostomy,Other health services,348,308,307,-0.114942529,-0.003246753,-0.117816092,219,229,234,10,5,15
z434,z,Encounter for attention to other artificial openings of digestive tract,Other health services,66,36,31,-0.454545455,-0.138888889,-0.53030303,353,390,401,37,11,48
z436,z,Encounter for attention to other artificial openings of urinary tract,Other health services,142,149,159,0.049295775,0.067114094,0.11971831,305,299,288,-6,-11,-17
z45010,z,Encounter for checking and testing of cardiac pacemaker pulse generator [battery],Other health services,23,23,25,0,0.086956522,0.086956522,428,430,414,2,-16,-14
z45018,z,Encounter for adjustment and management of other part of cardiac pacemaker,Other health services,59,45,46,-0.237288136,0.022222222,-0.220338983,360,374,380,14,6,20
z4502,z,Encounter for adjustment and management of automatic implantable cardiac defibrillator,Other health services,93,64,64,-0.311827957,0,-0.311827957,337,351,352,14,1,15
z452,z,Encounter for adjustment and management of vascular access device,Other health services,40,28,58,-0.3,1.071428571,0.45,384,405,362,21,-43,-22
z4542,z,Encounter for adjustment and management of neurostimulator,Other health services,13,11,14,-0.153846154,0.272727273,0.076923077,458,465,446,7,-19,-12
z4659,z,Encounter for fitting and adjustment of other gastrointestinal appliance and device,Other health services,13,11,11,-0.153846154,0,-0.153846154,458,465,460,7,-5,2
z466,z,Encounter for fitting and adjustment of urinary device,Other health services,138,144,128,0.043478261,-0.111111111,-0.072463768,307,300,305,-7,5,-2
z471,z,Aftercare following joint replacement surgery,Other health services,296,206,202,-0.304054054,-0.019417476,-0.317567568,241,266,268,25,2,27
z472,z,Encounter for removal of internal fixation device,Other health services,25,18,29,-0.28,0.611111111,0.16,413,438,400,25,-38,-13
z4731,z,Aftercare following explantation of shoulder joint prosthesis,Other health services,11,10,15,-0.090909091,0.5,0.363636364,460,465,438,5,-27,-22
z4732,z,Aftercare following explantation of hip joint prosthesis,Other health services,38,28,18,-0.263157895,-0.357142857,-0.526315789,387,403,431,16,28,44
z4733,z,Aftercare following explantation of knee joint prosthesis,Other health services,62,65,45,0.048387097,-0.307692308,-0.274193548,353,348,376,-5,28,23
z4781,z,Encounter for orthopedic aftercare following surgical amputation,Other health services,260,253,212,-0.026923077,-0.162055336,-0.184615385,250,243,264,-7,21,14
z4789,z,Encounter for other orthopedic aftercare,Other health services,765,732,638,-0.043137255,-0.128415301,-0.166013072,157,153,162,-4,9,5
z4801,z,Encounter for change or removal of surgical wound dressing,Other health services,63,52,60,-0.174603175,0.153846154,-0.047619048,350,359,350,9,-9,0
z4802,z,Encounter for removal of sutures,Other health services,22,21,21,-0.045454545,0,-0.045454545,422,425,415,3,-10,-7
z4803,z,Encounter for change or removal of drains,Other health services,25,26,27,0.04,0.038461538,0.08,408,407,399,-1,-8,-9
z4821,z,Encounter for aftercare following heart transplant,Other health services,16,24,13,0.5,-0.458333333,-0.1875,438,412,442,-26,30,4
z4822,z,Encounter for aftercare following kidney transplant,Other health services,58,70,48,0.206896552,-0.314285714,-0.172413793,355,342,367,-13,25,12
z4823,z,Encounter for aftercare following liver transplant,Other health services,25,32,32,0.28,0,0.28,407,387,389,-20,2,-18
z4824,z,Encounter for aftercare following lung transplant,Other health services,20,17,19,-0.15,0.117647059,-0.05,425,433,420,8,-13,-5
z483,z,Aftercare following surgery for neoplasm,Other health services,152,133,100,-0.125,-0.248120301,-0.342105263,297,305,320,8,15,23
z48811,z,Encounter for surgical aftercare following surgery on the nervous system,Other health services,283,251,229,-0.113074205,-0.087649402,-0.190812721,241,243,258,2,15,17
z48812,z,Encounter for surgical aftercare following surgery on the circulatory system,Other health services,309,333,315,0.077669903,-0.054054054,0.019417476,232,217,230,-15,13,-2
z48815,z,Encounter for surgical aftercare following surgery on the digestive system,Other health services,154,164,158,0.064935065,-0.036585366,0.025974026,292,280,283,-12,3,-9
z48816,z,Encounter for surgical aftercare following surgery on the genitourinary system,Other health services,15,21,23,0.4,0.095238095,0.533333333,433,417,404,-16,-13,-29
z48817,z,Encounter for surgical aftercare following surgery on the skin and subcutaneous tissue,Other health services,75,77,96,0.026666667,0.246753247,0.28,336,331,319,-5,-12,-17
z4889,z,Encounter for other specified surgical aftercare,Other health services,120,95,101,-0.208333333,0.063157895,-0.158333333,306,320,314,14,-6,8
z4902,z,Encounter for fitting and adjustment of peritoneal dialysis catheter,Other health services,15,12,16,-0.2,0.333333333,0.066666667,431,441,416,10,-25,-15
z510,z,Encounter for antineoplastic radiation therapy,Other health services,40,51,25,0.275,-0.509803922,-0.375,371,352,395,-19,43,24
z5111,z,Encounter for antineoplastic chemotherapy,Other health services,1324,1225,1084,-0.074773414,-0.115102041,-0.181268882,109,111,122,2,11,13
z5112,z,Encounter for antineoplastic immunotherapy,Other health services,52,69,90,0.326923077,0.304347826,0.730769231,355,336,320,-19,-16,-35
z515,z,Encounter for palliative care,Other health services,10297,11180,13166,0.085753132,0.17763864,0.278624842,21,17,13,-4,-4,-8
z5181,z,Encounter for therapeutic drug level monitoring,Other health services,165,147,262,-0.109090909,0.782312925,0.587878788,285,291,243,6,-48,-42
z5189,z,Encounter for other specified aftercare,Other health services,59,38,39,-0.355932203,0.026315789,-0.338983051,344,366,367,22,1,23
z524,z,Kidney donor,Other health services,75,19,31,-0.746666667,0.631578947,-0.586666667,332,413,378,81,-35,46
z529,z,Donor of unspecified organ or tissue,Other health services,24,46,59,0.916666667,0.282608696,1.458333333,397,354,343,-43,-11,-54
z5309,z,Procedure and treatment not carried out because of other contraindication,Other health services,419,391,395,-0.066825776,0.010230179,-0.057279236,199,205,205,6,0,6
z531,z,Procedure and treatment not carried out because of patient's decision for reasons of belief and group pressure,Other health services,96,77,101,-0.197916667,0.311688312,0.052083333,321,326,310,5,-16,-11
z5320,z,Procedure and treatment not carried out because of patient's decision for unspecified reasons,Other health services,577,504,676,-0.126516464,0.341269841,0.171577123,173,177,155,4,-22,-18
z5321,z,Procedure and treatment not carried out due to patient leaving prior to being seen by health care provider,Other health services,156,84,85,-0.461538462,0.011904762,-0.455128205,286,321,322,35,1,36
z5329,z,Procedure and treatment not carried out because of patient's decision for other reasons,Other health services,774,1101,1638,0.42248062,0.48773842,1.11627907,152,116,95,-36,-21,-57
z5331,z,Laparoscopic surgical procedure converted to open procedure,Other health services,863,734,769,-0.149478563,0.047683924,-0.108922364,141,149,145,8,-4,4
z5332,z,Thoracoscopic surgical procedure converted to open procedure,Other health services,44,34,43,-0.227272727,0.264705882,-0.022727273,352,363,356,11,-7,4
z5339,z,Other specified procedure converted to open procedure,Other health services,27,19,20,-0.296296296,0.052631579,-0.259259259,380,405,394,25,-11,14
z538,z,Procedure and treatment not carried out for other reasons,Other health services,319,324,366,0.015673981,0.12962963,0.147335423,223,212,208,-11,-4,-15
z539,z,"Procedure and treatment not carried out, unspecified reason",Other health services,193,163,199,-0.155440415,0.220858896,0.031088083,266,275,257,9,-18,-9
z558,z,Other problems related to education and literacy,Other health services,44,18,31,-0.590909091,0.722222222,-0.295454545,350,403,368,53,-35,18
z559,z,"Problems related to education and literacy, unspecified",Other health services,203,142,86,-0.300492611,-0.394366197,-0.57635468,262,285,314,23,29,52
z560,z,"Unemployment, unspecified",Other health services,5141,5027,5831,-0.022174674,0.159936344,0.134215133,44,40,35,-4,-5,-9
z5689,z,Other problems related to employment,Other health services,23,15,10,-0.347826087,-0.333333333,-0.565217391,387,408,419,21,11,32
z569,z,Unspecified problems related to employment,Other health services,86,64,80,-0.255813953,0.25,-0.069767442,317,325,319,8,-6,2
z574,z,Occupational exposure to toxic agents in agriculture,Other health services,14,13,10,-0.071428571,-0.230769231,-0.285714286,411,414,418,3,4,7
z575,z,Occupational exposure to toxic agents in other industries,Other health services,19,18,14,-0.052631579,-0.222222222,-0.263157895,398,400,402,2,2,4
z590,z,Homelessness,Other health services,11182,11127,11355,-0.004918619,0.020490698,0.015471293,19,17,16,-2,-1,-3
z591,z,Inadequate housing,Other health services,22,20,22,-0.090909091,0.1,0,389,397,381,8,-16,-8
z596,z,Low income,Other health services,99,78,58,-0.212121212,-0.256410256,-0.414141414,306,316,334,10,18,28
z597,z,Insufficient social insurance and welfare support,Other health services,120,142,172,0.183333333,0.211267606,0.433333333,293,283,264,-10,-19,-29
z598,z,Other problems related to housing and economic circumstances,Other health services,258,109,99,-0.57751938,-0.091743119,-0.61627907,238,297,303,59,6,65
z599,z,"Problem related to housing and economic circumstances, unspecified",Other health services,719,439,378,-0.389429764,-0.138952164,-0.474269819,154,188,203,34,15,49
z602,z,Problems related to living alone,Other health services,1278,1302,2260,0.018779343,0.735791091,0.768388106,107,107,72,0,-35,-35
z604,z,Social exclusion and rejection,Other health services,18,32,86,0.777777778,1.6875,3.777777778,394,356,308,-38,-48,-86
z608,z,Other problems related to social environment,Other health services,137,98,122,-0.284671533,0.244897959,-0.109489051,284,298,286,14,-12,2
z609,z,"Problem related to social environment, unspecified",Other health services,907,847,810,-0.06615215,-0.043683589,-0.106945976,130,131,135,1,4,5
z6221,z,Child in welfare custody,Other health services,422,409,270,-0.030805687,-0.339853301,-0.360189573,189,193,230,4,37,41
z62810,z,Personal history of physical and sexual abuse in childhood,Other health services,5353,4978,5198,-0.070054175,0.044194456,-0.028955726,40,39,40,-1,1,0
z62811,z,Personal history of psychological abuse in childhood,Other health services,2443,2680,3093,0.097011871,0.154104478,0.266066312,63,57,53,-6,-4,-10
z62812,z,Personal history of neglect in childhood,Other health services,693,639,596,-0.077922078,-0.067292645,-0.13997114,153,154,156,1,2,3
z62813,z,Personal history of forced labor or sexual exploitation in childhood,Other health services,11,28,30,1.545454545,0.071428571,1.727272727,402,359,354,-43,-5,-48
z62819,z,Personal history of unspecified abuse in childhood,Other health services,112,134,125,0.196428571,-0.067164179,0.116071429,290,280,280,-10,0,-10
z62820,z,Parent-biological child conflict,Other health services,252,264,203,0.047619048,-0.231060606,-0.194444444,232,220,245,-12,25,13
z62821,z,Parent-adopted child conflict,Other health services,34,33,26,-0.029411765,-0.212121212,-0.235294118,347,346,358,-1,12,11
z62890,z,Parent-child estrangement NEC,Other health services,16,13,21,-0.1875,0.615384615,0.3125,388,395,366,7,-29,-22
z630,z,Problems in relationship with spouse or partner,Other health services,322,259,331,-0.195652174,0.277992278,0.027950311,211,222,208,11,-14,-3
z6332,z,Other absence of family member,Other health services,21,27,19,0.285714286,-0.296296296,-0.095238095,376,357,371,-19,14,-5
z634,z,Disappearance and death of family member,Other health services,534,498,639,-0.06741573,0.28313253,0.196629213,169,169,150,0,-19,-19
z635,z,Disruption of family by separation and divorce,Other health services,221,227,340,0.027149321,0.497797357,0.538461538,241,238,205,-3,-33,-36
z636,z,Dependent relative needing care at home,Other health services,27,26,20,-0.037037037,-0.230769231,-0.259259259,356,359,366,3,7,10
z6379,z,Other stressful life events affecting family and household,Other health services,61,70,51,0.147540984,-0.271428571,-0.163934426,312,306,323,-6,17,11
z638,z,Other specified problems related to primary support group,Other health services,397,343,377,-0.136020151,0.099125364,-0.050377834,192,199,198,7,-1,6
z639,z,"Problem related to primary support group, unspecified",Other health services,529,499,464,-0.056710775,-0.070140281,-0.122873346,171,168,178,-3,10,7
z651,z,Imprisonment and other incarceration,Other health services,479,471,600,-0.016701461,0.27388535,0.252609603,176,173,154,-3,-19,-22
z652,z,Problems related to release from prison,Other health services,23,21,15,-0.086956522,-0.285714286,-0.347826087,363,370,370,7,0,7
z653,z,Problems related to other legal circumstances,Other health services,1258,1329,1489,0.056438792,0.120391272,0.183624801,107,103,95,-4,-8,-12
z658,z,Other specified problems related to psychosocial circumstances,Other health services,416,324,251,-0.221153846,-0.225308642,-0.396634615,183,198,227,15,29,44
z659,z,Problem related to unspecified psychosocial circumstances,Other health services,15,27,16,0.8,-0.407407407,0.066666667,377,349,364,-28,15,-13
z66,z,Do not resuscitate,Other health services,22819,24230,26544,0.061834436,0.095501444,0.163241159,7,6,6,-1,0,-1
z6710,z,"Type A blood, Rh positive",Other health services,22,24,11,0.090909091,-0.541666667,-0.5,363,355,381,-8,26,18
z6711,z,"Type A blood, Rh negative",Other health services,400,350,399,-0.125,0.14,-0.0025,185,194,188,9,-6,3
z6721,z,"Type B blood, Rh negative",Other health services,135,132,113,-0.022222222,-0.143939394,-0.162962963,269,270,273,1,3,4
z6731,z,"Type AB blood, Rh negative",Other health services,31,43,49,0.387096774,0.139534884,0.580645161,340,321,317,-19,-4,-23
z6740,z,"Type O blood, Rh positive",Other health services,33,17,16,-0.484848485,-0.058823529,-0.515151515,337,367,360,30,-7,23
z6741,z,"Type O blood, Rh negative",Other health services,457,470,494,0.028446389,0.05106383,0.080962801,175,171,169,-4,-2,-6
z6791,z,"Unspecified blood type, Rh negative",Other health services,391,381,364,-0.025575448,-0.044619423,-0.069053708,185,190,192,5,2,7
z681,z,"Body mass index [BMI] 19.9 or less, adult",Other health services,6585,6029,6599,-0.08443432,0.094543042,0.002126044,32,31,29,-1,-2,-3
z6820,z,"Body mass index [BMI] 20.0-20.9, adult",Other health services,949,959,962,0.010537408,0.003128259,0.01369863,120,118,119,-2,1,-1
z6821,z,"Body mass index [BMI] 21.0-21.9, adult",Other health services,918,848,867,-0.076252723,0.02240566,-0.055555556,123,124,126,1,2,3
z6822,z,"Body mass index [BMI] 22.0-22.9, adult",Other health services,884,766,829,-0.133484163,0.082245431,-0.062217195,128,135,126,7,-9,-2
z6823,z,"Body mass index [BMI] 23.0-23.9, adult",Other health services,853,710,802,-0.167643611,0.129577465,-0.05978898,129,140,128,11,-12,-1
z6824,z,"Body mass index [BMI] 24.0-24.9, adult",Other health services,698,742,736,0.063037249,-0.008086253,0.054441261,145,135,134,-10,-1,-11
z6825,z,"Body mass index [BMI] 25.0-25.9, adult",Other health services,767,710,923,-0.074315515,0.3,0.203389831,139,139,122,0,-17,-17
z6826,z,"Body mass index [BMI] 26.0-26.9, adult",Other health services,651,679,809,0.043010753,0.191458027,0.242703533,147,141,126,-6,-15,-21
z6827,z,"Body mass index [BMI] 27.0-27.9, adult",Other health services,814,716,912,-0.12039312,0.273743017,0.12039312,133,137,123,4,-14,-10
z6828,z,"Body mass index [BMI] 28.0-28.9, adult",Other health services,892,817,1139,-0.084080717,0.394124847,0.27690583,125,127,106,2,-21,-19
z6829,z,"Body mass index [BMI] 29.0-29.9, adult",Other health services,1076,1049,1398,-0.025092937,0.332697807,0.299256506,112,113,97,1,-16,-15
z6830,z,"Body mass index [BMI]30.0-30.9, adult",Other health services,1843,1869,2365,0.014107434,0.265382558,0.283233858,80,78,62,-2,-16,-18
z6831,z,"Body mass index [BMI] 31.0-31.9, adult",Other health services,1835,1784,2413,-0.027792916,0.352578475,0.314986376,80,81,59,1,-22,-21
z6832,z,"Body mass index [BMI] 32.0-32.9, adult",Other health services,1975,1901,2458,-0.037468354,0.293003682,0.244556962,72,75,56,3,-19,-16
z6833,z,"Body mass index [BMI] 33.0-33.9, adult",Other health services,1943,1847,2360,-0.049408132,0.277747699,0.214616572,74,78,61,4,-17,-13
z6834,z,"Body mass index [BMI] 34.0-34.9, adult",Other health services,1903,1929,2337,0.013662638,0.211508554,0.228060956,77,71,61,-6,-10,-16
z6835,z,"Body mass index [BMI] 35.0-35.9, adult",Other health services,2142,1962,2511,-0.084033613,0.279816514,0.172268908,68,69,55,1,-14,-13
z6836,z,"Body mass index [BMI] 36.0-36.9, adult",Other health services,1953,1849,2287,-0.053251408,0.236884803,0.171018945,72,75,60,3,-15,-12
z6837,z,"Body mass index [BMI] 37.0-37.9, adult",Other health services,1826,1736,2105,-0.049288061,0.212557604,0.15279299,75,76,67,1,-9,-8
z6838,z,"Body mass index [BMI] 38.0-38.9, adult",Other health services,1746,1589,2007,-0.089919817,0.263058527,0.149484536,79,82,67,3,-15,-12
z6839,z,"Body mass index [BMI] 39.0-39.9, adult",Other health services,1503,1526,1858,0.015302728,0.217562254,0.236194278,86,84,70,-2,-14,-16
z6841,z,"Body mass index [BMI]40.0-44.9, adult",Other health services,7623,7350,8962,-0.035812672,0.219319728,0.17565263,28,27,21,-1,-6,-7
z6842,z,"Body mass index [BMI] 45.0-49.9, adult",Other health services,4008,3708,4624,-0.074850299,0.247033441,0.153692615,43,43,41,0,-2,-2
z6843,z,"Body mass index [BMI] 50.0-59.9, adult",Other health services,3233,3129,3659,-0.032168265,0.16938319,0.131766161,48,48,46,0,-2,-2
z6844,z,"Body mass index [BMI] 60.0-69.9, adult",Other health services,919,812,977,-0.116430903,0.20320197,0.063112078,108,113,103,5,-10,-5
z6845,z,"Body mass index [BMI] 70 or greater, adult",Other health services,447,416,531,-0.06935123,0.276442308,0.187919463,152,155,136,3,-19,-16
z6851,z,"Body mass index [BMI] pediatric, less than 5th percentile for age",Other health services,100,93,93,-0.07,0,-0.07,254,258,255,4,-3,1
z6852,z,"Body mass index [BMI] pediatric, 5th percentile to less than 85th percentile for age",Other health services,98,99,93,0.010204082,-0.060606061,-0.051020408,256,251,255,-5,4,-1
z6853,z,"Body mass index [BMI] pediatric, 85th percentile to less than 95th percentile for age",Other health services,33,18,34,-0.454545455,0.888888889,0.03030303,307,334,300,27,-34,-7
z6854,z,"Body mass index [BMI] pediatric, greater than or equal to 95th percentile for age",Other health services,244,194,262,-0.204918033,0.350515464,0.073770492,196,213,192,17,-21,-4
z713,z,Dietary counseling and surveillance,Other health services,1351,1407,1440,0.041450777,0.023454158,0.065877128,87,83,81,-4,-2,-6
z7141,z,Alcohol abuse counseling and surveillance of alcoholic,Other health services,420,386,429,-0.080952381,0.111398964,0.021428571,153,160,151,7,-9,-2
z7151,z,Drug abuse counseling and surveillance of drug abuser,Other health services,360,318,364,-0.116666667,0.144654088,0.011111111,164,167,164,3,-3,0
z716,z,Tobacco abuse counseling,Other health services,2313,1937,1754,-0.162559447,-0.094475994,-0.241677475,63,66,71,3,5,8
z7182,z,Exercise counseling,Other health services,61,48,59,-0.213114754,0.229166667,-0.032786885,269,279,272,10,-7,3
z7189,z,Other specified counseling,Other health services,102,156,147,0.529411765,-0.057692308,0.441176471,248,226,225,-22,-1,-23
z720,z,Tobacco use,Other health services,5193,4699,4725,-0.095128057,0.005533092,-0.090121317,38,39,40,1,1,2
z7251,z,High risk heterosexual behavior,Other health services,47,58,60,0.234042553,0.034482759,0.276595745,281,268,267,-13,-1,-14
z72811,z,Adult antisocial behavior,Other health services,27,31,25,0.148148148,-0.193548387,-0.074074074,305,297,305,-8,8,0
z72820,z,Sleep deprivation,Other health services,141,98,118,-0.304964539,0.204081633,-0.163120567,232,244,234,12,-10,2
z7289,z,Other problems related to lifestyle,Other health services,822,1042,1077,0.267639903,0.033589251,0.310218978,113,97,94,-16,-3,-19
z733,z,"Stress, not elsewhere classified",Other health services,20,30,15,0.5,-0.5,-0.25,319,298,319,-21,21,0
z736,z,Limitation of activities due to disability,Other health services,167,134,329,-0.19760479,1.455223881,0.97005988,220,233,166,13,-67,-54
z7401,z,Bed confinement status,Other health services,1351,1208,1152,-0.10584752,-0.046357616,-0.147298298,85,87,88,2,1,3
z7409,z,Other reduced mobility,Other health services,794,657,716,-0.172544081,0.089802131,-0.098236776,114,121,112,7,-9,-2
z741,z,Need for assistance with personal care,Other health services,132,174,87,0.318181818,-0.5,-0.340909091,230,210,246,-20,36,16
z742,z,Need for assistance at home and no other household member able to render care,Other health services,31,44,59,0.419354839,0.340909091,0.903225806,293,274,263,-19,-11,-30
z743,z,Need for continuous supervision,Other health services,83,90,106,0.084337349,0.177777778,0.277108434,249,245,235,-4,-10,-14
z751,z,Person awaiting admission to adequate facility elsewhere,Other health services,304,433,415,0.424342105,-0.041570439,0.365131579,173,146,149,-27,3,-24
z765,z,Malingerer [conscious simulation],Other health services,405,415,378,0.024691358,-0.089156627,-0.066666667,149,148,157,-1,9,8
z7682,z,Awaiting organ transplant status,Other health services,376,300,299,-0.20212766,-0.003333333,-0.204787234,152,167,170,15,3,18
z77090,z,Contact with and (suspected) exposure to asbestos,Other health services,167,164,131,-0.017964072,-0.201219512,-0.215568862,215,212,224,-3,12,9
z77098,z,"Contact with and (suspected) exposure to other hazardous, chiefly nonmedicinal, chemicals",Other health services,48,34,42,-0.291666667,0.235294118,-0.125,269,280,272,11,-8,3
z77120,z,Contact with and (suspected) exposure to mold (toxic),Other health services,24,24,14,0,-0.416666667,-0.416666667,299,298,310,-1,12,11
z77128,z,Contact with and (suspected) exposure to other hazards in the physical environment,Other health services,70,42,31,-0.4,-0.261904762,-0.557142857,251,271,284,20,13,33
z7722,z,Contact with and (suspected) exposure to environmental tobacco smoke (acute) (chronic),Other health services,1564,1589,1260,0.015984655,-0.207048458,-0.194373402,78,77,84,-1,7,6
z7729,z,Contact with and (suspected) exposure to other hazardous substances,Other health services,25,15,13,-0.4,-0.133333333,-0.48,294,311,313,17,2,19
z780,z,Asymptomatic menopausal state,Other health services,137,115,116,-0.160583942,0.008695652,-0.153284672,224,231,226,7,-5,2
z781,z,Physical restraint status,Other health services,2347,2810,3523,0.197273115,0.253736655,0.50106519,61,50,45,-11,-5,-16
z789,z,Other specified health status,Other health services,257,371,275,0.443579767,-0.258760108,0.070038911,181,153,174,-28,21,-7
z7901,z,Long term (current) use of anticoagulants,Other health services,31115,31513,31335,0.012791258,-0.005648463,0.007070545,5,4,5,-1,1,0
z7902,z,Long term (current) use of antithrombotics/antiplatelets,Other health services,13920,14637,16779,0.051508621,0.146341463,0.205387931,9,7,6,-2,-1,-3
z791,z,Long term (current) use of non-steroidal anti-inflammatories (NSAID),Other health services,3398,3001,2598,-0.116833431,-0.13428857,-0.235432607,43,45,47,2,2,4
z792,z,Long term (current) use of antibiotics,Other health services,1924,2023,1666,0.051455301,-0.176470588,-0.134095634,63,59,67,-4,8,4
z793,z,Long term (current) use of hormonal contraceptives,Other health services,154,168,169,0.090909091,0.005952381,0.097402597,211,202,199,-9,-3,-12
z794,z,Long term (current) use of insulin,Other health services,31874,30844,33015,-0.032314739,0.070386461,0.035797201,4,4,4,0,0,0
z7951,z,Long term (current) use of inhaled steroids,Other health services,8272,8672,9043,0.048355899,0.042781365,0.093205996,22,19,17,-3,-2,-5
z7952,z,Long term (current) use of systemic steroids,Other health services,7559,7258,6159,-0.039820082,-0.151419124,-0.185209684,24,23,25,-1,2,1
z79810,z,Long term (current) use of selective estrogen receptor modulators (SERMs),Other health services,151,215,104,0.42384106,-0.51627907,-0.311258278,211,184,222,-27,38,11
z79811,z,Long term (current) use of aromatase inhibitors,Other health services,376,580,413,0.542553191,-0.287931034,0.098404255,143,116,141,-27,25,-2
z79818,z,Long term (current) use of other agents affecting estrogen receptors and estrogen levels,Other health services,119,219,90,0.840336134,-0.589041096,-0.243697479,215,182,225,-33,43,10
z7982,z,Long term (current) use of aspirin,Other health services,52253,50588,53075,-0.031864199,0.049161857,0.015731154,3,3,3,0,0,0
z7983,z,Long term (current) use of bisphosphonates,Other health services,813,1103,1630,0.356703567,0.477787851,1.004920049,102,80,65,-22,-15,-37
z7984,z,Long term (current) use of oral hypoglycemic drugs,Other health services,24510,23949,25509,-0.022888617,0.065138419,0.040758874,3,3,3,0,0,0
z79890,z,Hormone replacement therapy,Other health services,8125,12406,16439,0.526892308,0.325084636,1.023261538,20,7,3,-13,-4,-17
z79891,z,Long term (current) use of opiate analgesic,Other health services,8627,7547,6396,-0.125188362,-0.152510931,-0.2586067,19,19,21,0,2,2
z79899,z,Other long term (current) drug therapy,Other health services,76774,88387,100501,0.151262146,0.137056354,0.309049939,1,1,1,0,0,0
z800,z,Family history of malignant neoplasm of digestive organs,Other health services,2426,2242,1716,-0.075845012,-0.234611954,-0.292662819,46,46,58,0,12,12
z801,z,"Family history of malignant neoplasm of trachea, bronchus and lung",Other health services,1272,1213,776,-0.046383648,-0.360263809,-0.389937107,71,71,91,0,20,20
z802,z,Family history of malignant neoplasm of other respiratory and intrathoracic organs,Other health services,18,17,12,-0.055555556,-0.294117647,-0.333333333,286,287,293,1,6,7
z803,z,Family history of malignant neoplasm of breast,Other health services,1815,1650,1106,-0.090909091,-0.32969697,-0.390633609,58,60,75,2,15,17
z8041,z,Family history of malignant neoplasm of ovary,Other health services,328,250,191,-0.237804878,-0.236,-0.417682927,145,157,178,12,21,33
z8042,z,Family history of malignant neoplasm of prostate,Other health services,528,470,343,-0.109848485,-0.270212766,-0.350378788,120,121,139,1,18,19
z8043,z,Family history of malignant neoplasm of testis,Other health services,30,25,21,-0.166666667,-0.16,-0.3,260,267,272,7,5,12
z8049,z,Family history of malignant neoplasm of other genital organs,Other health services,214,180,133,-0.158878505,-0.261111111,-0.378504673,174,181,200,7,19,26
z8051,z,Family history of malignant neoplasm of kidney,Other health services,106,87,69,-0.179245283,-0.206896552,-0.349056604,208,215,226,7,11,18
z8052,z,Family history of malignant neoplasm of bladder,Other health services,119,97,83,-0.18487395,-0.144329897,-0.302521008,203,210,216,7,6,13
z806,z,Family history of leukemia,Other health services,301,250,165,-0.169435216,-0.34,-0.451827243,151,156,187,5,31,36
z807,z,"Family history of other malignant neoplasms of lymphoid, hematopoietic and related tissues",Other health services,240,252,166,0.05,-0.341269841,-0.308333333,163,155,186,-8,31,23
z808,z,Family history of malignant neoplasm of other organs or systems,Other health services,892,797,615,-0.106502242,-0.228356336,-0.310538117,89,91,101,2,10,12
z809,z,"Family history of malignant neoplasm, unspecified",Other health services,1028,844,724,-0.178988327,-0.142180095,-0.295719844,81,88,93,7,5,12
z810,z,Family history of intellectual disabilities,Other health services,54,48,31,-0.111111111,-0.354166667,-0.425925926,229,232,251,3,19,22
z811,z,Family history of alcohol abuse and dependence,Other health services,843,782,928,-0.072360617,0.186700767,0.100830368,90,92,83,2,-9,-7
z812,z,Family history of tobacco abuse and dependence,Other health services,23,27,10,0.173913043,-0.62962963,-0.565217391,263,255,284,-8,29,21
z813,z,Family history of other psychoactive substance abuse and dependence,Other health services,282,706,627,1.503546099,-0.111898017,1.223404255,151,96,98,-55,2,-53
z814,z,Family history of other substance abuse and dependence,Other health services,174,157,193,-0.097701149,0.229299363,0.109195402,181,184,172,3,-12,-9
z818,z,Family history of other mental and behavioral disorders,Other health services,3214,3952,4311,0.229620411,0.090840081,0.341319228,36,30,31,-6,1,-5
z820,z,Family history of epilepsy and other diseases of the nervous system,Other health services,840,862,638,0.026190476,-0.259860789,-0.24047619,89,83,96,-6,13,7
z821,z,Family history of blindness and visual loss,Other health services,14,11,12,-0.214285714,0.090909091,-0.142857143,273,280,276,7,-4,3
z822,z,Family history of deafness and hearing loss,Other health services,13,13,14,0,0.076923077,0.076923077,273,276,269,3,-7,-4
z823,z,Family history of stroke,Other health services,2381,2279,1638,-0.042839143,-0.281263712,-0.312053759,47,43,58,-4,15,11
z8241,z,Family history of sudden cardiac death,Other health services,59,49,34,-0.169491525,-0.306122449,-0.423728814,217,224,239,7,15,22
z8249,z,Family history of ischemic heart disease and other diseases of the circulatory system,Other health services,11335,10578,6950,-0.066784296,-0.342975988,-0.386854874,11,9,18,-2,9,7
z825,z,Family history of asthma and other chronic lower respiratory diseases,Other health services,1970,2135,1005,0.083756345,-0.529274005,-0.489847716,50,44,77,-6,33,27
z8261,z,Family history of arthritis,Other health services,568,473,443,-0.167253521,-0.063424947,-0.220070423,104,111,116,7,5,12
z8262,z,Family history of osteoporosis,Other health services,82,72,86,-0.12195122,0.194444444,0.048780488,203,207,201,4,-6,-2
z8269,z,Family history of other diseases of the musculoskeletal system and connective tissue,Other health services,44,41,37,-0.068181818,-0.097560976,-0.159090909,224,226,231,2,5,7
z8271,z,Family history of polycystic kidney,Other health services,21,32,16,0.523809524,-0.5,-0.238095238,255,235,258,-20,23,3
z8279,z,"Family history of other congenital malformations, deformations and chromosomal abnormalities",Other health services,124,123,149,-0.008064516,0.211382114,0.201612903,188,190,180,2,-10,-8
z831,z,Family history of other infectious and parasitic diseases,Other health services,39,98,75,1.512820513,-0.234693878,0.923076923,228,194,207,-34,13,-21
z832,z,Family history of diseases of the blood and blood-forming organs and certain disorders involving the immune mechanism,Other health services,305,312,299,0.02295082,-0.041666667,-0.019672131,140,131,140,-9,9,0
z833,z,Family history of diabetes mellitus,Other health services,8092,7037,5532,-0.13037568,-0.213869547,-0.316361839,17,17,22,0,5,5
z8342,z,Family history of familial hypercholesterolemia,Other health services,13,15,10,0.153846154,-0.333333333,-0.230769231,261,258,266,-3,8,5
z8349,z,"Family history of other endocrine, nutritional and metabolic diseases",Other health services,471,455,415,-0.033970276,-0.087912088,-0.118895966,114,113,120,-1,7,6
z83511,z,Family history of glaucoma,Other health services,30,28,14,-0.066666667,-0.5,-0.533333333,235,236,256,1,20,21
z836,z,Family history of other diseases of the respiratory system,Other health services,97,64,54,-0.340206186,-0.15625,-0.443298969,193,203,214,10,11,21
z8371,z,Family history of colonic polyps,Other health services,28,31,41,0.107142857,0.322580645,0.464285714,235,230,224,-5,-6,-11
z8379,z,Family history of other diseases of the digestive system,Other health services,158,138,136,-0.126582278,-0.014492754,-0.139240506,177,183,181,6,-2,4
z840,z,Family history of diseases of the skin and subcutaneous tissue,Other health services,13,11,10,-0.153846154,-0.090909091,-0.230769231,256,261,261,5,0,5
z841,z,Family history of disorders of kidney and ureter,Other health services,276,246,257,-0.108695652,0.044715447,-0.06884058,146,143,148,-3,5,2
z842,z,Family history of other diseases of the genitourinary system,Other health services,32,31,27,-0.03125,-0.129032258,-0.15625,231,228,233,-3,5,2
z8481,z,Family history of carrier of genetic disease,Other health services,13,27,23,1.076923077,-0.148148148,0.769230769,254,232,240,-22,8,-14
z8489,z,Family history of other specified conditions,Other health services,120,128,129,0.066666667,0.0078125,0.075,183,182,182,-1,0,-1
z8500,z,Personal history of malignant neoplasm of unspecified digestive organ,Other health services,20,17,15,-0.15,-0.117647059,-0.25,244,248,247,4,-1,3
z8501,z,Personal history of malignant neoplasm of esophagus,Other health services,209,232,236,0.110047847,0.017241379,0.129186603,159,152,152,-7,0,-7
z85028,z,Personal history of other malignant neoplasm of stomach,Other health services,233,199,203,-0.145922747,0.020100503,-0.128755365,150,158,158,8,0,8
z85038,z,Personal history of other malignant neoplasm of large intestine,Other health services,2461,2350,2287,-0.045103616,-0.026808511,-0.070702966,42,37,41,-5,4,-1
z85048,z,"Personal history of other malignant neoplasm of rectum, rectosigmoid junction, and anus",Other health services,727,695,685,-0.044016506,-0.014388489,-0.057771664,89,89,87,0,-2,-2
z8505,z,Personal history of malignant neoplasm of liver,Other health services,329,311,316,-0.054711246,0.01607717,-0.039513678,130,127,132,-3,5,2
z85068,z,Personal history of other malignant neoplasm of small intestine,Other health services,34,38,29,0.117647059,-0.236842105,-0.147058824,223,215,224,-8,9,1
z8507,z,Personal history of malignant neoplasm of pancreas,Other health services,298,279,318,-0.063758389,0.139784946,0.067114094,137,134,131,-3,-3,-6
z8509,z,Personal history of malignant neoplasm of other digestive organs,Other health services,67,54,81,-0.194029851,0.5,0.208955224,194,201,190,7,-11,-4
z85118,z,Personal history of other malignant neoplasm of bronchus and lung,Other health services,1502,1608,1425,0.07057257,-0.11380597,-0.05126498,59,55,59,-4,4,0
z8521,z,Personal history of malignant neoplasm of larynx,Other health services,197,195,175,-0.010152284,-0.102564103,-0.111675127,156,154,160,-2,6,4
z8522,z,"Personal history of malignant neoplasm of nasal cavities, middle ear, and accessory sinuses",Other health services,35,22,27,-0.371428571,0.227272727,-0.228571429,217,231,222,14,-9,5
z85238,z,Personal history of other malignant neoplasm of thymus,Other health services,12,20,10,0.666666667,-0.5,-0.166666667,241,234,245,-7,11,4
z853,z,Personal history of malignant neoplasm of breast,Other health services,6091,5321,5398,-0.126416024,0.014470964,-0.113774421,21,22,22,1,0,1
z8541,z,Personal history of malignant neoplasm of cervix uteri,Other health services,807,726,761,-0.100371747,0.048209366,-0.057001239,83,85,81,2,-4,-2
z8542,z,Personal history of malignant neoplasm of other parts of uterus,Other health services,937,827,923,-0.117395945,0.116082225,-0.014941302,77,79,75,2,-4,-2
z8543,z,Personal history of malignant neoplasm of ovary,Other health services,551,521,537,-0.054446461,0.030710173,-0.025408348,99,95,93,-4,-2,-6
z8544,z,Personal history of malignant neoplasm of other female genital organs,Other health services,99,75,83,-0.242424242,0.106666667,-0.161616162,176,183,183,7,0,7
z8546,z,Personal history of malignant neoplasm of prostate,Other health services,5215,4809,4829,-0.077852349,0.004158869,-0.074017258,24,23,26,-1,3,2
z8547,z,Personal history of malignant neoplasm of testis,Other health services,241,214,238,-0.112033195,0.112149533,-0.012448133,138,144,140,6,-4,2
z8549,z,Personal history of malignant neoplasm of other male genital organs,Other health services,17,21,25,0.235294118,0.19047619,0.470588235,229,226,216,-3,-10,-13
z8550,z,Personal history of malignant neoplasm of unspecified urinary tract organ,Other health services,11,15,11,0.363636364,-0.266666667,0,233,228,235,-5,7,2
z8551,z,Personal history of malignant neoplasm of bladder,Other health services,1702,1719,1601,0.009988249,-0.068644561,-0.059341951,51,49,54,-2,5,3
z85528,z,Personal history of other malignant neoplasm of kidney,Other health services,1448,1372,1388,-0.052486188,0.011661808,-0.041436464,56,57,57,1,0,1
z8553,z,Personal history of malignant neoplasm of renal pelvis,Other health services,56,39,28,-0.303571429,-0.282051282,-0.5,187,201,212,14,11,25
z8554,z,Personal history of malignant neoplasm of ureter,Other health services,25,29,15,0.16,-0.482758621,-0.4,215,208,225,-7,17,10
z856,z,Personal history of leukemia,Other health services,277,275,299,-0.007220217,0.087272727,0.079422383,132,126,126,-6,0,-6
z8571,z,Personal history of Hodgkin lymphoma,Other health services,182,200,157,0.098901099,-0.215,-0.137362637,150,143,155,-7,12,5
z8572,z,Personal history of non-Hodgkin lymphomas,Other health services,839,797,778,-0.050059595,-0.023839398,-0.072705602,78,77,76,-1,-1,-2
z8579,z,"Personal history of other malignant neoplasms of lymphoid, hematopoietic and related tissues",Other health services,53,56,58,0.056603774,0.035714286,0.094339623,188,185,187,-3,2,-1
z85810,z,Personal history of malignant neoplasm of tongue,Other health services,208,171,186,-0.177884615,0.087719298,-0.105769231,143,147,146,4,-1,3
z85818,z,"Personal history of malignant neoplasm of other sites of lip, oral cavity, and pharynx",Other health services,177,166,179,-0.062146893,0.078313253,0.011299435,150,149,146,-1,-3,-4
z85819,z,"Personal history of malignant neoplasm of unspecified site of lip, oral cavity, and pharynx",Other health services,221,234,194,0.058823529,-0.170940171,-0.122171946,140,137,144,-3,7,4
z85820,z,Personal history of malignant melanoma of skin,Other health services,1596,1435,1639,-0.100877193,0.142160279,0.026942356,52,54,52,2,-2,0
z85821,z,Personal history of Merkel cell carcinoma,Other health services,15,15,17,0,0.133333333,0.133333333,219,216,215,-3,-1,-4
z85828,z,Personal history of other malignant neoplasm of skin,Other health services,5435,4802,4931,-0.116467341,0.026863807,-0.092732291,23,23,25,0,2,2
z85830,z,Personal history of malignant neoplasm of bone,Other health services,152,154,139,0.013157895,-0.097402597,-0.085526316,154,153,152,-1,-1,-2
z85831,z,Personal history of malignant neoplasm of soft tissue,Other health services,66,49,101,-0.257575758,1.06122449,0.53030303,174,183,165,9,-18,-9
z85840,z,Personal history of malignant neoplasm of eye,Other health services,37,36,48,-0.027027027,0.333333333,0.297297297,193,191,185,-2,-6,-8
z85841,z,Personal history of malignant neoplasm of brain,Other health services,228,239,243,0.048245614,0.016736402,0.065789474,134,131,133,-3,2,-1
z85850,z,Personal history of malignant neoplasm of thyroid,Other health services,902,804,881,-0.10864745,0.095771144,-0.023281596,73,74,70,1,-4,-3
z85858,z,Personal history of malignant neoplasm of other endocrine glands,Other health services,42,41,37,-0.023809524,-0.097560976,-0.119047619,185,186,189,1,3,4
z8589,z,Personal history of malignant neoplasm of other organs and systems,Other health services,306,315,319,0.029411765,0.012698413,0.04248366,122,113,118,-9,5,-4
z859,z,"Personal history of malignant neoplasm, unspecified",Other health services,82,67,76,-0.182926829,0.134328358,-0.073170732,166,170,169,4,-1,3
z86000,z,Personal history of in-situ neoplasm of breast,Other health services,21,28,33,0.333333333,0.178571429,0.571428571,204,192,191,-12,-1,-13
z86001,z,Personal history of in-situ neoplasm of cervix uteri,Other health services,11,12,12,0.090909091,0,0.090909091,210,210,211,0,1,1
z86006,z,Personal history of melanoma in-situ,Other health services,24,41,47,0.708333333,0.146341463,0.958333333,199,184,181,-15,-3,-18
z86008,z,Personal history of in-situ neoplasm of other site,Other health services,11,13,21,0.181818182,0.615384615,0.909090909,209,208,199,-1,-9,-10
z86010,z,Personal history of colonic polyps,Other health services,1697,1359,1448,-0.199175015,0.06548933,-0.146729523,50,55,53,5,-2,3
z86011,z,Personal history of benign neoplasm of the brain,Other health services,300,288,322,-0.04,0.118055556,0.073333333,122,119,115,-3,-4,-7
z86018,z,Personal history of other benign neoplasm,Other health services,60,56,63,-0.066666667,0.125,0.05,170,173,170,3,-3,0
z8603,z,Personal history of neoplasm of uncertain behavior,Other health services,22,24,13,0.090909091,-0.458333333,-0.409090909,199,192,204,-7,12,5
z8611,z,Personal history of tuberculosis,Other health services,448,385,392,-0.140625,0.018181818,-0.125,100,107,109,7,2,9
z8612,z,Personal history of poliomyelitis,Other health services,185,169,176,-0.086486486,0.041420118,-0.048648649,137,138,137,1,-1,0
z8613,z,Personal history of malaria,Other health services,26,25,25,-0.038461538,0,-0.038461538,189,187,189,-2,2,0
z8614,z,Personal history of Methicillin resistant Staphylococcus aureus infection,Other health services,3943,3403,2963,-0.13695156,-0.129297679,-0.24854172,27,27,31,0,4,4
z8615,z,Personal history of latent tuberculosis infection,Other health services,50,120,113,1.4,-0.058333333,1.26,173,151,151,-22,0,-22
z8619,z,Personal history of other infectious and parasitic diseases,Other health services,2946,3325,7325,0.128649016,1.203007519,1.486422267,30,28,17,-2,-11,-13
z862,z,Personal history of diseases of the blood and blood-forming organs and certain disorders involving the immune mechanism,Other health services,173,156,176,-0.098265896,0.128205128,0.01734104,140,141,135,1,-6,-5
z8632,z,Personal history of gestational diabetes,Other health services,174,176,215,0.011494253,0.221590909,0.235632184,138,135,131,-3,-4,-7
z8639,z,"Personal history of other endocrine, nutritional and metabolic disease",Other health services,152,159,201,0.046052632,0.264150943,0.322368421,143,138,132,-5,-6,-11
z8659,z,Personal history of other mental and behavioral disorders,Other health services,404,410,519,0.014851485,0.265853659,0.284653465,101,100,86,-1,-14,-15
z8661,z,Personal history of infections of the central nervous system,Other health services,481,425,427,-0.116424116,0.004705882,-0.112266112,96,97,99,1,2,3
z8669,z,Personal history of other diseases of the nervous system and sense organs,Other health services,904,931,1161,0.029867257,0.247046187,0.284292035,69,65,55,-4,-10,-14
z86711,z,Personal history of pulmonary embolism,Other health services,7494,6868,6822,-0.083533493,-0.006697729,-0.089671737,17,17,17,0,0,0
z86718,z,Personal history of other venous thrombosis and embolism,Other health services,11527,10477,10404,-0.091090483,-0.006967643,-0.097423441,10,9,10,-1,1,0
z8672,z,Personal history of thrombophlebitis,Other health services,103,74,104,-0.281553398,0.405405405,0.009708738,145,153,146,8,-7,1
z8673,z,"Personal history of transient ischemic attack (TIA), and cerebral infarction without residual deficits",Other health services,16955,16053,15916,-0.053199646,-0.00853423,-0.061279858,2,2,2,0,0,0
z8674,z,Personal history of sudden cardiac arrest,Other health services,1037,1059,1054,0.021215043,-0.004721435,0.016393443,60,58,58,-2,0,-2
z8679,z,Personal history of other diseases of the circulatory system,Other health services,1912,1900,2118,-0.006276151,0.114736842,0.107740586,40,40,38,0,-2,-2
z8701,z,Personal history of pneumonia (recurrent),Other health services,2673,2923,2398,0.093527871,-0.17960999,-0.102880658,29,27,31,-2,4,2
z8709,z,Personal history of other diseases of the respiratory system,Other health services,332,334,342,0.006024096,0.023952096,0.030120482,103,97,100,-6,3,-3
z8711,z,Personal history of peptic ulcer disease,Other health services,2867,2527,2653,-0.118590862,0.049861496,-0.074642483,27,27,27,0,0,0
z8719,z,Personal history of other diseases of the digestive system,Other health services,1395,1642,2153,0.177060932,0.311205847,0.543369176,45,42,34,-3,-8,-11
z872,z,Personal history of diseases of the skin and subcutaneous tissue,Other health services,39,43,47,0.102564103,0.093023256,0.205128205,162,159,157,-3,-2,-5
z87310,z,Personal history of (healed) osteoporosis fracture,Other health services,51,38,19,-0.254901961,-0.5,-0.62745098,154,159,176,5,17,22
z87311,z,Personal history of (healed) other pathological fracture,Other health services,47,48,33,0.021276596,-0.3125,-0.29787234,156,155,165,-1,10,9
z8739,z,Personal history of other diseases of the musculoskeletal system and connective tissue,Other health services,660,786,790,0.190909091,0.005089059,0.196969697,71,62,60,-9,-2,-11
z87410,z,Personal history of cervical dysplasia,Other health services,41,35,55,-0.146341463,0.571428571,0.341463415,156,157,152,1,-5,-4
z8742,z,Personal history of other diseases of the female genital tract,Other health services,99,119,136,0.202020202,0.142857143,0.373737374,137,134,130,-3,-4,-7
z87438,z,Personal history of other diseases of male genital organs,Other health services,19,34,29,0.789473684,-0.147058824,0.526315789,171,156,163,-15,7,-8
z87440,z,Personal history of urinary (tract) infections,Other health services,4456,3894,3853,-0.126122083,-0.010529019,-0.13532316,22,22,23,0,1,1
z87441,z,Personal history of nephrotic syndrome,Other health services,49,50,51,0.020408163,0.02,0.040816327,152,151,151,-1,0,-1
z87442,z,Personal history of urinary calculi,Other health services,4278,3566,4479,-0.166432913,0.256029164,0.046984572,22,22,21,0,-1,-1
z87448,z,Personal history of other diseases of urinary system,Other health services,87,94,105,0.08045977,0.117021277,0.206896552,139,136,132,-3,-4,-7
z8751,z,Personal history of pre-term labor,Other health services,64,64,79,0,0.234375,0.234375,144,142,140,-2,-2,-4
z8759,z,"Personal history of other complications of pregnancy, childbirth and the puerperium",Other health services,526,509,495,-0.032319392,-0.027504912,-0.058935361,81,76,78,-5,2,-3
z87718,z,Personal history of other specified (corrected) congenital malformations of genitourinary system,Other health services,25,24,34,-0.04,0.416666667,0.36,161,157,154,-4,-3,-7
z87728,z,Personal history of other specified (corrected) congenital malformations of nervous system and sense organs,Other health services,55,54,57,-0.018181818,0.055555556,0.036363636,145,145,145,0,0,0
z87730,z,Personal history of (corrected) cleft lip and palate,Other health services,96,101,105,0.052083333,0.03960396,0.09375,135,132,131,-3,-1,-4
z87738,z,Personal history of other specified (corrected) congenital malformations of digestive system,Other health services,118,98,99,-0.169491525,0.010204082,-0.161016949,130,132,132,2,0,2
z8774,z,Personal history of (corrected) congenital malformations of heart and circulatory system,Other health services,562,523,498,-0.069395018,-0.047801147,-0.113879004,75,72,77,-3,5,2
z8776,z,"Personal history of (corrected) congenital malformations of integument, limbs and musculoskeletal system",Other health services,19,22,34,0.157894737,0.545454545,0.789473684,160,157,150,-3,-7,-10
z8781,z,Personal history of (healed) traumatic fracture,Other health services,623,553,502,-0.112359551,-0.092224231,-0.194221509,72,69,76,-3,7,4
z87820,z,Personal history of traumatic brain injury,Other health services,2390,2165,2164,-0.094142259,-0.000461894,-0.094560669,31,29,30,-2,1,-1
z87828,z,Personal history of other (healed) physical injury and trauma,Other health services,400,414,450,0.035,0.086956522,0.125,84,82,80,-2,-2,-4
z87890,z,Personal history of sex reassignment,Other health services,34,25,42,-0.264705882,0.68,0.235294118,148,148,144,0,-4,-4
z87891,z,Personal history of nicotine dependence,Other health services,66455,62526,62608,-0.059122715,0.001311454,-0.057888797,1,1,1,0,0,0
z87892,z,Personal history of anaphylaxis,Other health services,227,298,341,0.31277533,0.144295302,0.502202643,106,92,89,-14,-3,-17
z87898,z,Personal history of other specified conditions,Other health services,231,238,261,0.03030303,0.096638655,0.12987013,105,103,101,-2,-2,-4
z880,z,Allergy status to penicillin,Other health services,13443,11942,12334,-0.111656624,0.032825322,-0.082496467,3,5,3,2,-2,0
z881,z,Allergy status to other antibiotic agents,Other health services,5803,5167,5093,-0.109598484,-0.014321657,-0.122350508,16,17,18,1,1,2
z882,z,Allergy status to sulfonamides,Other health services,6746,6003,6048,-0.110139342,0.007496252,-0.103468722,13,13,13,0,0,0
z883,z,Allergy status to other anti-infective agents,Other health services,512,407,476,-0.205078125,0.16953317,-0.0703125,74,78,71,4,-7,-3
z884,z,Allergy status to anesthetic agent,Other health services,174,159,167,-0.086206897,0.050314465,-0.040229885,111,111,108,0,-3,-3
z885,z,Allergy status to narcotic agent,Other health services,9493,8448,8535,-0.110081112,0.010298295,-0.100916465,10,11,10,1,-1,0
z886,z,Allergy status to analgesic agent,Other health services,3432,2966,3227,-0.135780886,0.087997303,-0.059731935,18,19,18,1,-1,0
z887,z,Allergy status to serum and vaccine,Other health services,428,397,384,-0.072429907,-0.032745592,-0.102803738,75,76,81,1,5,6
z888,z,"Allergy status to other drugs, medicaments and biological substances",Other health services,9522,8882,8547,-0.06721277,-0.03771673,-0.102394455,9,9,9,0,0,0
z889,z,"Allergy status to unspecified drugs, medicaments and biological substances",Other health services,56,62,37,0.107142857,-0.403225806,-0.339285714,125,124,132,-1,8,7
z89021,z,Acquired absence of right finger(s),Other health services,97,93,89,-0.041237113,-0.043010753,-0.082474227,117,117,117,0,0,0
z89022,z,Acquired absence of left finger(s),Other health services,94,75,86,-0.20212766,0.146666667,-0.085106383,117,120,117,3,-3,0
z89029,z,Acquired absence of unspecified finger(s),Other health services,36,18,20,-0.5,0.111111111,-0.444444444,131,139,138,8,-1,7
z89411,z,Acquired absence of right great toe,Other health services,333,315,313,-0.054054054,-0.006349206,-0.06006006,83,80,83,-3,3,0
z89412,z,Acquired absence of left great toe,Other health services,337,254,256,-0.246290801,0.007874016,-0.240356083,80,87,93,7,6,13
z89419,z,Acquired absence of unspecified great toe,Other health services,28,44,47,0.571428571,0.068181818,0.678571429,131,125,125,-6,0,-6
z89421,z,Acquired absence of other right toe(s),Other health services,721,625,587,-0.133148405,-0.0608,-0.185852982,56,57,58,1,1,2
z89422,z,Acquired absence of other left toe(s),Other health services,626,529,514,-0.154952077,-0.028355388,-0.178913738,62,60,65,-2,5,3
z89429,z,"Acquired absence of other toe(s), unspecified side",Other health services,275,239,274,-0.130909091,0.146443515,-0.003636364,90,90,87,0,-3,-3
z89431,z,Acquired absence of right foot,Other health services,173,140,138,-0.190751445,-0.014285714,-0.202312139,102,106,104,4,-2,2
z89432,z,Acquired absence of left foot,Other health services,144,125,131,-0.131944444,0.048,-0.090277778,105,108,105,3,-3,0
z89511,z,Acquired absence of right leg below knee,Other health services,1129,1092,1159,-0.032772365,0.061355311,0.026572188,42,41,38,-1,-3,-4
z89512,z,Acquired absence of left leg below knee,Other health services,1168,1065,1087,-0.088184932,0.020657277,-0.069349315,39,42,41,3,-1,2
z89519,z,Acquired absence of unspecified leg below knee,Other health services,56,89,80,0.589285714,-0.101123596,0.428571429,114,108,108,-6,0,-6
z89611,z,Acquired absence of right leg above knee,Other health services,447,477,424,0.067114094,-0.111111111,-0.051454139,69,64,70,-5,6,1
z89612,z,Acquired absence of left leg above knee,Other health services,456,470,436,0.030701754,-0.072340426,-0.043859649,68,65,69,-3,4,1
z89619,z,Acquired absence of unspecified leg above knee,Other health services,16,14,13,-0.125,-0.071428571,-0.1875,129,129,130,0,1,1
z9001,z,Acquired absence of eye,Other health services,71,45,60,-0.366197183,0.333333333,-0.154929577,110,113,110,3,-3,0
z9002,z,Acquired absence of larynx,Other health services,37,31,27,-0.162162162,-0.129032258,-0.27027027,117,116,118,-1,2,1
z9010,z,Acquired absence of unspecified breast and nipple,Other health services,558,482,438,-0.136200717,-0.091286307,-0.215053763,62,63,68,1,5,6
z9011,z,Acquired absence of right breast and nipple,Other health services,631,475,468,-0.247226624,-0.014736842,-0.258320127,59,63,65,4,2,6
z9012,z,Acquired absence of left breast and nipple,Other health services,677,584,534,-0.137370753,-0.085616438,-0.211225997,56,56,60,0,4,4
z9013,z,Acquired absence of bilateral breasts and nipples,Other health services,1055,856,937,-0.188625592,0.094626168,-0.111848341,43,47,45,4,-2,2
z902,z,Acquired absence of lung [part of],Other health services,892,845,730,-0.052690583,-0.136094675,-0.18161435,48,48,48,0,0,0
z903,z,Acquired absence of stomach [part of],Other health services,322,292,288,-0.093167702,-0.01369863,-0.105590062,72,73,74,1,1,2
z90410,z,Acquired total absence of pancreas,Other health services,44,27,33,-0.386363636,0.222222222,-0.25,107,111,111,4,0,4
z90411,z,Acquired partial absence of pancreas,Other health services,367,309,364,-0.158038147,0.177993528,-0.008174387,66,69,69,3,0,3
z9049,z,Acquired absence of other specified parts of digestive tract,Other health services,16012,14241,15134,-0.110604547,0.062706271,-0.054833875,1,2,1,1,-1,0
z905,z,Acquired absence of kidney,Other health services,2476,2244,2361,-0.093699515,0.052139037,-0.04644588,21,20,20,-1,0,-1
z906,z,Acquired absence of other parts of urinary tract,Other health services,222,198,169,-0.108108108,-0.146464646,-0.238738739,79,82,85,3,3,6
z90710,z,Acquired absence of both cervix and uterus,Other health services,12303,9926,11856,-0.193204909,0.194438847,-0.036332602,4,5,3,1,-2,-1
z90711,z,Acquired absence of uterus with remaining cervical stump,Other health services,318,294,424,-0.075471698,0.442176871,0.333333333,69,68,61,-1,-7,-8
z90721,z,"Acquired absence of ovaries, unilateral",Other health services,289,247,276,-0.14532872,0.117408907,-0.044982699,71,70,71,-1,1,0
z90722,z,"Acquired absence of ovaries, bilateral",Other health services,533,456,548,-0.144465291,0.201754386,0.028142589,57,58,54,1,-4,-3
z9079,z,Acquired absence of other genital organ(s),Other health services,1590,1304,1506,-0.179874214,0.154907975,-0.052830189,29,33,30,4,-3,1
z9081,z,Acquired absence of spleen,Other health services,990,849,954,-0.142424242,0.123674912,-0.036363636,40,43,40,3,-3,0
z9089,z,Acquired absence of other organs,Other health services,303,264,466,-0.128712871,0.765151515,0.537953795,67,65,56,-2,-9,-11
z91010,z,Allergy to peanuts,Other health services,278,244,258,-0.122302158,0.057377049,-0.071942446,68,69,69,1,0,1
z91011,z,Allergy to milk products,Other health services,366,304,280,-0.169398907,-0.078947368,-0.234972678,60,63,65,3,2,5
z91012,z,Allergy to eggs,Other health services,282,231,228,-0.180851064,-0.012987013,-0.191489362,66,69,70,3,1,4
z91013,z,Allergy to seafood,Other health services,946,889,796,-0.0602537,-0.104611924,-0.158562368,42,41,41,-1,0,-1
z91018,z,Allergy to other foods,Other health services,1535,1402,1323,-0.086644951,-0.056348074,-0.138110749,29,31,32,2,1,3
z9102,z,Food additives allergy status,Other health services,65,59,52,-0.092307692,-0.118644068,-0.2,88,88,90,0,2,2
z91030,z,Bee allergy status,Other health services,390,301,337,-0.228205128,0.119601329,-0.135897436,56,61,59,5,-2,3
z91038,z,Other insect allergy status,Other health services,19,15,20,-0.210526316,0.333333333,0.052631579,100,100,98,0,-2,-2
z91040,z,Latex allergy status,Other health services,2131,1888,1922,-0.114030971,0.018008475,-0.098076021,23,25,23,2,-2,0
z91041,z,Radiographic dye allergy status,Other health services,1819,1669,1761,-0.082462892,0.055122828,-0.031885651,25,27,27,2,0,2
z91048,z,Other nonmedicinal substance allergy status,Other health services,740,779,737,0.052702703,-0.053915276,-0.004054054,42,39,38,-3,-1,-4
z9109,z,"Other allergy status, other than to drugs and biological substances",Other health services,370,204,270,-0.448648649,0.323529412,-0.27027027,53,65,60,12,-5,7
z9111,z,Patient's noncompliance with dietary regimen,Other health services,580,521,408,-0.101724138,-0.216890595,-0.296551724,47,46,52,-1,6,5
z91120,z,Patient's intentional underdosing of medication regimen due to financial hardship,Other health services,216,155,138,-0.282407407,-0.109677419,-0.361111111,62,70,72,8,2,10
z91128,z,Patient's intentional underdosing of medication regimen for other reason,Other health services,707,669,662,-0.053748232,-0.010463378,-0.063649222,42,41,39,-1,-2,-3
z91138,z,Patient's unintentional underdosing of medication regimen for other reason,Other health services,181,162,165,-0.104972376,0.018518519,-0.08839779,66,68,66,2,-2,0
z9114,z,Patient's other noncompliance with medication regimen,Other health services,10437,9547,10363,-0.085273546,0.085471876,-0.00709016,5,6,5,1,-1,0
z9115,z,Patient's noncompliance with renal dialysis,Other health services,1035,1041,1136,0.005797101,0.091258405,0.097584541,35,34,30,-1,-4,-5
z9119,z,Patient's noncompliance with other medical treatment and regimen,Other health services,8753,8534,8270,-0.025019993,-0.030935083,-0.055181081,6,6,6,0,0,0
z91410,z,Personal history of adult physical and sexual abuse,Other health services,1816,1462,1621,-0.194933921,0.10875513,-0.107378855,23,26,25,3,-1,2
z91411,z,Personal history of adult psychological abuse,Other health services,769,582,580,-0.243172952,-0.003436426,-0.245773732,37,39,39,2,0,2
z91419,z,Personal history of unspecified adult abuse,Other health services,35,33,47,-0.057142857,0.424242424,0.342857143,79,77,77,-2,0,-2
z915,z,Personal history of self-harm,Other health services,13292,12383,12015,-0.068387,-0.029718162,-0.096072826,2,3,2,1,-1,0
z9181,z,History of falling,Other health services,5626,5526,5739,-0.017774618,0.03854506,0.020085318,8,8,6,0,-2,-2
z9183,z,Wandering in diseases classified elsewhere,Other health services,158,167,212,0.056962025,0.269461078,0.341772152,61,59,56,-2,-3,-5
z9189,z,"Other specified personal risk factors, not elsewhere classified",Other health services,129,97,80,-0.248062016,-0.175257732,-0.379844961,63,66,67,3,1,4
z9221,z,Personal history of antineoplastic chemotherapy,Other health services,6210,5635,5316,-0.092592593,-0.05661047,-0.143961353,7,7,8,0,1,1
z9225,z,Personal history of immunosupression therapy,Other health services,24,15,37,-0.375,1.466666667,0.541666667,78,81,73,3,-8,-5
z923,z,Personal history of irradiation,Other health services,6389,5816,5549,-0.089685397,-0.04590784,-0.131475974,6,6,6,0,0,0
z9281,z,Personal history of extracorporeal membrane oxygenation (ECMO),Other health services,26,23,14,-0.115384615,-0.391304348,-0.461538462,74,76,78,2,2,4
z9282,z,Status post administration of tPA (rtPA) in a different facility within the last 24 hours prior to admission to current facility,Other health services,236,245,220,0.038135593,-0.102040816,-0.06779661,50,49,53,-1,4,3
z9289,z,Personal history of other medical treatment,Other health services,17,24,21,0.411764706,-0.125,0.235294118,77,73,75,-4,2,-2
z930,z,Tracheostomy status,Other health services,1115,1081,1119,-0.030493274,0.035152636,0.003587444,27,27,25,0,-2,-2
z931,z,Gastrostomy status,Other health services,2286,2100,1783,-0.081364829,-0.150952381,-0.220034996,15,14,20,-1,6,5
z932,z,Ileostomy status,Other health services,779,740,716,-0.050064185,-0.032432432,-0.080872914,30,29,28,-1,-1,-2
z933,z,Colostomy status,Other health services,2061,1920,1960,-0.068413392,0.020833333,-0.049005337,16,15,16,-1,1,0
z934,z,Other artificial openings of gastrointestinal tract status,Other health services,222,193,231,-0.130630631,0.196891192,0.040540541,46,49,47,3,-2,1
z9350,z,Unspecified cystostomy status,Other health services,23,23,25,0,0.086956522,0.086956522,70,69,66,-1,-3,-4
z9351,z,Cutaneous-vesicostomy status,Other health services,23,22,22,-0.043478261,0,-0.043478261,70,69,68,-1,-1,-2
z9359,z,Other cystostomy status,Other health services,210,191,170,-0.09047619,-0.109947644,-0.19047619,46,50,49,4,-1,3
z936,z,Other artificial openings of urinary tract status,Other health services,664,588,603,-0.114457831,0.025510204,-0.09186747,30,30,29,0,-1,-1
z940,z,Kidney transplant status,Other health services,1186,1150,1042,-0.030354132,-0.093913043,-0.121416526,22,22,24,0,2,2
z941,z,Heart transplant status,Other health services,205,192,153,-0.063414634,-0.203125,-0.253658537,44,47,47,3,0,3
z942,z,Lung transplant status,Other health services,201,206,188,0.024875622,-0.087378641,-0.064676617,44,46,46,2,0,2
z944,z,Liver transplant status,Other health services,639,528,549,-0.17370892,0.039772727,-0.14084507,29,29,30,0,1,1
z945,z,Skin transplant status,Other health services,55,32,60,-0.418181818,0.875,0.090909091,56,59,56,3,-3,0
z947,z,Corneal transplant status,Other health services,140,142,152,0.014285714,0.070422535,0.085714286,48,48,46,0,-2,-2
z9481,z,Bone marrow transplant status,Other health services,277,246,226,-0.111913357,-0.081300813,-0.184115523,41,41,44,0,3,3
z9483,z,Pancreas transplant status,Other health services,184,155,114,-0.157608696,-0.264516129,-0.380434783,43,45,47,2,2,4
z9484,z,Stem cells transplant status,Other health services,412,461,397,0.118932039,-0.138828633,-0.036407767,34,32,36,-2,4,2
z9489,z,Other transplanted organ and tissue status,Other health services,15,18,14,0.2,-0.222222222,-0.066666667,59,58,58,-1,0,-1
z950,z,Presence of cardiac pacemaker,Other health services,8735,8320,7787,-0.047510017,-0.0640625,-0.108528907,5,5,5,0,0,0
z951,z,Presence of aortocoronary bypass graft,Other health services,12002,11462,10602,-0.044992501,-0.075030536,-0.116647225,3,3,2,0,-1,-1
z952,z,Presence of prosthetic heart valve,Other health services,3278,3265,3025,-0.003965833,-0.073506891,-0.077181208,7,7,7,0,0,0
z953,z,Presence of xenogenic heart valve,Other health services,1324,1375,1249,0.038519637,-0.091636364,-0.056646526,17,17,18,0,1,1
z954,z,Presence of other heart-valve replacement,Other health services,115,140,117,0.217391304,-0.164285714,0.017391304,42,41,41,-1,0,-1
z955,z,Presence of coronary angioplasty implant and graft,Other health services,15812,14559,14218,-0.079243612,-0.023421938,-0.100809512,1,1,1,0,0,0
z95810,z,Presence of automatic (implantable) cardiac defibrillator,Other health services,4890,4461,4268,-0.087730061,-0.043263842,-0.127198364,4,4,4,0,0,0
z95811,z,Presence of heart assist device,Other health services,164,164,153,0,-0.067073171,-0.067073171,37,37,37,0,0,0
z95818,z,Presence of other cardiac implants and grafts,Other health services,493,511,513,0.036511156,0.003913894,0.040567951,27,24,26,-3,2,-1
z95820,z,Peripheral vascular angioplasty status with implants and grafts,Other health services,871,711,652,-0.1836969,-0.082981716,-0.251435132,21,21,21,0,0,0
z95828,z,Presence of other vascular implants and grafts,Other health services,1909,1909,1869,0,-0.020953379,-0.020953379,11,11,11,0,0,0
z959,z,"Presence of cardiac and vascular implant and graft, unspecified",Other health services,72,106,91,0.472222222,-0.141509434,0.263888889,40,36,37,-4,1,-3
z960,z,Presence of urogenital implants,Other health services,549,488,476,-0.111111111,-0.024590164,-0.132969035,22,22,24,0,2,2
z961,z,Presence of intraocular lens,Other health services,366,386,465,0.054644809,0.204663212,0.270491803,24,25,24,1,-1,0
z9621,z,Cochlear implant status,Other health services,74,53,59,-0.283783784,0.113207547,-0.202702703,37,39,38,2,-1,1
z9641,z,Presence of insulin pump (external) (internal),Other health services,977,889,823,-0.090071648,-0.07424072,-0.157625384,18,19,18,1,-1,0
z96611,z,Presence of right artificial shoulder joint,Other health services,703,662,659,-0.058321479,-0.004531722,-0.062588905,19,19,18,0,-1,-1
z96612,z,Presence of left artificial shoulder joint,Other health services,584,513,580,-0.121575342,0.130604288,-0.006849315,19,19,19,0,0,0
z96619,z,Presence of unspecified artificial shoulder joint,Other health services,194,222,279,0.144329897,0.256756757,0.43814433,27,28,26,1,-2,-1
z96622,z,Presence of left artificial elbow joint,Other health services,26,12,14,-0.538461538,0.166666667,-0.461538462,38,39,39,1,0,1
z96641,z,Presence of right artificial hip joint,Other health services,2533,2101,2144,-0.170548756,0.020466445,-0.153572839,8,8,10,0,2,2
z96642,z,Presence of left artificial hip joint,Other health services,2133,1791,1829,-0.160337553,0.021217197,-0.142522269,9,10,10,1,0,1
z96643,z,"Presence of artificial hip joint, bilateral",Other health services,1262,1194,1120,-0.053882726,-0.061976549,-0.11251981,12,12,13,0,1,1
z96649,z,Presence of unspecified artificial hip joint,Other health services,1097,1143,1399,0.041932543,0.223972003,0.275296263,14,12,11,-2,-1,-3
z96651,z,Presence of right artificial knee joint,Other health services,2753,2339,2413,-0.150381402,0.031637452,-0.123501635,5,7,7,2,0,2
z96652,z,Presence of left artificial knee joint,Other health services,2405,2011,2159,-0.163825364,0.073595226,-0.102286902,7,7,8,0,1,1
z96653,z,"Presence of artificial knee joint, bilateral",Other health services,2575,2342,2456,-0.090485437,0.048676345,-0.046213592,6,6,5,0,-1,-1
z96659,z,Presence of unspecified artificial knee joint,Other health services,1810,1919,2446,0.060220994,0.274622199,0.351381215,6,6,5,0,-1,-1
z96661,z,Presence of right artificial ankle joint,Other health services,41,45,25,0.097560976,-0.444444444,-0.390243902,26,27,28,1,1,2
z96662,z,Presence of left artificial ankle joint,Other health services,40,25,44,-0.375,0.76,0.1,26,28,27,2,-1,1
z96669,z,Presence of unspecified artificial ankle joint,Other health services,11,11,11,0,0,0,29,29,29,0,0,0
z96698,z,Presence of other orthopedic joint implants,Other health services,30,29,24,-0.033333333,-0.172413793,-0.2,27,27,27,0,0,0
z967,z,Presence of other bone and tendon implants,Other health services,51,59,50,0.156862745,-0.152542373,-0.019607843,25,26,26,1,0,1
z9682,z,Presence of neurostimulator,Other health services,180,359,406,0.994444444,0.13091922,1.255555556,19,14,13,-5,-1,-6
z9689,z,Presence of other specified functional implants,Other health services,336,238,237,-0.291666667,-0.004201681,-0.294642857,13,18,18,5,0,5
z970,z,Presence of artificial eye,Other health services,76,79,71,0.039473684,-0.101265823,-0.065789474,22,21,22,-1,1,0
z974,z,Presence of external hearing-aid,Other health services,246,245,268,-0.004065041,0.093877551,0.089430894,17,17,17,0,0,0
z975,z,Presence of (intrauterine) contraceptive device,Other health services,108,74,105,-0.314814815,0.418918919,-0.027777778,19,20,19,1,-1,0
z978,z,Presence of other specified devices,Other health services,93,83,72,-0.107526882,-0.13253012,-0.225806452,19,19,19,0,0,0
z980,z,Intestinal bypass and anastomosis status,Other health services,334,261,322,-0.218562874,0.233716475,-0.035928144,13,16,14,3,-2,1
z981,z,Arthrodesis status,Other health services,5138,4733,5346,-0.078824445,0.129516163,0.040482678,3,3,3,0,0,0
z982,z,Presence of cerebrospinal fluid drainage device,Other health services,1151,1100,1023,-0.044309296,-0.07,-0.111207646,7,7,8,0,1,1
z9841,z,"Cataract extraction status, right eye",Other health services,322,319,303,-0.00931677,-0.05015674,-0.059006211,12,13,13,1,0,1
z9842,z,"Cataract extraction status, left eye",Other health services,331,325,313,-0.018126888,-0.036923077,-0.054380665,11,12,12,1,0,1
z9849,z,"Cataract extraction status, unspecified eye",Other health services,312,423,394,0.355769231,-0.06855792,0.262820513,11,10,11,-1,1,0
z9851,z,Tubal ligation status,Other health services,545,392,520,-0.280733945,0.326530612,-0.04587156,9,10,10,1,0,1
z9852,z,Vasectomy status,Other health services,39,63,64,0.615384615,0.015873016,0.641025641,12,12,12,0,0,0
z9861,z,Coronary angioplasty status,Other health services,1376,1530,1377,0.111918605,-0.1,0.000726744,6,6,6,0,0,0
z9862,z,Peripheral vascular angioplasty status,Other health services,117,128,111,0.094017094,-0.1328125,-0.051282051,10,10,10,0,0,0
z98818,z,Other dental procedure status,Other health services,26,24,16,-0.076923077,-0.333333333,-0.384615385,10,10,10,0,0,0
z9882,z,Breast implant status,Other health services,532,448,534,-0.157894737,0.191964286,0.003759398,8,8,8,0,0,0
z9884,z,Bariatric surgery status,Other health services,3905,3334,3779,-0.146222791,0.133473305,-0.032266325,3,3,3,0,0,0
z98890,z,Other specified postprocedural states,Other health services,1139,962,1065,-0.155399473,0.107068607,-0.064969271,5,6,5,1,-1,0
z98891,z,History of uterine scar from previous surgery,Other health services,153,154,139,0.006535948,-0.097402597,-0.091503268,6,6,6,0,0,0
z9911,z,Dependence on respirator [ventilator] status,Other health services,1512,1712,1797,0.132275132,0.049649533,0.188492063,4,4,4,0,0,0
z992,z,Dependence on renal dialysis,Other health services,9768,9692,10254,-0.007780508,0.057985968,0.0497543,2,2,2,0,0,0
z993,z,Dependence on wheelchair,Other health services,2605,2349,2252,-0.098272553,-0.041294168,-0.135508637,2,2,2,0,0,0
z9981,z,Dependence on supplemental oxygen,Other health services,13081,12713,10545,-0.028132406,-0.170534099,-0.19386897,1,1,1,0,0,0
z9989,z,Dependence on other enabling machines and devices,Other health services,953,994,592,0.043022036,-0.404426559,-0.378803778,1,1,1,0,0,0
